,condition,odometer,mmr,sellingprice,income,using_time,difference,selling_year
9847,3.8,39506.0,11200,11500,77030,2,300,2015
344412,2.0,109319.0,5700,6200,82750,7,500,2015
50891,3.9,36280.0,8575,10500,77030,3,1925,2015
28859,2.9,27977.0,19350,17500,77030,4,-1850,2015
146762,3.8,87507.0,6300,6950,73100,5,650,2015
472025,4.4,43817.0,10950,10800,62930,3,-150,2015
529060,2.9,63125.0,21700,21200,70210,6,-500,2015
523747,4.5,8921.0,25200,25000,71660,1,-200,2015
462104,4.1,17107.0,16500,16200,61490,1,-300,2015
349741,3.6,63030.0,12750,12500,62960,1,-250,2014
117431,2.8,39419.0,10350,9900,68360,2,-450,2015
499212,4.3,23320.0,18200,19500,80610,1,1300,2015
221345,2.7,41961.0,6625,4500,57290,4,-2125,2015
231181,2.1,112284.0,4175,2800,89090,9,-1375,2015
39903,4.3,40344.0,12800,13500,77030,1,700,2015
235695,3.9,20628.0,23400,21200,59100,1,-2200,2015
349805,4.0,62362.0,14250,14000,62960,1,-250,2014
485153,4.3,58362.0,16350,17500,73130,2,1150,2015
429954,2.4,144870.0,4775,5300,61450,11,525,2015
275329,2.5,145665.0,5225,4000,59100,12,-1225,2015
134312,3.5,63672.0,11600,11200,73100,2,-400,2015
521492,2.0,113551.0,13250,12500,71660,5,-750,2015
445504,2.7,98998.0,2725,3900,56120,11,1175,2015
432233,1.9,118724.0,1275,1100,61450,14,-175,2015
88649,3.9,13996.0,17950,17000,68360,1,-950,2015
252968,4.9,44461.0,13050,13600,59100,4,550,2015
44163,4.3,38940.0,12800,12600,77030,1,-200,2015
509973,4.9,45955.0,15650,17900,71660,3,2250,2015
268405,4.1,36774.0,16500,15500,59100,2,-1000,2015
510086,2.0,114610.0,17150,16500,71660,6,-650,2015
298510,2.8,15669.0,28700,26800,59100,2,-1900,2015
75754,3.7,26507.0,22300,21250,68360,2,-1050,2014
370079,2.8,97697.0,7950,8600,64520,11,650,2015
26981,3.7,80459.0,19950,20500,77030,8,550,2015
238452,1.0,75937.0,6725,3900,59100,8,-2825,2014
271692,1.9,96096.0,4325,5000,59100,9,675,2015
302404,1.9,76315.0,1275,700,59100,15,-575,2015
235151,2.7,153364.0,3450,2900,59100,10,-550,2014
381783,3.5,64334.0,18550,24800,64520,5,6250,2015
263814,4.4,16154.0,17000,18000,59100,1,1000,2015
104190,3.8,87090.0,11100,13200,68360,5,2100,2015
380460,2.9,54008.0,12100,12300,64520,2,200,2015
104575,1.9,67628.0,13050,12100,68360,3,-950,2015
72762,2.3,83503.0,4475,4350,77030,10,-125,2015
229194,3.5,117620.0,5600,3200,89090,6,-2400,2015
308340,4.6,43940.0,3850,5900,59100,11,2050,2015
293186,3.7,50292.0,26800,26300,59100,2,-500,2015
283576,4.1,116077.0,10100,11800,59100,9,1700,2015
463678,3.9,91920.0,8750,11200,61490,9,2450,2015
120026,5.0,78736.0,11550,14600,73100,5,3050,2014
332315,4.9,9958.0,17900,18000,82750,1,100,2015
265360,4.0,10257.0,14100,14800,59100,1,700,2015
165682,2.9,76022.0,15450,14100,73100,5,-1350,2015
434915,2.5,76097.0,4600,5000,74430,5,400,2015
449081,1.9,145449.0,2575,1900,61490,9,-675,2015
358788,4.3,19169.0,20500,22000,62960,1,1500,2015
269830,2.0,83729.0,8775,7000,59100,3,-1775,2015
312314,3.6,64059.0,15600,15200,59100,3,-400,2015
411568,2.0,74117.0,7125,6100,61450,4,-1025,2015
293833,3.5,33276.0,20700,21600,59100,3,900,2015
140316,3.5,73665.0,26200,24200,73100,3,-2000,2015
134704,2.6,125594.0,5875,5050,73100,9,-825,2015
97202,3.4,172415.0,8900,8700,68360,8,-200,2015
273471,3.9,19285.0,16050,16000,59100,0,-50,2015
50095,2.7,159485.0,1975,1750,77030,13,-225,2015
281552,3.3,74646.0,11250,11800,59100,3,550,2015
236942,,133631.0,14000,5000,59100,6,-9000,2014
319447,3.6,95461.0,11000,11800,73200,7,800,2015
435654,3.9,105476.0,3150,3900,74430,12,750,2015
496592,2.6,52444.0,13150,12700,73130,2,-450,2015
343242,4.7,11260.0,42500,40250,82750,0,-2250,2015
397205,4.8,68522.0,23000,24000,65610,4,1000,2015
199963,1.9,95467.0,7575,6300,67090,9,-1275,2015
173048,4.0,12392.0,17200,17400,83200,1,200,2015
441503,1.0,318464.0,350,350,74430,19,0,2015
237480,3.7,35671.0,19800,20500,59100,2,700,2014
60297,4.0,27415.0,21800,22500,77030,3,700,2015
437525,3.5,20185.0,11600,11400,74430,2,-200,2015
348362,,120356.0,1525,800,62960,12,-725,2014
363717,4.7,58249.0,25600,27400,64520,3,1800,2015
163886,3.6,82078.0,13800,13800,73100,6,0,2015
469996,1.9,183390.0,3325,4800,61490,11,1475,2015
36372,2.9,111916.0,12000,8900,77030,7,-3100,2015
193295,3.9,11051.0,31900,31500,67090,2,-400,2015
211309,3.6,66949.0,9350,9500,57290,3,150,2015
382146,4.1,64473.0,11500,11300,65610,3,-200,2014
338040,4.5,16644.0,39500,40000,82750,1,500,2015
253358,3.8,18777.0,21500,20900,59100,1,-600,2015
399028,2.4,55994.0,21200,18900,61450,2,-2300,2014
22878,3.7,22704.0,15800,16000,77030,2,200,2015
380096,2.4,44978.0,10650,8100,64520,3,-2550,2015
284367,3.9,87058.0,15450,15100,59100,3,-350,2015
209603,4.1,55958.0,13900,16000,57290,3,2100,2015
51407,3.9,91930.0,10400,12100,77030,11,1700,2015
282715,4.9,48043.0,23400,23000,59100,3,-400,2015
155439,1.9,115984.0,2100,2600,73100,14,500,2015
15329,4.7,87411.0,16000,20000,77030,9,4000,2015
197029,3.6,87973.0,5350,6000,67090,8,650,2015
524846,4.9,16575.0,23900,25000,70210,1,1100,2014
388353,4.8,18882.0,14750,15200,65610,2,450,2015
498358,1.9,96304.0,18100,16000,80610,6,-2100,2014
326911,3.5,119555.0,9200,8700,82750,2,-500,2015
145737,3.7,41579.0,27500,26500,73100,2,-1000,2015
366500,3.7,71499.0,9875,10800,64520,9,925,2015
419256,2.9,54533.0,10850,9000,61450,2,-1850,2015
487605,3.8,37325.0,11900,11600,73130,3,-300,2015
533110,2.8,132409.0,9375,9000,82150,8,-375,2015
504778,4.8,19010.0,14500,15200,80610,1,700,2015
112872,4.9,53275.0,17150,19000,68360,3,1850,2015
215289,3.8,13037.0,16350,20400,57290,1,4050,2015
138345,3.0,88279.0,1975,2500,73100,12,525,2015
103879,4.2,29112.0,17850,17900,68360,2,50,2015
261243,3.5,46216.0,10750,10800,59100,2,50,2015
131481,2.1,143034.0,4350,4500,73100,10,150,2015
377869,4.4,14344.0,16100,15200,64520,3,-900,2015
80700,3.7,44778.0,11650,12200,68360,3,550,2015
164938,2.1,45217.0,11100,10300,73100,3,-800,2015
517093,3.4,64658.0,6350,8700,71660,11,2350,2015
519047,4.3,12874.0,37200,37500,71660,2,300,2015
174443,4.1,9616.0,19600,20800,83200,2,1200,2015
282134,4.4,7586.0,24500,24800,59100,2,300,2015
383992,1.9,99661.0,4100,1850,65610,6,-2250,2015
59275,2.9,75029.0,7350,7500,77030,6,150,2015
468543,4.2,36924.0,14000,14600,61490,1,600,2015
437649,3.7,101604.0,7875,7700,74430,3,-175,2015
359700,4.6,8720.0,41800,44500,62960,4,2700,2015
55144,2.9,65739.0,7525,9600,77030,6,2075,2015
434780,2.8,47360.0,7600,8300,74430,5,700,2015
26719,2.7,64331.0,26500,27200,77030,5,700,2015
501942,4.7,29597.0,38900,40000,80610,1,1100,2015
235085,1.9,107861.0,5425,1000,59100,10,-4425,2014
396397,1.9,30805.0,8375,5500,65610,5,-2875,2015
83575,2.4,37729.0,11150,9000,68360,2,-2150,2015
266454,3.7,77395.0,10700,11000,59100,4,300,2015
333898,2.0,116248.0,4575,3000,82750,13,-1575,2015
515384,3.9,152648.0,1800,3100,71660,8,1300,2015
120507,4.2,4359.0,22300,23200,73100,0,900,2014
437183,2.8,58127.0,18600,18300,74430,5,-300,2015
402476,1.9,153972.0,3050,1900,61450,11,-1150,2015
97408,4.7,37853.0,20900,21500,68360,1,600,2015
369147,3.9,58082.0,5550,6500,64520,5,950,2015
358417,3.5,79041.0,3900,4300,62960,8,400,2015
165752,4.3,48871.0,29500,29250,73100,3,-250,2015
209523,4.2,41787.0,12800,12900,57290,2,100,2015
484144,4.1,21720.0,12850,13400,73130,3,550,2015
366618,2.5,112872.0,1850,2650,64520,11,800,2015
202579,2.8,75891.0,8600,7500,57290,3,-1100,2015
250100,4.8,20042.0,14650,14000,59100,2,-650,2015
56186,4.9,12129.0,19550,21250,77030,2,1700,2015
134364,3.6,77449.0,11850,11600,73100,3,-250,2015
505774,3.4,101342.0,4000,4500,80610,9,500,2015
477910,4.5,29348.0,11450,10800,73130,2,-650,2015
301849,1.9,196795.0,2250,1400,59100,14,-850,2015
198943,4.1,58175.0,21100,22250,67090,6,1150,2015
463845,4.3,31448.0,12900,12900,61490,3,0,2015
183427,4.2,42123.0,18700,19100,63250,1,400,2014
435218,3.5,99578.0,5725,6600,74430,9,875,2015
514990,3.6,89429.0,16200,15300,71660,1,-900,2015
488452,4.0,33669.0,10650,10600,73130,3,-50,2015
105855,4.5,29646.0,31600,31800,68360,2,200,2015
499366,4.9,20792.0,52400,53500,80610,1,1100,2015
182497,4.0,28343.0,16250,15000,63250,0,-1250,2014
269972,2.9,66180.0,16600,16800,59100,3,200,2015
11285,4.9,42538.0,14050,15300,77030,1,1250,2014
74514,2.4,125072.0,5750,3700,68360,10,-2050,2015
387505,3.9,30522.0,27700,26900,65610,2,-800,2015
150180,4.2,182311.0,3250,3300,73100,12,50,2015
443901,1.9,143345.0,2825,3400,74430,9,575,2015
511993,5.0,30137.0,34300,33300,71660,1,-1000,2015
5305,2.0,23152.0,11200,7300,77030,0,-3900,2014
236441,4.6,15210.0,17350,17200,59100,1,-150,2014
466606,3.0,255324.0,50,1800,61490,12,1750,2015
345452,3.4,80789.0,7025,7300,82750,4,275,2015
402733,3.5,72318.0,11050,11500,61450,8,450,2015
45705,3.5,97618.0,5275,7000,77030,8,1725,2015
291050,3.4,31082.0,14850,13800,59100,3,-1050,2015
531685,1.9,200492.0,2750,1250,82150,12,-1500,2015
283339,2.8,72934.0,8100,7700,59100,5,-400,2015
380213,3.5,45298.0,8200,8200,64520,2,0,2015
143468,3.5,32972.0,18150,18500,73100,3,350,2015
224675,2.5,64623.0,10200,8100,89090,8,-2100,2015
395085,4.0,25827.0,12900,12500,65610,1,-400,2015
485882,1.9,113454.0,5225,6200,73130,7,975,2015
538793,1.9,137552.0,4450,4800,55590,8,350,2015
152042,2.5,139778.0,4025,3800,73100,12,-225,2015
10938,2.8,98263.0,8500,8400,77030,9,-100,2014
381283,4.4,15903.0,12900,13500,64520,2,600,2015
395670,3.2,37254.0,27100,27900,65610,3,800,2015
535167,2.9,53724.0,9325,8800,82150,2,-525,2015
344160,4.4,27373.0,11800,10800,82750,1,-1000,2015
217769,4.4,18443.0,23500,22400,57290,1,-1100,2015
70573,4.2,26664.0,15650,17000,77030,2,1350,2015
45706,2.9,72774.0,7325,8000,77030,9,675,2015
143595,3.7,70824.0,7725,9000,73100,7,1275,2015
41735,2.9,154461.0,5400,5200,77030,9,-200,2015
111076,3.8,31885.0,26600,28100,68360,2,1500,2015
442536,3.0,64836.0,9075,11100,74430,5,2025,2015
393008,3.6,85610.0,3125,3500,65610,8,375,2015
82499,4.4,75427.0,10400,10000,68360,2,-400,2015
403974,3.4,10005.0,14050,13300,61450,2,-750,2015
216284,4.3,15691.0,30200,35600,57290,2,5400,2015
30632,4.6,16529.0,28900,29750,77030,1,850,2015
106087,3.5,36010.0,21000,20700,68360,0,-300,2015
205047,4.4,22934.0,32000,30600,57290,1,-1400,2015
317785,4.3,32201.0,15100,9000,73200,1,-6100,2015
381671,5.0,7056.0,30100,31000,64520,2,900,2015
77757,2.0,203527.0,3550,2300,68360,10,-1250,2014
225241,3.2,153539.0,6250,5800,89090,9,-450,2015
76696,1.0,126576.0,1700,1200,68360,13,-500,2015
124817,4.2,11565.0,15000,15800,73100,2,800,2015
452900,2.7,130495.0,11750,12800,61490,9,1050,2015
312250,2.0,19824.0,12700,10900,59100,0,-1800,2015
128274,2.0,84931.0,1150,1100,73100,13,-50,2015
504864,3.7,65026.0,20400,21800,80610,3,1400,2015
133,4.1,22961.0,31500,25000,77030,2,-6500,2015
134182,2.9,122336.0,2475,4200,73100,7,1725,2015
527742,3.7,33461.0,14000,13200,70210,2,-800,2015
119919,3.4,72707.0,10550,10600,73100,4,50,2014
333920,4.3,27567.0,17800,17800,82750,2,0,2015
296649,4.2,52860.0,8250,8800,59100,2,550,2015
37647,2.1,88258.0,5075,6100,77030,6,1025,2015
237833,4.2,59356.0,4825,5500,59100,5,675,2015
198443,3.5,64967.0,11400,11800,67090,2,400,2015
317840,1.9,155976.0,1625,850,73200,11,-775,2015
292709,3.3,65629.0,20200,17200,59100,5,-3000,2015
351889,2.0,88040.0,1850,1250,62960,11,-600,2015
410767,4.0,29257.0,12350,12200,61450,1,-150,2015
308401,4.5,14702.0,23100,23500,59100,1,400,2015
207229,3.8,97767.0,15300,17500,57290,5,2200,2015
239539,3.8,25988.0,28400,28000,59100,2,-400,2015
490947,2.0,32819.0,12050,11600,73130,3,-450,2015
388252,4.9,26761.0,23700,25400,65610,2,1700,2015
237308,4.9,15074.0,24100,24500,59100,1,400,2014
181390,1.9,120419.0,3375,7000,83200,8,3625,2015
126407,4.4,15794.0,12550,13600,73100,3,1050,2015
373744,1.9,101337.0,2075,3200,64520,11,1125,2015
97915,2.1,78778.0,17550,17800,68360,6,250,2015
331173,3.7,83504.0,5000,6750,82750,10,1750,2015
400050,2.9,18219.0,23200,23200,61450,2,0,2015
2783,3.5,35561.0,35600,28500,77030,4,-7100,2014
303715,2.6,30895.0,12650,12000,59100,3,-650,2015
243014,2.2,204543.0,2600,2700,59100,11,100,2015
284572,4.3,28841.0,12800,14800,59100,3,2000,2015
417132,2.7,73827.0,17050,16200,61450,2,-850,2015
131317,4.1,59993.0,13600,14200,73100,4,600,2015
247504,3.6,38862.0,21700,21800,59100,2,100,2015
515747,1.9,110820.0,16000,14900,71660,8,-1100,2015
272673,3.2,68862.0,9975,11400,59100,6,1425,2015
246364,1.0,32249.0,20800,19500,59100,2,-1300,2015
519355,2.5,53930.0,9575,9900,71660,4,325,2015
459469,1.9,126097.0,2900,3800,61490,12,900,2015
321992,3.3,48566.0,9975,9800,82750,4,-175,2014
194402,1.0,120221.0,3950,1225,67090,14,-2725,2015
348794,3.7,32735.0,15600,17500,62960,2,1900,2014
470100,4.1,22216.0,30600,30600,61490,3,0,2015
536389,4.1,28963.0,10300,11200,73640,2,900,2014
451021,2.6,201110.0,11800,13300,61490,9,1500,2015
126992,4.0,16950.0,30600,30700,73100,1,100,2015
249454,4.0,17812.0,15950,15900,59100,1,-50,2015
303039,3.8,31142.0,14450,14600,59100,3,150,2015
100577,1.9,152102.0,3825,2700,68360,11,-1125,2015
103979,3.7,24712.0,11950,12900,68360,1,950,2015
352020,4.6,23826.0,11700,11800,62960,2,100,2015
171729,4.7,32324.0,9600,10000,73100,2,400,2015
304983,3.3,50252.0,8350,8500,59100,2,150,2015
131593,4.2,30969.0,16850,17300,73100,3,450,2015
153480,4.1,132191.0,5175,5300,73100,11,125,2015
97632,3.7,66103.0,13200,11100,68360,5,-2100,2015
436911,2.0,121731.0,24500,16200,74430,9,-8300,2015
39926,2.8,61141.0,10500,10100,77030,3,-400,2015
5932,2.6,13853.0,13900,13500,77030,1,-400,2015
149699,4.2,38001.0,10350,10700,73100,4,350,2015
309832,4.7,29858.0,43600,49600,59100,3,6000,2015
126470,4.0,23675.0,18200,18300,73100,1,100,2015
129290,3.7,24348.0,16000,16700,73100,3,700,2015
289330,3.5,62385.0,19700,20200,59100,3,500,2015
155639,2.9,58453.0,9200,7500,73100,3,-1700,2015
203323,4.0,39952.0,19550,20600,57290,2,1050,2015
119387,3.8,69022.0,7475,7400,73100,3,-75,2014
496929,2.7,110047.0,4350,3700,73130,11,-650,2015
164622,3.7,113906.0,18300,19800,73100,8,1500,2015
48180,3.6,75175.0,14300,14800,77030,5,500,2015
491945,2.0,12678.0,20800,14000,73130,3,-6800,2015
145424,1.9,107363.0,3575,3400,73100,8,-175,2015
309932,4.5,16949.0,22000,22500,59100,0,500,2015
296770,3.1,79956.0,18450,18300,59100,7,-150,2015
513320,1.9,156378.0,2175,1600,71660,11,-575,2015
187502,3.0,93303.0,6200,6600,63250,5,400,2015
69627,4.4,9779.0,30500,29750,77030,3,-750,2015
67477,3.5,124237.0,8450,11500,77030,10,3050,2015
435593,2.0,161384.0,5825,2200,74430,7,-3625,2015
19845,3.4,39076.0,26100,25300,77030,2,-800,2015
28407,4.0,34004.0,11500,11600,77030,1,100,2015
385399,3.4,14271.0,30200,28700,65610,1,-1500,2015
140283,2.8,57145.0,9075,8500,73100,3,-575,2015
351631,3.8,24002.0,13600,12500,62960,3,-1100,2015
59206,2.2,77104.0,9000,8100,77030,3,-900,2015
271349,4.1,30950.0,12700,12600,59100,2,-100,2015
415381,3.2,77912.0,7875,8500,61450,3,625,2015
297866,3.1,169431.0,15600,14800,59100,7,-800,2015
57079,4.1,4562.0,30300,27000,77030,1,-3300,2015
87159,4.4,27181.0,11300,11400,68360,1,100,2015
202149,3.5,60279.0,6100,7100,57290,4,1000,2014
487387,2.9,82562.0,9525,10700,73130,8,1175,2015
512212,4.3,30248.0,16750,16500,71660,3,-250,2015
39430,2.5,86495.0,4550,5000,77030,9,450,2015
546862,4.3,53736.0,14300,19500,81400,7,5200,2015
325395,4.3,25011.0,12000,12700,82750,3,700,2015
451656,2.0,76041.0,7675,6000,61490,7,-1675,2015
331778,1.0,114800.0,12050,9000,82750,6,-3050,2015
218608,4.5,28715.0,20100,20600,57290,2,500,2015
157380,4.2,76847.0,19050,18100,73100,5,-950,2015
178956,4.7,53854.0,27600,27000,83200,3,-600,2015
426742,2.4,161354.0,1875,3000,61450,13,1125,2015
312278,2.5,61385.0,10550,10000,59100,3,-550,2015
162204,3.6,60044.0,12650,11300,73100,4,-1350,2015
111530,2.8,101195.0,23600,22900,68360,3,-700,2015
441362,3.2,112468.0,4050,4200,74430,7,150,2015
474048,1.0,29952.0,12800,6600,62930,1,-6200,2015
255284,4.4,10481.0,23700,23900,59100,1,200,2015
352687,4.2,68898.0,11500,12600,62960,5,1100,2015
222885,3.4,56922.0,8450,7000,89090,2,-1450,2014
401610,2.9,50686.0,29500,27000,61450,3,-2500,2015
180018,4.4,30138.0,33500,34600,83200,2,1100,2015
181617,3.5,126773.0,11750,12000,83200,8,250,2015
174002,4.3,30047.0,16500,15500,83200,3,-1000,2015
37695,3.3,107655.0,13050,13200,77030,8,150,2015
367269,5.0,5165.0,26700,25750,64520,0,-950,2015
173705,,138439.0,725,800,83200,14,75,2014
286137,4.5,38223.0,17150,18000,59100,3,850,2015
241350,3.7,29737.0,22100,21400,59100,2,-700,2014
349318,2.0,234657.0,975,900,62960,16,-75,2014
499485,4.4,53913.0,12150,12200,80610,3,50,2015
157230,3.8,19023.0,15050,14500,73100,1,-550,2015
186833,2.2,92412.0,5050,6800,63250,9,1750,2015
508296,4.5,39309.0,19550,21300,71660,1,1750,2014
289877,2.8,116985.0,6500,7200,59100,9,700,2015
31718,4.3,43686.0,26800,25500,77030,3,-1300,2015
226409,4.3,117505.0,1100,1600,89090,13,500,2015
85578,4.8,5913.0,13900,15200,68360,1,1300,2015
111024,2.4,90936.0,7800,6600,68360,9,-1200,2015
150654,2.5,118995.0,4800,3300,73100,9,-1500,2015
484768,1.0,1.0,5425,1000,73130,11,-4425,2015
419259,3.8,35427.0,11650,11900,61450,2,250,2015
202501,3.8,28564.0,11900,12300,57290,1,400,2014
158936,4.0,47956.0,8175,8200,73100,2,25,2015
217048,4.6,17379.0,29500,29500,57290,0,0,2015
34698,4.3,31999.0,21500,21000,77030,1,-500,2015
477848,3.6,71213.0,21000,21600,73130,4,600,2015
134392,3.8,60169.0,9000,8500,73100,3,-500,2015
509512,4.1,46627.0,18300,18200,71660,1,-100,2015
128417,4.7,42140.0,55900,50400,73100,3,-5500,2015
198302,2.0,75336.0,13800,12300,67090,2,-1500,2015
158527,3.7,24996.0,16350,16600,73100,1,250,2015
492247,4.1,33482.0,10950,18200,73130,1,7250,2015
225685,3.5,78067.0,7450,6500,89090,10,-950,2015
8913,3.5,65276.0,14800,13500,77030,3,-1300,2014
258273,3.8,16304.0,12600,13100,59100,2,500,2015
130464,3.8,65918.0,29100,31200,73100,8,2100,2015
446818,1.9,116608.0,1600,600,56120,15,-1000,2015
500718,1.9,191918.0,450,250,80610,11,-200,2015
471308,2.7,137123.0,6800,5900,62930,4,-900,2015
472981,1.9,73965.0,6000,4700,62930,4,-1300,2015
197018,1.9,109404.0,3625,2500,67090,7,-1125,2015
518577,4.2,20936.0,27700,29000,71660,2,1300,2015
377336,4.4,13642.0,28500,28400,64520,2,-100,2015
418619,3.5,41088.0,12300,13400,61450,3,1100,2015
62708,1.9,101460.0,5575,4800,77030,10,-775,2015
155785,4.1,39638.0,25500,26500,73100,3,1000,2015
318470,3.6,71390.0,24700,23750,73200,4,-950,2015
58435,4.0,30960.0,18000,18000,77030,2,0,2015
183288,2.7,16925.0,15800,13200,63250,1,-2600,2015
384418,1.9,45142.0,11000,7000,65610,4,-4000,2015
22495,2.6,128922.0,4900,5700,77030,11,800,2015
339781,4.1,18321.0,23800,23000,82750,1,-800,2015
160384,4.7,38954.0,12400,11400,73100,5,-1000,2015
474686,2.0,14845.0,10200,6000,62930,0,-4200,2015
160639,4.4,6646.0,43800,44250,73100,1,450,2015
2198,2.0,14875.0,16550,14200,77030,0,-2350,2014
371599,2.8,116331.0,8275,7500,64520,7,-775,2015
455633,1.9,109535.0,6825,8300,61490,8,1475,2015
26554,4.2,33748.0,21800,25900,77030,3,4100,2015
514779,2.2,184989.0,1975,2000,71660,9,25,2015
62406,3.3,28772.0,12050,13100,77030,3,1050,2015
483107,4.0,56602.0,8900,9400,73130,3,500,2015
247796,4.4,30275.0,11700,12700,59100,4,1000,2015
252816,4.4,22354.0,19850,19800,59100,4,-50,2015
475447,,91819.0,6225,6200,73130,7,-25,2014
35608,2.5,84378.0,10100,8200,77030,6,-1900,2015
354221,4.2,11838.0,21600,23500,62960,4,1900,2015
23013,4.2,77938.0,14550,15000,77030,5,450,2015
317509,4.3,40189.0,9375,9500,73200,2,125,2015
139723,2.5,114307.0,5525,5200,73100,9,-325,2015
52643,4.6,50604.0,17750,15600,77030,3,-2150,2015
407654,3.8,19326.0,23100,24200,61450,3,1100,2015
397016,4.3,43755.0,10450,9600,65610,7,-850,2015
36423,3.5,93325.0,5525,5100,77030,10,-425,2015
17430,4.5,6608.0,20500,21500,77030,1,1000,2015
82776,4.3,29005.0,23200,24100,68360,3,900,2015
238884,1.9,227971.0,675,400,59100,13,-275,2014
198566,3.5,115912.0,16150,13400,67090,9,-2750,2015
157858,4.4,20939.0,36200,9200,73100,1,-27000,2015
503734,3.6,57652.0,23600,21600,80610,4,-2000,2015
342081,3.3,160988.0,2400,2700,82750,11,300,2015
348186,,230092.0,1025,1900,62960,9,875,2014
51200,2.9,135399.0,5250,4600,77030,8,-650,2015
468229,2.6,172367.0,7800,9800,61490,9,2000,2015
22229,2.8,121228.0,3925,3900,77030,7,-25,2015
283490,4.0,27232.0,18800,19600,59100,1,800,2015
415255,2.8,198652.0,1800,2600,61450,12,800,2015
417874,2.0,135837.0,1425,1600,61450,10,175,2015
394534,5.0,10399.0,14650,15900,65610,1,1250,2015
239500,3.7,39445.0,13400,13000,59100,1,-400,2014
119684,3.7,34955.0,15900,16800,73100,3,900,2014
168076,4.0,22887.0,41700,40400,73100,3,-1300,2015
203499,3.4,29026.0,13150,12600,57290,3,-550,2015
297605,2.6,79164.0,11000,10600,59100,3,-400,2015
451951,1.9,98690.0,5600,6500,61490,9,900,2015
509601,2.6,54727.0,8600,7600,71660,3,-1000,2015
33289,3.5,61226.0,14500,14300,77030,3,-200,2015
161338,3.7,60546.0,8825,8600,73100,4,-225,2015
344218,3.6,38887.0,30900,31000,82750,3,100,2015
238447,3.7,198157.0,5200,6400,59100,8,1200,2014
326105,3.6,72913.0,4125,5600,82750,14,1475,2015
447762,4.0,23971.0,16800,13400,56120,0,-3400,2015
174928,3.4,52981.0,16300,16700,83200,3,400,2015
480421,3.8,35572.0,13200,12700,73130,2,-500,2015
32410,2.9,177178.0,3400,3700,77030,12,300,2015
538066,2.0,109945.0,6250,5200,55590,8,-1050,2015
165333,4.7,72913.0,10050,9900,73100,6,-150,2015
384532,2.0,74652.0,20800,19800,65610,8,-1000,2015
243803,2.7,32276.0,21400,19900,59100,4,-1500,2015
94490,1.9,120891.0,16700,10100,68360,7,-6600,2015
536723,4.2,119684.0,7100,8400,73640,9,1300,2015
393647,3.8,51410.0,9675,9300,65610,2,-375,2015
408632,4.0,65763.0,13000,12600,61450,8,-400,2015
415775,3.2,237341.0,2625,5100,61450,14,2475,2015
48857,3.5,31871.0,21400,21750,77030,3,350,2015
29353,4.2,11471.0,14800,18500,77030,2,3700,2015
49380,4.2,18067.0,23900,24750,77030,2,850,2015
328408,3.4,24883.0,13500,12500,82750,3,-1000,2015
503909,2.0,40613.0,15600,14401,80610,2,-1199,2015
413302,3.9,32891.0,14100,14000,61450,1,-100,2015
283625,4.0,23319.0,16200,16600,59100,1,400,2015
491447,4.2,22308.0,19750,20200,73130,1,450,2015
419757,3.1,104471.0,8125,8200,61450,8,75,2015
511057,4.7,19285.0,19300,16900,71660,2,-2400,2015
312174,4.1,20218.0,18750,18400,59100,2,-350,2015
529749,2.6,188560.0,1625,1100,82150,13,-525,2014
386111,5.0,45796.0,17200,17500,65610,3,300,2015
340233,1.9,144649.0,1125,300,82750,14,-825,2015
208704,4.4,22828.0,23900,24300,57290,1,400,2015
113388,3.9,2436.0,18650,15200,68360,0,-3450,2015
297311,4.6,4616.0,35600,35200,59100,1,-400,2015
272666,2.6,79692.0,7475,6900,59100,6,-575,2015
176204,2.7,71433.0,5425,6900,83200,7,1475,2015
300841,1.9,120568.0,2400,2500,59100,15,100,2015
177792,5.0,10745.0,46500,45200,83200,2,-1300,2015
413771,2.5,110257.0,29900,29200,61450,7,-700,2015
317591,3.7,90870.0,12500,13500,73200,6,1000,2015
147449,1.9,21451.0,22300,19100,73100,3,-3200,2015
127710,3.8,84498.0,8275,9300,73100,7,1025,2015
168890,2.8,18479.0,11750,10000,73100,3,-1750,2015
230370,3.3,77087.0,9025,11000,89090,11,1975,2015
228408,1.9,31258.0,11950,10200,89090,3,-1750,2015
40306,1.9,102596.0,14300,12000,77030,8,-2300,2015
505933,2.0,33379.0,14650,13000,80610,2,-1650,2015
450573,1.9,174559.0,4900,3600,61490,10,-1300,2014
311111,2.8,154894.0,5000,4800,59100,11,-200,2015
272359,4.6,17397.0,31200,33000,59100,3,1800,2015
24122,3.9,62972.0,12050,12500,77030,2,450,2015
184272,1.9,165369.0,2475,2300,63250,6,-175,2015
90869,1.9,68637.0,9275,7200,68360,4,-2075,2015
18402,3.1,19131.0,40100,38000,77030,4,-2100,2015
408196,3.5,114846.0,5975,5300,61450,6,-675,2015
532373,1.9,1.0,4150,400,82150,9,-3750,2015
49125,4.3,15733.0,23300,23500,77030,2,200,2015
502876,1.9,35866.0,14550,10600,80610,2,-3950,2015
477843,4.3,14779.0,42200,42500,73130,0,300,2015
81089,2.1,15153.0,8800,5300,68360,2,-3500,2015
116336,3.1,127227.0,7225,8500,68360,7,1275,2015
50081,2.2,123044.0,2550,3200,77030,12,650,2015
479364,3.0,22758.0,12150,11900,73130,1,-250,2015
256425,4.3,7579.0,15600,18000,59100,2,2400,2015
107110,2.7,153520.0,1325,1400,68360,13,75,2015
183167,,148067.0,2775,4100,63250,12,1325,2014
130282,4.1,89140.0,26800,24500,73100,4,-2300,2015
463460,2.5,91142.0,1250,1200,61490,12,-50,2015
109053,1.9,127843.0,1000,1200,68360,13,200,2015
263250,4.2,41151.0,10300,11000,59100,3,700,2015
12588,2.4,222853.0,13000,12000,77030,8,-1000,2015
305684,4.4,17605.0,12000,12400,59100,2,400,2015
92321,3.9,27872.0,18000,19400,68360,3,1400,2015
287831,4.0,46022.0,15350,17000,59100,2,1650,2015
1106,3.0,53009.0,9575,10800,77030,2,1225,2014
201288,5.0,10412.0,34500,34800,57290,1,300,2015
46110,2.1,83096.0,7500,5100,77030,6,-2400,2015
47372,2.1,128771.0,2325,3100,77030,11,775,2015
444396,,97597.0,6600,4300,56120,5,-2300,2014
331905,3.3,58350.0,22100,20200,82750,3,-1900,2015
197553,2.7,147993.0,8150,10000,67090,3,1850,2015
504669,1.9,91990.0,1750,1200,80610,13,-550,2015
429278,3.8,50566.0,15550,15800,61450,5,250,2015
445572,1.9,103056.0,1125,800,56120,13,-325,2015
172308,2.8,195121.0,4800,5800,73100,10,1000,2015
218678,4.4,19525.0,11500,11800,57290,2,300,2015
434980,1.0,253716.0,600,350,74430,19,-250,2015
372907,3.7,41785.0,13600,13200,64520,2,-400,2015
419302,2.7,47703.0,8500,8000,61450,4,-500,2015
448691,2.8,122185.0,13250,13000,61490,4,-250,2014
494060,4.5,33133.0,26400,27500,73130,1,1100,2015
394986,2.8,55076.0,32500,30500,65610,4,-2000,2015
9714,4.5,7612.0,16900,15750,77030,0,-1150,2014
36562,3.6,28159.0,22100,23100,77030,2,1000,2015
95012,2.7,29052.0,13950,12200,68360,2,-1750,2015
419829,4.4,9383.0,18650,18300,61450,1,-350,2015
522508,4.1,29233.0,10350,8800,71660,3,-1550,2015
336692,3.4,42133.0,17500,16800,82750,4,-700,2015
412570,3.5,55215.0,9825,9600,61450,2,-225,2015
456179,1.9,56726.0,5025,2300,61490,8,-2725,2015
549114,1.0,70242.0,13700,2000,48460,2,-11700,2015
279288,3.5,11832.0,13900,12400,59100,1,-1500,2015
120676,,172386.0,4600,4700,73100,10,100,2014
16803,3.7,42889.0,20400,21500,77030,4,1100,2015
90074,4.8,33664.0,11500,11700,68360,1,200,2015
380731,3.1,71801.0,10700,9600,64520,3,-1100,2015
72914,3.9,49437.0,18750,17000,77030,6,-1750,2015
335098,1.9,27555.0,17300,13700,82750,4,-3600,2015
175841,3.8,70330.0,9875,11100,83200,4,1225,2015
440816,2.6,215745.0,1500,1800,74430,10,300,2015
534105,3.1,93730.0,6725,5100,82150,7,-1625,2015
511150,3.4,35454.0,11900,11900,71660,2,0,2015
400684,4.2,27131.0,10100,10000,61450,1,-100,2014
135889,3.7,85012.0,18950,21200,73100,7,2250,2015
397616,3.9,59816.0,22500,20300,61450,3,-2200,2014
437842,2.6,93983.0,3075,3300,74430,9,225,2015
414006,5.0,3438.0,17350,17600,61450,1,250,2015
233172,2.2,48897.0,13700,11400,59100,3,-2300,2014
347995,3.9,75790.0,11700,10700,62960,7,-1000,2014
429922,3.5,70454.0,8050,8600,61450,3,550,2015
276493,3.3,19850.0,12050,11200,59100,4,-850,2015
517498,4.1,10500.0,12550,12100,71660,1,-450,2015
484442,4.0,7902.0,13950,13800,73130,1,-150,2015
8188,5.0,252.0,44600,31500,77030,0,-13100,2014
256502,2.2,50935.0,11250,11000,59100,4,-250,2015
520324,3.7,38999.0,17900,16500,71660,1,-1400,2015
230815,2.0,26624.0,9225,3600,89090,2,-5625,2015
24695,1.0,56137.0,8225,6250,77030,2,-1975,2015
122531,4.1,24638.0,44400,47500,73100,2,3100,2014
135977,4.0,107098.0,3725,5200,73100,11,1475,2015
538836,4.5,101882.0,2475,4550,55590,13,2075,2015
4579,2.1,199797.0,1750,1200,77030,11,-550,2014
480341,4.7,16162.0,19900,19900,73130,2,0,2015
24855,3.7,47704.0,28900,28500,77030,2,-400,2015
485583,3.0,18397.0,14800,14200,73130,1,-600,2015
20937,2.5,87195.0,9625,6500,77030,7,-3125,2015
70668,3.9,24444.0,19200,19750,77030,3,550,2015
282417,3.9,87656.0,13500,13500,59100,11,0,2015
454850,3.5,106765.0,1725,2000,61490,8,275,2015
192941,2.7,38688.0,31400,30800,67090,2,-600,2015
9946,4.1,27437.0,14100,13500,77030,1,-600,2014
315278,2.3,105561.0,6900,7100,59100,9,200,2015
194665,3.6,26830.0,13900,14300,67090,4,400,2015
88358,4.5,12001.0,40600,40000,68360,0,-600,2015
175490,2.9,126067.0,9850,8500,83200,6,-1350,2015
377448,4.3,15103.0,15850,15800,64520,3,-50,2015
549429,4.3,52145.0,11100,12400,48460,2,1300,2015
227779,4.0,46737.0,6450,6300,89090,8,-150,2015
58840,3.5,35640.0,10100,11750,77030,3,1650,2015
198171,2.8,21976.0,8950,8900,67090,4,-50,2015
78017,3.6,63452.0,22600,21600,68360,3,-1000,2014
212570,4.8,11862.0,23400,23400,57290,1,0,2015
48031,4.3,34062.0,24200,23000,77030,3,-1200,2015
62528,3.6,94412.0,12650,12000,77030,5,-650,2015
243829,4.4,31868.0,20200,20800,59100,4,600,2015
334556,4.7,62925.0,15550,16200,82750,4,650,2015
364577,2.8,117290.0,4675,3800,64520,5,-875,2015
467024,3.9,72215.0,17500,17000,61490,5,-500,2015
255513,4.5,81094.0,8575,9800,59100,6,1225,2015
77065,4.2,28120.0,14600,15300,68360,2,700,2014
384651,2.9,36601.0,17300,15700,65610,5,-1600,2015
226999,2.6,59360.0,10600,10400,89090,3,-200,2015
145196,4.5,36437.0,18450,20300,73100,3,1850,2015
356243,4.2,36016.0,17850,18000,62960,1,150,2015
466793,1.9,118527.0,4325,2900,61490,7,-1425,2015
359338,3.8,38132.0,11200,11500,62960,1,300,2015
158165,3.2,22565.0,11250,11400,73100,3,150,2015
292459,2.5,55786.0,11950,9200,59100,2,-2750,2015
492860,4.9,15158.0,8400,9800,73130,3,1400,2015
227050,3.6,100605.0,7500,5500,89090,5,-2000,2015
150365,4.3,35147.0,12400,12000,73100,3,-400,2015
450843,3.5,63990.0,21000,20600,61490,2,-400,2014
36511,4.9,3142.0,20600,20600,77030,1,0,2015
504406,2.9,17886.0,15650,15500,80610,3,-150,2015
39152,1.0,21580.0,12700,9300,77030,1,-3400,2015
328847,3.9,32365.0,12700,12200,82750,2,-500,2015
61884,3.6,33147.0,12400,12000,77030,2,-400,2015
361618,3.1,96705.0,6425,4200,64520,8,-2225,2014
472769,3.4,123965.0,12350,12250,62930,5,-100,2015
435708,1.9,52435.0,9700,8500,74430,3,-1200,2015
26006,4.2,32237.0,24900,25400,77030,3,500,2015
58455,4.9,13076.0,20400,20000,77030,0,-400,2015
240882,1.9,131338.0,1625,1100,59100,12,-525,2014
49890,3.6,120327.0,5325,4000,77030,9,-1325,2015
414106,4.1,76496.0,10900,10800,61450,3,-100,2015
489721,1.9,40668.0,17550,14800,73130,4,-2750,2015
535315,2.1,170100.0,1125,1050,82150,16,-75,2015
291946,4.0,28997.0,16800,16500,59100,1,-300,2015
484203,3.7,32544.0,20000,19600,73130,3,-400,2015
401502,5.0,21777.0,22900,23800,61450,1,900,2015
105568,1.9,143846.0,3250,2000,68360,12,-1250,2015
398369,2.7,120372.0,5450,5900,61450,8,450,2014
384580,4.9,10237.0,28800,27900,65610,3,-900,2015
417022,3.6,85212.0,10900,10000,61450,3,-900,2015
532151,2.6,117083.0,3325,1200,82150,9,-2125,2015
539414,3.4,60989.0,7650,8600,55590,3,950,2015
549045,4.8,3705.0,16200,16900,48460,0,700,2015
373217,4.3,72936.0,30000,30000,64520,4,0,2015
189894,3.6,37858.0,13000,11500,63250,2,-1500,2015
492162,4.1,24537.0,27200,24500,73130,1,-2700,2015
157207,2.5,19397.0,19500,20000,73100,1,500,2015
525819,1.9,182009.0,3125,1500,70210,11,-1625,2015
214494,3.9,46177.0,16500,16400,57290,1,-100,2015
312876,1.9,173704.0,3225,2400,59100,8,-825,2015
307288,1.9,165227.0,775,850,59100,16,75,2015
43751,1.8,123948.0,3400,2700,77030,10,-700,2015
217300,4.0,51941.0,19500,19100,57290,3,-400,2015
435728,2.5,75624.0,6475,6100,74430,4,-375,2015
315075,4.8,35878.0,17650,17700,59100,2,50,2015
323689,3.8,24676.0,21300,18700,82750,2,-2600,2015
150797,3.3,42749.0,14300,14600,73100,3,300,2015
135518,4.4,29000.0,18900,15600,73100,3,-3300,2015
123277,3.5,27065.0,15600,13900,73100,1,-1700,2014
111765,3.4,18958.0,25000,25300,68360,1,300,2015
339791,1.9,7641.0,23000,18850,82750,2,-4150,2015
30086,3.6,42488.0,25000,24750,77030,4,-250,2015
9217,2.7,62277.0,15000,14700,77030,7,-300,2014
254255,2.5,120566.0,3675,3600,59100,8,-75,2015
492065,4.2,32258.0,23300,23000,73130,2,-300,2015
488214,4.2,44211.0,10600,11100,73130,5,500,2015
27993,3.8,97951.0,9425,8900,77030,4,-525,2015
107606,2.0,85952.0,8575,5200,68360,9,-3375,2015
222870,3.7,37595.0,10700,11100,89090,2,400,2015
466838,2.6,178040.0,1950,2000,61490,10,50,2015
339071,2.9,147990.0,3900,3700,82750,7,-200,2015
60445,3.2,85973.0,5175,6500,77030,9,1325,2015
292501,4.7,19459.0,36900,37500,59100,2,600,2015
355100,4.2,41730.0,11350,12100,62960,3,750,2015
186102,3.9,66930.0,11700,12400,63250,3,700,2015
106756,3.5,38902.0,12800,13000,68360,1,200,2015
3412,3.1,141485.0,4175,4100,77030,7,-75,2014
389586,4.6,105581.0,8100,9100,65610,10,1000,2015
163827,4.3,34186.0,26500,26400,73100,3,-100,2015
446466,3.8,151688.0,3200,4100,56120,11,900,2015
544822,2.2,117189.0,4575,6100,81400,10,1525,2015
268673,2.4,35945.0,9725,8900,59100,4,-825,2015
73317,,164848.0,18400,16600,68360,3,-1800,2014
509876,4.4,24555.0,34900,35000,71660,1,100,2015
480562,3.8,22848.0,31300,32700,73130,1,1400,2015
88729,3.8,93271.0,5725,7000,68360,5,1275,2015
87900,3.1,104944.0,3000,2600,68360,14,-400,2015
251263,4.0,29.0,24900,25200,59100,1,300,2015
93746,2.9,127465.0,5300,7800,68360,11,2500,2015
431838,3.2,79320.0,7150,8000,61450,12,850,2015
60981,2.8,75132.0,8225,7600,77030,4,-625,2015
438865,4.0,13894.0,20200,20300,74430,1,100,2015
160281,4.2,37571.0,14700,14700,73100,3,0,2015
384643,3.2,81876.0,7350,6800,65610,5,-550,2015
125120,2.9,47525.0,11500,9900,73100,3,-1600,2015
258481,4.2,29750.0,27700,26500,59100,3,-1200,2015
444522,3.8,101610.0,9450,10000,56120,9,550,2015
59073,3.2,8226.0,17100,16500,77030,0,-600,2015
4744,3.2,99607.0,3650,5550,77030,12,1900,2015
462872,2.0,223715.0,2650,3300,61490,16,650,2015
520009,3.4,19279.0,19500,19900,71660,2,400,2015
174946,3.8,29535.0,11800,11400,83200,3,-400,2015
217379,4.1,49663.0,4100,9100,57290,8,5000,2015
87870,1.0,213893.0,3300,3200,68360,12,-100,2015
426837,3.1,149894.0,3325,4300,61450,7,975,2015
484202,4.1,29967.0,11050,11300,73130,3,250,2015
286278,2.7,106633.0,10900,11600,59100,8,700,2015
212294,4.3,85374.0,35100,37200,57290,3,2100,2015
271754,2.9,149542.0,3500,4200,59100,11,700,2015
450091,1.9,178440.0,1025,2200,61490,11,1175,2014
39952,2.1,21458.0,27800,25000,77030,3,-2800,2015
59516,2.0,54237.0,23600,18250,77030,4,-5350,2015
313493,3.4,54163.0,9400,9200,59100,2,-200,2015
480204,3.9,18180.0,28500,29200,73130,1,700,2015
446666,4.3,98141.0,8675,9800,56120,5,1125,2015
250144,4.6,60139.0,15100,13500,59100,2,-1600,2015
333985,3.5,107037.0,11600,11800,82750,6,200,2015
538102,4.7,57969.0,8475,8500,55590,3,25,2015
545763,3.7,37106.0,24600,26000,81400,4,1400,2015
477997,4.9,5013.0,21200,23100,73130,1,1900,2015
186332,2.0,103398.0,15650,14600,63250,7,-1050,2015
210135,3.9,78119.0,6950,9100,57290,9,2150,2015
509454,4.2,31333.0,16200,16000,71660,1,-200,2015
320979,3.7,30771.0,13500,12500,82750,2,-1000,2015
390950,4.7,23494.0,30400,27700,65610,3,-2700,2015
480778,4.9,19890.0,28400,29200,73130,2,800,2015
345513,2.9,93412.0,13550,10500,82750,10,-3050,2015
208112,4.3,33606.0,21800,22500,57290,1,700,2015
331896,4.1,17477.0,20400,13300,82750,3,-7100,2015
114550,2.9,66526.0,20000,19800,68360,3,-200,2015
118349,3.9,27323.0,26900,25250,68360,1,-1650,2015
527217,2.6,133863.0,5275,4350,70210,12,-925,2015
392217,5.0,27611.0,19100,20700,65610,3,1600,2015
59887,2.8,19341.0,23900,20250,77030,2,-3650,2015
301085,4.5,23795.0,15200,15000,59100,2,-200,2015
202280,4.1,144881.0,5350,5500,57290,8,150,2014
18070,2.0,180666.0,4825,7000,77030,8,2175,2015
120875,4.3,40660.0,20700,16600,73100,0,-4100,2014
90190,3.7,50839.0,18750,16500,68360,2,-2250,2015
243762,3.5,28511.0,18050,17200,59100,3,-850,2015
173386,,97011.0,4950,4300,83200,8,-650,2014
111519,3.7,38794.0,32000,30500,68360,2,-1500,2015
68226,5.0,12546.0,28100,28500,77030,3,400,2015
523524,4.0,55490.0,13700,14900,71660,1,1200,2015
187965,4.2,33410.0,12450,13000,63250,1,550,2015
221177,4.9,11722.0,27300,26800,57290,2,-500,2015
111239,4.9,15638.0,30000,29000,68360,0,-1000,2015
387278,2.3,89292.0,7725,6400,65610,4,-1325,2015
363361,4.9,9849.0,20300,21100,64520,1,800,2015
534484,2.1,25491.0,44500,37400,82150,3,-7100,2015
167299,4.3,30894.0,26600,24800,73100,2,-1800,2015
73284,2.6,104873.0,24100,21500,68360,3,-2600,2014
90890,3.0,59717.0,16000,13000,68360,4,-3000,2015
148988,3.7,130879.0,10700,11400,73100,8,700,2015
194719,2.1,113606.0,5075,3600,67090,9,-1475,2015
236633,3.7,26528.0,10400,9100,59100,2,-1300,2014
87962,4.8,23827.0,27000,24800,68360,2,-2200,2015
547416,4.0,4393.0,19950,19750,78090,1,-200,2015
11789,3.3,147349.0,12200,13600,77030,5,1400,2015
68045,3.5,119115.0,2625,3100,77030,9,475,2015
370543,2.5,53975.0,9200,8600,64520,5,-600,2015
533973,1.9,187108.0,100,750,82150,9,650,2015
205897,3.8,62231.0,30400,30000,57290,3,-400,2015
54016,2.4,46257.0,10700,10000,77030,3,-700,2015
22053,4.0,30073.0,13350,13000,77030,3,-350,2015
114734,2.6,116422.0,8875,5000,68360,8,-3875,2015
494454,1.0,182468.0,900,325,73130,12,-575,2015
473111,3.3,55025.0,11350,12300,62930,3,950,2015
39754,3.6,47061.0,10300,10100,77030,3,-200,2015
16834,2.2,110591.0,15300,14000,77030,5,-1300,2015
3834,,73299.0,9975,8900,77030,8,-1075,2014
363346,4.2,40409.0,15650,15300,64520,1,-350,2015
502311,1.9,48814.0,15000,14700,80610,3,-300,2015
272056,4.5,18289.0,22300,27400,59100,2,5100,2015
481781,4.5,31287.0,12200,13200,73130,3,1000,2015
77499,4.4,72006.0,13050,17700,68360,4,4650,2014
417479,3.9,26094.0,16600,16000,61450,1,-600,2015
150887,4.4,70280.0,4175,4300,73100,11,125,2015
177991,3.6,99083.0,15850,17700,83200,8,1850,2015
72872,3.7,25317.0,12700,12800,77030,3,100,2015
429742,4.9,19068.0,36100,37000,61450,1,900,2015
164512,3.7,25311.0,13000,13100,73100,3,100,2015
152134,4.8,14628.0,22800,23200,73100,3,400,2015
135429,3.8,34432.0,10950,11000,73100,2,50,2015
456627,2.6,134648.0,7300,6600,61490,8,-700,2015
341634,3.1,48918.0,11550,9800,82750,5,-1750,2015
388374,5.0,33518.0,23000,26900,65610,2,3900,2015
398933,3.4,10465.0,21100,21200,61450,1,100,2014
259828,4.4,55276.0,11950,11900,59100,3,-50,2015
55553,2.0,108167.0,1925,1700,77030,17,-225,2015
349112,4.2,60178.0,27000,24300,62960,2,-2700,2014
525794,2.8,109807.0,12400,11700,70210,6,-700,2015
404643,3.6,37915.0,48200,46801,61450,2,-1399,2015
70314,4.1,47069.0,16100,15000,77030,2,-1100,2015
498679,4.2,17930.0,23500,22800,80610,1,-700,2014
136575,3.8,123649.0,1575,2350,73100,13,775,2015
288198,3.0,145436.0,6825,6000,59100,4,-825,2015
525991,3.7,145104.0,10200,6800,70210,3,-3400,2015
298581,3.5,44029.0,29500,27800,59100,3,-1700,2015
17584,4.9,16309.0,15100,15300,77030,2,200,2015
145567,2.8,105470.0,4025,4000,73100,12,-25,2015
48887,4.4,47526.0,40400,41500,77030,3,1100,2015
423410,4.2,37289.0,11700,12700,61450,4,1000,2015
383004,4.6,14893.0,12300,12800,65610,0,500,2014
79923,1.9,117369.0,7525,5700,68360,6,-1825,2015
293114,3.0,35384.0,12700,12700,59100,1,0,2015
267515,4.4,26975.0,22500,23400,59100,3,900,2015
46776,3.6,36069.0,21800,21700,77030,2,-100,2015
148742,4.3,34042.0,27200,27250,73100,2,50,2015
293277,1.9,66083.0,15600,14900,59100,3,-700,2015
442991,3.4,35107.0,22800,24500,74430,4,1700,2015
113492,2.3,99435.0,7175,6600,68360,5,-575,2015
510786,4.9,15417.0,28200,29100,71660,1,900,2015
439178,3.2,133508.0,3575,4700,74430,10,1125,2015
212097,4.8,35156.0,18700,18200,57290,1,-500,2015
389646,4.9,39105.0,23900,23600,65610,4,-300,2015
354974,2.9,78462.0,36300,32500,62960,3,-3800,2015
327597,3.6,11447.0,22700,22000,82750,1,-700,2015
221713,3.5,19572.0,22800,23600,57290,2,800,2015
173097,4.3,5510.0,22400,23000,83200,0,600,2014
194050,2.8,91215.0,7300,4100,67090,9,-3200,2015
424160,2.4,113431.0,8750,9100,61450,8,350,2015
114819,4.2,33867.0,30700,30100,68360,1,-600,2015
278348,3.5,38033.0,16200,16400,59100,1,200,2015
366348,3.1,75219.0,5475,3600,64520,14,-1875,2015
500408,2.3,121830.0,4050,2000,80610,10,-2050,2015
543208,4.2,36075.0,13100,14300,81400,2,1200,2015
283935,4.2,30971.0,25700,22800,59100,2,-2900,2015
516775,4.6,69303.0,11600,12100,71660,4,500,2015
120290,3.3,78191.0,20500,21000,73100,8,500,2015
423439,4.3,10754.0,36100,36800,61450,0,700,2015
147445,4.6,26685.0,7950,8000,73100,3,50,2015
297034,2.7,80445.0,3825,3800,59100,8,-25,2015
170519,4.2,21539.0,24300,25250,73100,2,950,2015
232115,2.8,79964.0,19550,17100,89090,5,-2450,2015
458315,1.8,103715.0,7850,2300,61490,8,-5550,2015
101706,3.9,41120.0,7850,6500,68360,2,-1350,2015
443479,2.0,65924.0,11050,7700,74430,2,-3350,2015
123649,3.6,37324.0,14700,14700,73100,3,0,2015
178016,3.6,154690.0,1050,1500,83200,13,450,2015
171999,2.9,117477.0,25800,27200,73100,4,1400,2015
289868,2.9,89689.0,7550,8500,59100,8,950,2015
183572,3.0,40961.0,8325,8400,63250,2,75,2014
77726,2.6,118463.0,9200,6700,68360,9,-2500,2014
170647,4.4,31974.0,23200,23500,73100,2,300,2015
515258,3.8,68879.0,7375,7600,71660,3,225,2015
221110,4.3,27424.0,19950,20000,57290,2,50,2015
206214,4.9,17443.0,47900,49000,57290,1,1100,2015
6666,3.5,43674.0,38100,36750,77030,3,-1350,2014
495212,3.8,85374.0,4825,5800,73130,7,975,2015
143823,4.2,36608.0,17300,17800,73100,3,500,2015
147122,3.1,35729.0,17250,14900,73100,3,-2350,2015
461759,4.6,26318.0,13900,13400,61490,2,-500,2015
448821,2.9,95540.0,14600,12400,61490,7,-2200,2015
175883,2.9,133970.0,5325,4300,83200,8,-1025,2015
455346,2.8,96107.0,5925,6500,61490,6,575,2015
31601,3.7,83523.0,14800,13300,77030,3,-1500,2015
40991,4.3,38496.0,13000,13300,77030,2,300,2015
461082,2.4,99753.0,5350,8100,61490,9,2750,2015
468844,2.5,56434.0,7925,8500,61490,4,575,2015
108644,2.9,112721.0,4850,4100,68360,6,-750,2015
544930,3.3,110193.0,4700,5000,81400,11,300,2015
543402,2.9,57329.0,20100,22100,81400,3,2000,2015
69991,3.7,42698.0,9650,9750,77030,4,100,2015
79017,1.9,93791.0,8950,5900,68360,7,-3050,2015
18376,4.4,32673.0,18700,21300,77030,4,2600,2015
152904,2.9,92418.0,19600,17900,73100,5,-1700,2015
57102,2.5,53545.0,21500,18850,77030,2,-2650,2015
512134,2.7,35972.0,14150,14200,71660,2,50,2015
39911,4.7,15309.0,22500,24000,77030,3,1500,2015
496775,4.6,18301.0,14400,15100,73130,2,700,2015
441028,3.6,76447.0,8875,8800,74430,3,-75,2015
340987,3.6,17168.0,10700,11100,82750,3,400,2015
427447,3.6,43408.0,12200,11800,61450,1,-400,2015
126372,3.6,54157.0,12900,13600,73100,3,700,2015
363354,2.3,219639.0,375,800,64520,11,425,2015
255271,2.7,103564.0,6000,5200,59100,10,-800,2015
52783,3.6,71888.0,18750,19000,77030,5,250,2015
425873,2.0,194184.0,400,800,61450,11,400,2015
470227,4.2,17452.0,18500,18200,61490,4,-300,2015
79916,1.9,103876.0,6900,7500,68360,6,600,2015
61662,3.2,50364.0,17250,16300,77030,3,-950,2015
119821,,164407.0,5250,4000,73100,4,-1250,2014
65330,3.9,28272.0,49000,50000,77030,2,1000,2015
198742,4.2,16802.0,16550,16200,67090,1,-350,2015
128994,4.9,20228.0,26600,28200,73100,1,1600,2015
282592,2.7,16703.0,11550,11000,59100,0,-550,2015
78300,2.0,125053.0,4200,4200,68360,7,0,2014
77775,1.9,150295.0,3425,2000,68360,12,-1425,2015
97113,2.5,89254.0,9650,9800,68360,6,150,2015
420570,3.2,112450.0,4525,6500,61450,7,1975,2015
547458,2.4,112047.0,6850,4600,78090,9,-2250,2015
369788,2.8,42481.0,12750,11500,64520,3,-1250,2015
61315,4.4,17851.0,12900,13750,77030,3,850,2015
48378,1.9,198288.0,275,500,77030,15,225,2015
115425,3.8,63626.0,11500,13000,68360,2,1500,2015
105550,4.4,98679.0,3825,6300,68360,10,2475,2015
50143,2.0,16529.0,17150,11400,77030,1,-5750,2015
35684,3.0,76149.0,20700,21000,77030,8,300,2015
421493,2.9,108212.0,4550,6200,61450,7,1650,2015
160616,4.6,11225.0,27900,32000,73100,1,4100,2015
355859,3.2,137372.0,3475,3500,62960,10,25,2015
201061,4.6,26796.0,22000,22000,57290,3,0,2014
312947,2.8,68183.0,5450,7400,59100,9,1950,2015
329237,3.2,44238.0,17200,16300,82750,3,-900,2015
185217,3.4,12560.0,23100,23000,63250,2,-100,2015
194240,2.2,179451.0,3125,3500,67090,13,375,2015
53957,4.0,60851.0,9675,9750,77030,3,75,2015
499259,2.5,70195.0,8975,7600,80610,4,-1375,2015
162005,4.3,51808.0,15550,18900,73100,3,3350,2015
180653,4.0,126085.0,4925,5400,83200,8,475,2015
421778,3.7,85792.0,10750,12500,61450,7,1750,2015
255189,2.8,81370.0,29600,28200,59100,5,-1400,2015
493526,3.7,88326.0,11700,11000,73130,5,-700,2015
550182,4.6,6951.0,31900,32300,48460,1,400,2015
114857,3.5,34239.0,20500,21900,68360,1,1400,2015
539331,3.7,18040.0,15300,14000,55590,2,-1300,2015
360248,3.3,56359.0,6075,8200,62960,7,2125,2015
7503,3.8,92614.0,9475,8500,77030,11,-975,2014
176564,3.9,46443.0,27800,26900,83200,1,-900,2015
153165,2.9,23692.0,13250,13000,73100,2,-250,2015
10955,3.8,89675.0,10200,8750,77030,9,-1450,2014
96592,3.6,36487.0,10850,10500,68360,1,-350,2015
462914,4.2,72317.0,8150,9700,61490,4,1550,2015
145608,4.0,8974.0,19350,19700,73100,1,350,2015
105939,2.8,30255.0,13500,7300,68360,2,-6200,2015
39064,4.9,5558.0,18200,17300,77030,1,-900,2015
415223,1.9,156679.0,3825,5300,61450,10,1475,2015
89613,4.1,18331.0,11750,11200,68360,1,-550,2015
321086,2.8,56880.0,10750,8900,82750,3,-1850,2015
365871,4.5,7924.0,15450,16500,64520,1,1050,2015
379017,2.1,33507.0,25100,22500,64520,2,-2600,2015
526184,1.9,148061.0,3050,2400,70210,11,-650,2015
458405,3.1,130108.0,1250,1800,61490,9,550,2015
309212,4.4,21203.0,10200,10500,59100,4,300,2015
394035,4.6,42797.0,15450,14300,65610,3,-1150,2015
160061,3.5,37597.0,26100,27000,73100,3,900,2015
35975,1.0,35775.0,9625,8400,77030,1,-1225,2015
95618,4.2,11744.0,43000,41750,68360,1,-1250,2015
130630,4.5,23420.0,28300,28600,73100,2,300,2015
19358,2.8,163721.0,5125,4300,77030,7,-825,2015
362614,4.6,9794.0,38500,40000,64520,0,1500,2014
328100,3.6,57486.0,14050,14200,82750,7,150,2015
220557,4.7,68571.0,20400,22000,57290,4,1600,2015
6140,2.9,40496.0,11000,10250,77030,1,-750,2014
115179,2.0,39375.0,8675,8200,68360,3,-475,2015
165824,4.2,44426.0,23700,24600,73100,5,900,2015
409917,3.7,141887.0,8525,8200,61450,7,-325,2015
522819,4.8,22787.0,12450,13000,71660,3,550,2015
114854,4.2,12495.0,57500,58750,68360,1,1250,2015
318523,3.1,96892.0,2050,2600,73200,13,550,2015
484025,4.2,45766.0,11900,12900,73130,3,1000,2015
413611,2.5,93004.0,22300,23800,61450,4,1500,2015
104069,2.0,16740.0,13650,12800,68360,3,-850,2015
74929,3.0,154606.0,875,350,68360,12,-525,2014
434340,5.0,9.0,35900,34200,74430,0,-1700,2015
139959,4.8,30006.0,10450,10600,73100,2,150,2015
285715,4.2,106042.0,17550,19600,59100,7,2050,2015
238063,2.8,114007.0,7550,6800,59100,7,-750,2015
286695,2.7,57376.0,14950,13100,59100,4,-1850,2015
424992,2.9,117295.0,3000,4000,61450,6,1000,2015
460382,2.7,53550.0,15150,12500,61490,2,-2650,2015
509827,2.7,83170.0,2375,2600,71660,7,225,2015
212156,4.9,21826.0,26700,27300,57290,2,600,2015
190427,4.7,7616.0,19350,19000,63250,1,-350,2015
241659,2.8,93975.0,9900,8900,59100,5,-1000,2015
299862,4.1,55376.0,15700,15100,59100,2,-600,2015
389741,4.5,11295.0,22400,22200,65610,1,-200,2015
316789,1.9,225936.0,1650,1000,73200,11,-650,2015
72475,2.0,193150.0,1375,2350,77030,18,975,2015
363172,4.8,14000.0,14100,13800,64520,1,-300,2015
162645,3.8,70772.0,17050,14900,73100,3,-2150,2015
547660,3.3,41005.0,18050,17500,78090,3,-550,2015
296090,4.1,47752.0,7225,7900,59100,3,675,2015
328368,2.6,33851.0,20500,18400,82750,3,-2100,2015
231323,3.7,137401.0,2175,1200,89090,16,-975,2015
393542,3.7,28213.0,26200,25500,65610,2,-700,2015
395032,4.3,10108.0,38700,37200,65610,2,-1500,2015
174674,4.2,52553.0,18650,18000,83200,2,-650,2015
95691,4.4,99016.0,40200,36000,68360,2,-4200,2015
547646,3.9,18435.0,10250,9750,78090,2,-500,2015
61968,2.9,40301.0,18250,17500,77030,3,-750,2015
404138,3.3,18816.0,11900,10700,61450,2,-1200,2015
93940,4.0,43830.0,24800,25000,68360,4,200,2015
144575,2.8,37923.0,11100,11800,73100,3,700,2015
72407,3.5,46479.0,17200,17250,77030,3,50,2015
26025,4.8,22420.0,16000,17500,77030,1,1500,2015
423952,4.3,44353.0,18600,20900,61450,3,2300,2015
276294,3.7,31470.0,14900,14200,59100,3,-700,2015
180323,2.3,46426.0,8250,6700,83200,5,-1550,2015
391155,4.2,28220.0,19400,19300,65610,1,-100,2015
496672,4.6,33224.0,23100,24500,73130,1,1400,2015
481036,3.7,90180.0,8800,9200,73130,3,400,2015
509136,3.5,57110.0,13600,12500,71660,3,-1100,2014
31238,2.0,89123.0,4050,2000,77030,15,-2050,2015
434002,2.1,134821.0,2375,2900,74430,12,525,2014
115915,3.7,76504.0,11750,11900,68360,2,150,2015
110209,2.4,39576.0,30400,28000,68360,2,-2400,2015
414085,4.4,20449.0,21700,20800,61450,2,-900,2015
450855,3.8,90922.0,7825,7200,61490,3,-625,2014
439260,4.0,13657.0,26500,26700,74430,1,200,2015
278678,4.9,22054.0,14700,14100,59100,2,-600,2015
256706,4.6,24601.0,10250,10600,59100,3,350,2015
60200,4.3,36181.0,33200,35750,77030,2,2550,2015
18004,3.8,27227.0,15450,19100,77030,4,3650,2015
101851,2.7,139310.0,3175,3000,68360,7,-175,2015
478474,2.5,59228.0,12600,11700,73130,2,-900,2015
205347,3.8,42009.0,18950,21750,57290,4,2800,2015
22756,4.8,6312.0,18650,18500,77030,1,-150,2015
226272,1.9,213038.0,2150,2300,89090,13,150,2015
48099,3.9,43625.0,23400,25250,77030,4,1850,2015
98111,2.6,33976.0,12400,10300,68360,3,-2100,2015
201929,1.0,174085.0,700,500,57290,17,-200,2014
96222,4.2,92254.0,13200,12500,68360,7,-700,2015
75495,4.3,43427.0,13050,13800,68360,1,750,2014
544225,2.2,36551.0,12650,10500,81400,3,-2150,2015
368308,4.8,23097.0,21900,22000,64520,2,100,2015
451024,3.7,135095.0,5275,8000,61490,10,2725,2015
506935,1.9,199968.0,500,1400,80200,10,900,2015
198716,1.9,24985.0,27300,24100,67090,3,-3200,2015
299251,4.7,14681.0,23700,23300,59100,1,-400,2015
464312,3.5,137148.0,5200,6100,61490,7,900,2015
388659,3.7,33965.0,31900,30000,65610,1,-1900,2015
278896,1.9,52452.0,18600,14300,59100,5,-4300,2015
115063,3.4,186459.0,6800,6000,68360,10,-800,2015
492157,4.6,24884.0,19300,19000,73130,1,-300,2015
227310,4.5,144069.0,4225,4300,89090,12,75,2015
149368,3.2,108357.0,7875,6400,73100,9,-1475,2015
15462,1.9,131630.0,5850,4200,77030,10,-1650,2015
322261,2.6,31517.0,14200,12300,82750,4,-1900,2015
50243,3.9,38596.0,14150,14200,77030,1,50,2015
39639,3.2,42821.0,12700,12900,77030,2,200,2015
161467,3.3,88324.0,12400,13600,73100,7,1200,2015
251367,1.4,104693.0,4900,2800,59100,8,-2100,2015
379556,1.9,146494.0,2000,1300,64520,7,-700,2015
475769,,106413.0,2125,2800,73130,9,675,2014
69364,2.0,35993.0,11300,8800,77030,1,-2500,2015
388710,3.7,6852.0,10150,10000,65610,4,-150,2015
296878,3.9,62565.0,11200,10500,59100,2,-700,2015
207861,4.4,38138.0,18000,16800,57290,3,-1200,2015
158590,3.5,49684.0,14600,15400,73100,2,800,2015
180741,3.5,50796.0,9825,9900,83200,2,75,2015
474545,1.0,102490.0,7075,2200,62930,5,-4875,2015
539814,,128803.0,7175,5000,81400,10,-2175,2014
149975,3.7,61885.0,11600,11600,73100,2,0,2015
337880,1.9,144510.0,1350,1000,82750,16,-350,2015
532751,2.5,36378.0,12000,11200,82150,5,-800,2015
213603,4.3,38555.0,14300,15600,57290,3,1300,2015
496194,4.1,11937.0,50600,44000,73130,0,-6600,2015
115347,3.7,50933.0,9150,8800,68360,2,-350,2015
509151,1.9,62238.0,6375,5000,71660,4,-1375,2014
57962,2.7,5866.0,15750,13300,77030,0,-2450,2015
30667,4.3,36433.0,37700,38750,77030,1,1050,2015
121670,,6687.0,27100,26500,73100,0,-600,2014
272047,3.8,54791.0,14150,13900,59100,2,-250,2015
506205,2.4,158733.0,3525,3800,80200,10,275,2014
953,3.9,29499.0,12900,14900,77030,2,2000,2014
202089,2.7,50182.0,13400,12600,57290,3,-800,2014
337049,2.0,23522.0,14300,14300,82750,2,0,2015
155013,4.1,92710.0,5950,6600,73100,10,650,2015
532597,2.8,119661.0,2025,1500,82150,13,-525,2015
437283,2.8,24931.0,11950,12100,74430,4,150,2015
468443,3.4,84797.0,6300,7400,61490,8,1100,2015
33876,2.8,62245.0,10650,12250,77030,5,1600,2015
135443,2.8,25039.0,15500,13600,73100,2,-1900,2015
189263,3.2,53287.0,10300,10800,63250,2,500,2015
29216,5.0,3157.0,22500,24250,77030,1,1750,2015
248622,4.2,33272.0,9900,10100,59100,2,200,2015
200803,1.9,43716.0,10650,10400,67090,2,-250,2015
446972,2.0,68518.0,10450,10100,56120,7,-350,2015
332846,3.7,30227.0,14400,14300,82750,3,-100,2015
496822,2.9,46968.0,8550,8600,73130,2,50,2015
417010,4.2,15872.0,10150,10300,61450,1,150,2015
431406,2.8,116775.0,8150,8300,61450,8,150,2015
509510,4.3,18173.0,20900,20500,71660,1,-400,2015
216130,4.9,16582.0,12300,13200,57290,1,900,2015
299005,1.9,154285.0,4050,4000,59100,12,-50,2015
403689,3.5,19186.0,11250,10500,61450,3,-750,2015
129818,2.8,43145.0,8750,8300,73100,4,-450,2015
136760,4.2,36883.0,26800,26600,73100,4,-200,2015
128136,4.3,20272.0,67000,68500,73100,2,1500,2015
178377,4.1,57515.0,11900,11600,83200,2,-300,2015
97551,3.6,39377.0,22000,21700,68360,2,-300,2015
147157,3.7,20515.0,11500,11200,73100,3,-300,2015
97621,1.9,114271.0,6100,6900,68360,5,800,2015
70883,3.6,12483.0,20000,18100,77030,3,-1900,2015
386314,2.9,59636.0,10300,10100,65610,3,-200,2015
497660,3.9,18766.0,26200,26500,73130,2,300,2015
438125,2.8,120569.0,1875,1600,74430,13,-275,2015
398918,3.8,40621.0,12100,12300,61450,2,200,2015
272590,2.9,87660.0,7050,7300,59100,5,250,2015
31046,2.9,41993.0,2225,2100,77030,9,-125,2015
256232,3.6,20354.0,21600,21800,59100,1,200,2015
103342,2.9,98064.0,11800,13500,68360,8,1700,2015
146909,4.9,611.0,14100,13800,73100,2,-300,2015
492028,4.8,25160.0,18900,19900,73130,2,1000,2015
41553,2.7,68286.0,9900,12500,77030,8,2600,2015
437282,2.9,22161.0,10350,10400,74430,4,50,2015
6215,4.7,22636.0,22400,23400,77030,1,1000,2014
517463,2.3,134402.0,3275,3200,71660,10,-75,2015
266081,4.3,23289.0,23900,19800,59100,2,-4100,2015
35906,2.9,179488.0,5850,9000,77030,13,3150,2015
254531,1.9,94772.0,3300,2600,59100,15,-700,2015
393566,3.8,109146.0,6600,6500,65610,8,-100,2015
163112,1.9,154572.0,12000,8600,73100,7,-3400,2015
307354,4.1,32045.0,27700,27400,59100,2,-300,2015
442419,4.0,16536.0,16500,15800,74430,1,-700,2015
158045,4.3,25151.0,16500,18000,73100,3,1500,2015
40609,2.7,75460.0,7125,5000,77030,15,-2125,2015
120439,1.0,3148.0,15400,11500,73100,0,-3900,2015
446643,2.5,172808.0,3100,2300,56120,14,-800,2015
147068,3.7,39801.0,11750,11400,73100,3,-350,2015
236611,4.4,33248.0,11400,13200,59100,2,1800,2014
464678,2.2,101485.0,9150,7300,61490,8,-1850,2015
343632,3.5,102768.0,3525,3900,82750,7,375,2015
539251,1.9,130362.0,3700,1900,55590,10,-1800,2015
514511,3.8,34112.0,19600,19300,71660,3,-300,2015
257443,4.6,41611.0,15800,18000,59100,1,2200,2015
180374,4.4,15795.0,27300,26100,83200,2,-1200,2015
361958,1.0,181646.0,1550,350,64520,13,-1200,2014
537065,4.9,74462.0,21100,22200,73640,4,1100,2015
68833,4.0,58549.0,14950,13901,77030,2,-1049,2015
539716,2.7,177720.0,19800,18500,81400,6,-1300,2014
220292,3.0,73583.0,24500,27200,57290,4,2700,2015
241931,1.9,147326.0,3625,1800,59100,10,-1825,2015
306677,3.1,91765.0,29500,31000,59100,4,1500,2015
162138,3.9,35615.0,16350,16800,73100,6,450,2015
74984,,130087.0,3500,3100,68360,13,-400,2014
459082,3.7,55640.0,10300,11400,61490,4,1100,2015
481370,4.6,15039.0,15100,15200,73130,2,100,2015
238791,2.8,162178.0,1300,1200,59100,12,-100,2014
305451,4.6,30449.0,10800,11300,59100,2,500,2015
460156,1.0,273455.0,575,300,61490,14,-275,2015
344707,1.9,68753.0,19750,17400,82750,2,-2350,2015
482716,1.0,18733.0,12350,12100,73130,1,-250,2015
455525,3.1,63357.0,15550,15100,61490,4,-450,2015
6077,4.2,43550.0,13900,14800,77030,1,900,2015
16664,3.6,77713.0,4375,5600,77030,4,1225,2015
409960,1.9,160062.0,3575,3200,61450,9,-375,2015
340257,2.3,66335.0,18800,14500,82750,2,-4300,2015
435510,4.8,32257.0,13650,13200,74430,2,-450,2015
72019,4.4,82583.0,5950,7400,77030,7,1450,2015
116794,3.3,62270.0,10450,10000,68360,3,-450,2015
18111,3.8,121099.0,7900,8500,77030,11,600,2015
165761,4.0,49788.0,22200,22500,73100,3,300,2015
13899,3.4,129624.0,4125,3800,77030,8,-325,2015
433903,3.5,31004.0,15250,15500,74430,1,250,2014
445207,3.9,80369.0,14350,14500,56120,5,150,2015
223037,3.7,24182.0,25300,25800,89090,1,500,2015
315028,2.0,148575.0,1525,1700,59100,14,175,2015
436093,3.2,89531.0,13100,10800,74430,4,-2300,2015
166417,3.2,148114.0,10550,12900,73100,7,2350,2015
197011,2.9,132759.0,3050,3300,67090,7,250,2015
425686,2.0,41831.0,9075,6100,61450,1,-2975,2015
377194,2.8,37593.0,12350,12400,64520,2,50,2015
194140,3.8,102915.0,7050,7100,67090,3,50,2015
212956,4.3,67743.0,18500,22000,57290,4,3500,2015
347224,2.9,106838.0,8300,8000,82750,9,-300,2015
28283,4.1,140774.0,10650,12600,77030,11,1950,2015
497820,1.9,52752.0,10500,9000,73130,3,-1500,2015
207177,4.7,37187.0,18700,19200,57290,4,500,2015
487828,4.6,19492.0,12500,11900,73130,1,-600,2015
476746,3.1,82955.0,17200,16600,73130,2,-600,2014
420804,4.9,21098.0,24500,24500,61450,2,0,2015
324551,2.6,134396.0,4575,3800,82750,12,-775,2015
301770,1.9,134057.0,7425,6300,59100,9,-1125,2015
380596,4.0,22240.0,25000,23200,64520,3,-1800,2015
79692,4.6,24940.0,22300,24500,68360,3,2200,2015
50785,1.9,81892.0,9425,8600,77030,3,-825,2015
188030,4.1,64433.0,23700,23000,63250,4,-700,2015
315948,1.9,138682.0,4750,3700,59100,9,-1050,2015
115925,3.7,18095.0,11100,11500,68360,2,400,2015
150637,4.1,72516.0,22200,24250,73100,5,2050,2015
511113,3.7,37280.0,9050,9200,71660,2,150,2015
113475,2.9,53216.0,22700,21500,68360,4,-1200,2015
427836,3.8,95945.0,11700,12600,61450,7,900,2015
111950,3.7,25990.0,33000,36250,68360,1,3250,2015
293965,1.9,89457.0,5825,4000,59100,6,-1825,2015
193636,2.9,11632.0,12600,12000,67090,1,-600,2015
495430,4.7,26401.0,19950,20000,73130,1,50,2015
72333,1.9,121312.0,1525,2000,77030,12,475,2015
281347,3.3,17887.0,16000,15000,59100,1,-1000,2015
315285,2.7,128118.0,1275,1100,59100,10,-175,2015
127142,4.4,12936.0,33600,33100,73100,0,-500,2015
252844,3.0,15847.0,14950,14600,59100,1,-350,2015
96003,1.9,79459.0,10300,9300,68360,4,-1000,2015
173007,4.7,40353.0,20600,21700,83200,4,1100,2015
414527,3.7,54873.0,8425,9000,61450,3,575,2015
373705,4.3,145022.0,5525,6400,64520,7,875,2015
506614,3.4,20419.0,28200,27500,80200,1,-700,2015
265059,3.1,100900.0,3350,4700,59100,14,1350,2015
122744,3.8,119212.0,7200,7500,73100,7,300,2015
495745,3.7,46335.0,9950,10100,73130,2,150,2015
20393,3.5,40323.0,29100,27500,77030,3,-1600,2015
151572,3.0,29578.0,16850,16400,73100,1,-450,2015
464800,4.1,88972.0,7100,9800,61490,10,2700,2015
376482,4.0,82464.0,16950,18900,64520,5,1950,2015
56922,4.5,36270.0,30900,29500,77030,1,-1400,2015
208835,4.4,44223.0,12900,12800,57290,2,-100,2015
45152,2.0,113695.0,6650,6500,77030,9,-150,2015
492143,4.8,33185.0,11000,12200,73130,1,1200,2015
29436,4.3,39519.0,13400,14000,77030,2,600,2015
46977,3.3,35849.0,17200,16000,77030,3,-1200,2015
503587,3.0,21876.0,14350,14500,80610,1,150,2015
288279,2.1,124453.0,6750,5700,59100,10,-1050,2015
113781,3.6,94936.0,12600,13000,68360,6,400,2015
213552,5.0,29784.0,24100,25000,57290,2,900,2015
373623,3.7,33678.0,13400,13700,64520,3,300,2015
92234,4.1,14170.0,22400,25100,68360,2,2700,2015
101276,2.1,91300.0,4925,4900,68360,9,-25,2015
428241,4.5,23094.0,14200,13900,61450,1,-300,2015
291127,2.1,33925.0,8800,8800,59100,5,0,2015
526786,5.0,9094.0,13300,14200,70210,3,900,2015
262672,2.1,85724.0,7200,6100,59100,6,-1100,2015
309849,5.0,25748.0,43200,46000,59100,3,2800,2015
208391,3.8,21475.0,15700,15200,57290,1,-500,2015
234680,,151282.0,6950,6800,59100,8,-150,2014
66502,2.8,52072.0,11000,11000,77030,2,0,2015
29538,3.2,69947.0,23300,23000,77030,3,-300,2015
343717,4.9,6082.0,33200,35000,82750,0,1800,2015
440660,1.9,154923.0,1425,900,74430,9,-525,2015
520096,2.3,80889.0,5825,9500,71660,5,3675,2015
1853,4.4,24382.0,20800,23000,77030,3,2200,2014
304093,1.9,232956.0,500,400,59100,16,-100,2015
351379,4.4,11422.0,16700,18300,62960,2,1600,2015
353258,2.5,61955.0,8200,7800,62960,3,-400,2015
206217,4.1,28461.0,30100,31800,57290,2,1700,2015
268634,4.0,43645.0,12550,13300,59100,3,750,2015
258874,4.7,18446.0,20400,19200,59100,4,-1200,2015
256788,4.1,25496.0,21500,22200,59100,3,700,2015
397055,1.9,138654.0,3150,2600,65610,9,-550,2015
324346,3.3,50478.0,7950,7800,82750,3,-150,2015
55657,3.7,44156.0,12800,12500,77030,2,-300,2015
523863,,56429.0,21300,21500,70210,2,200,2014
430018,4.8,28495.0,26900,29000,61450,2,2100,2015
505505,4.4,37520.0,26000,27000,80610,3,1000,2015
31372,4.3,30562.0,23200,26300,77030,2,3100,2015
389704,3.6,32160.0,28900,27000,65610,3,-1900,2015
157525,4.2,53010.0,28900,28700,73100,3,-200,2015
53737,3.7,24249.0,13350,14200,77030,2,850,2015
118783,2.8,140913.0,9075,7000,68360,11,-2075,2015
25665,2.7,100078.0,5500,5200,77030,11,-300,2015
418766,3.4,92842.0,11550,14000,61450,8,2450,2015
372895,3.4,134409.0,6950,8300,64520,11,1350,2015
532841,3.7,51882.0,13600,13100,82150,2,-500,2015
504148,4.6,27613.0,20800,22300,80610,2,1500,2015
314486,4.1,60263.0,15450,16600,59100,2,1150,2015
76514,2.5,87991.0,8725,7600,68360,6,-1125,2014
321192,3.9,17093.0,14700,14900,82750,1,200,2014
399932,3.3,22525.0,21700,18400,61450,1,-3300,2015
539443,1.0,155334.0,4275,2600,55590,14,-1675,2015
418738,3.3,139420.0,9275,9500,61450,5,225,2015
539566,1.9,139500.0,26200,22700,55590,4,-3500,2015
13500,4.3,30216.0,16000,16500,77030,3,500,2015
419587,3.5,103992.0,8300,8900,61450,8,600,2015
329975,2.6,122815.0,1400,1500,82750,17,100,2015
538112,3.5,136930.0,5475,7000,55590,6,1525,2015
98918,4.8,42851.0,18750,18400,68360,3,-350,2015
103762,2.9,173697.0,1150,2000,68360,14,850,2015
472783,2.0,85505.0,4675,1500,62930,10,-3175,2015
180371,4.7,16954.0,13900,14300,83200,2,400,2015
543252,2.9,166750.0,11150,8800,81400,6,-2350,2015
437442,3.5,37777.0,11350,10500,74430,2,-850,2015
455001,2.4,105685.0,4650,5200,61490,10,550,2015
355913,2.0,214355.0,800,500,62960,20,-300,2015
427002,3.4,50884.0,22100,24000,61450,5,1900,2015
524809,,107149.0,1250,600,70210,15,-650,2014
174501,4.3,67891.0,9400,9600,83200,3,200,2015
544567,3.4,92681.0,14750,15900,81400,8,1150,2015
214039,4.3,24760.0,10550,10600,57290,1,50,2015
435962,2.0,85662.0,1275,1000,74430,17,-275,2015
275441,4.1,61547.0,11000,11000,59100,2,0,2015
367337,3.8,30029.0,12400,12600,64520,3,200,2015
349481,3.5,63453.0,16450,16500,62960,1,50,2014
124346,2.7,90238.0,8675,7400,73100,3,-1275,2015
260129,4.4,36954.0,32300,34800,59100,2,2500,2015
346917,3.9,41044.0,9525,9900,82750,3,375,2015
430930,3.6,40535.0,12800,13300,61450,1,500,2015
17073,2.8,57890.0,4550,1200,77030,10,-3350,2015
58072,4.5,8601.0,8600,10000,77030,3,1400,2015
75569,2.8,34777.0,10650,11800,68360,2,1150,2014
163325,4.7,21032.0,22500,24300,73100,2,1800,2015
163624,2.0,198232.0,1450,400,73100,14,-1050,2015
280222,4.9,21466.0,24300,26000,59100,2,1700,2015
416661,2.5,60892.0,15400,15300,61450,4,-100,2015
316771,4.4,51641.0,24900,27400,73200,4,2500,2015
115918,3.7,52172.0,22200,21200,68360,2,-1000,2015
446769,2.5,161457.0,3650,4700,56120,8,1050,2015
538436,1.9,111424.0,4475,3100,55590,8,-1375,2015
285360,4.3,17876.0,29000,31200,59100,1,2200,2015
515383,2.4,113972.0,3725,3600,71660,8,-125,2015
363122,4.4,13785.0,15500,15000,64520,1,-500,2015
467058,4.0,49240.0,1975,4100,61490,12,2125,2015
10830,1.9,141212.0,8250,6800,77030,8,-1450,2015
394199,4.5,27565.0,22900,23000,65610,1,100,2015
168826,2.6,78952.0,44900,38000,73100,3,-6900,2015
353706,4.3,9806.0,15300,14800,62960,1,-500,2015
538853,3.6,109888.0,1550,2600,55590,16,1050,2015
37213,2.5,76968.0,8050,6000,77030,12,-2050,2015
496045,4.0,13288.0,16400,17200,73130,0,800,2015
247765,4.1,43151.0,33200,34000,59100,4,800,2015
376545,1.9,130566.0,6300,4400,64520,4,-1900,2015
40914,2.0,51378.0,10450,4750,77030,2,-5700,2015
397517,3.5,54579.0,10750,10700,65610,2,-50,2015
502912,4.5,31992.0,25300,25700,80610,1,400,2015
461862,2.6,97496.0,8750,8100,61490,9,-650,2015
373665,4.3,37362.0,36000,36500,64520,4,500,2015
45146,2.9,176525.0,4850,3400,77030,9,-1450,2015
30486,2.8,131631.0,4350,3500,77030,12,-850,2015
442967,2.5,126216.0,625,225,74430,16,-400,2015
466067,2.9,55578.0,22600,22500,61490,3,-100,2015
276335,4.3,47918.0,21100,22400,59100,3,1300,2015
184140,1.9,120706.0,4500,2700,63250,11,-1800,2015
527827,4.5,45406.0,25400,25800,70210,2,400,2015
473142,1.0,67186.0,8850,3100,62930,6,-5750,2015
436169,2.6,132030.0,3150,2300,74430,9,-850,2015
426703,3.6,129017.0,12350,13500,61450,8,1150,2015
114482,4.9,10047.0,26600,27600,68360,0,1000,2015
222705,2.1,134214.0,2800,2200,89090,7,-600,2014
364523,4.7,27908.0,21400,21500,64520,2,100,2015
134047,3.8,20326.0,15250,15300,73100,4,50,2015
234204,,113915.0,5825,5700,59100,7,-125,2014
494435,4.7,6497.0,10350,10000,73130,1,-350,2015
168289,2.6,28886.0,13300,12200,73100,3,-1100,2015
137038,3.3,88769.0,10650,11200,73100,9,550,2015
278036,2.5,149974.0,2475,2600,59100,13,125,2015
192409,3.8,17336.0,22400,20700,67090,2,-1700,2015
54067,2.7,43308.0,19850,18000,77030,4,-1850,2015
422742,4.1,27876.0,19700,18900,61450,1,-800,2015
519456,3.2,43271.0,16150,17600,71660,4,1450,2015
312845,5.0,1350.0,14850,14800,59100,0,-50,2015
128481,3.4,62030.0,14200,14800,73100,3,600,2015
545783,2.0,56389.0,8125,9700,81400,6,1575,2015
166669,4.8,12221.0,41400,41750,73100,3,350,2015
66449,4.2,22683.0,20000,20500,77030,1,500,2015
228488,2.9,56878.0,10800,10100,89090,3,-700,2015
472607,2.7,83703.0,9700,8100,62930,2,-1600,2015
305071,4.4,28179.0,13750,15100,59100,3,1350,2015
50403,2.8,62360.0,7925,8100,77030,4,175,2015
256703,3.5,15460.0,12750,12100,59100,3,-650,2015
362705,4.4,10834.0,67000,65500,64520,0,-1500,2014
158754,3.6,63773.0,7700,8900,73100,3,1200,2015
450036,3.2,131246.0,7075,6600,61490,7,-475,2014
214076,4.9,28007.0,18100,18000,57290,2,-100,2015
24369,3.5,52977.0,7575,7600,77030,4,25,2015
55868,4.2,25798.0,15250,18250,77030,5,3000,2015
339645,4.3,21943.0,26000,26200,82750,1,200,2015
154791,4.0,10312.0,34700,34200,73100,2,-500,2015
480639,4.0,21543.0,13250,13000,73130,1,-250,2015
160931,3.5,17885.0,8475,9200,73100,9,725,2015
256278,3.1,149317.0,2725,2000,59100,11,-725,2015
469607,3.9,120686.0,1550,2500,61490,11,950,2015
512625,4.2,42922.0,22500,21100,71660,3,-1400,2015
492971,3.6,13317.0,35500,31600,73130,1,-3900,2015
437000,2.4,100045.0,7600,8300,74430,5,700,2015
326498,3.6,133323.0,4025,4100,82750,9,75,2015
448286,4.1,94438.0,10900,10900,56120,4,0,2015
504438,2.0,92336.0,16150,16100,80610,6,-50,2015
395949,1.9,161977.0,2975,2300,65610,13,-675,2015
138368,4.3,15918.0,12450,12900,73100,1,450,2015
533293,3.5,142537.0,6500,5900,82150,6,-600,2015
226365,2.5,97129.0,4925,4600,89090,7,-325,2015
440964,1.9,131657.0,5075,2800,74430,9,-2275,2015
295372,1.9,46886.0,12900,10800,59100,4,-2100,2015
225249,2.6,156410.0,5300,3900,89090,10,-1400,2015
204765,4.3,44635.0,18700,19900,57290,3,1200,2015
59309,4.4,12688.0,14750,14300,77030,1,-450,2015
125396,1.0,209396.0,875,550,73100,20,-325,2015
96917,4.4,36269.0,31500,32500,68360,3,1000,2015
206158,3.9,39380.0,19950,20000,57290,2,50,2015
339841,2.9,44494.0,8950,8200,82750,2,-750,2015
421308,1.9,91256.0,2200,1500,61450,11,-700,2015
55687,4.1,33435.0,27900,25750,77030,3,-2150,2015
2137,3.0,28278.0,11900,12100,77030,0,200,2014
314996,2.6,116300.0,3000,3000,59100,9,0,2015
113043,2.3,125116.0,9100,8800,68360,9,-300,2015
208113,4.5,37600.0,20000,19900,57290,1,-100,2015
520375,2.7,58686.0,9100,8100,71660,3,-1000,2015
292768,3.8,22798.0,35300,32500,59100,1,-2800,2015
428260,4.4,12700.0,13900,14800,61450,2,900,2015
196379,4.8,12676.0,15650,14900,67090,1,-750,2015
33077,4.4,28753.0,15750,16750,77030,2,1000,2015
95152,3.8,18257.0,33100,30000,68360,2,-3100,2015
530363,2.6,101019.0,8725,7200,82150,7,-1525,2015
159012,2.3,32675.0,11800,10400,73100,3,-1400,2015
45159,3.5,82052.0,7775,8800,77030,9,1025,2015
166517,3.5,184271.0,2750,4100,73100,13,1350,2015
455197,3.0,66397.0,5500,5200,61490,6,-300,2015
214440,3.5,44113.0,39200,38900,57290,1,-300,2015
300963,4.3,19656.0,21200,22400,59100,2,1200,2015
529367,3.5,22198.0,11850,10700,70210,1,-1150,2015
516513,2.1,14054.0,9400,7300,71660,2,-2100,2015
289574,3.5,64701.0,8375,8600,59100,3,225,2015
176942,3.6,87083.0,17600,17500,83200,2,-100,2015
371424,2.5,78023.0,6050,5800,64520,7,-250,2015
115674,2.5,122499.0,3550,2200,68360,5,-1350,2015
367342,4.2,45004.0,12550,12800,64520,3,250,2015
130119,4.3,23319.0,14400,13700,73100,2,-700,2015
457266,4.3,62513.0,13550,15300,61490,5,1750,2015
369254,3.7,80380.0,5675,5600,64520,7,-75,2015
298550,4.3,14211.0,32400,32000,59100,0,-400,2015
364726,4.4,21326.0,23400,24100,64520,3,700,2015
225308,1.0,194585.0,1525,1000,89090,13,-525,2015
513857,4.6,27029.0,17600,17800,71660,1,200,2015
331609,3.9,87388.0,9100,10000,82750,5,900,2015
197656,2.8,83975.0,10600,7800,67090,7,-2800,2015
46594,1.9,241803.0,1825,1200,77030,16,-625,2015
504256,4.2,31637.0,18850,17300,80610,1,-1550,2015
357026,3.7,34745.0,31400,34750,62960,2,3350,2015
296227,3.6,99194.0,4950,6400,59100,5,1450,2015
465587,2.2,107963.0,3700,3400,61490,12,-300,2015
454291,4.2,120664.0,6025,6200,61490,6,175,2015
87735,2.9,127948.0,15150,15600,68360,8,450,2015
544324,2.7,27208.0,20100,19750,81400,3,-350,2015
1993,4.7,24192.0,28400,28500,77030,3,100,2014
390080,4.0,55115.0,12000,11900,65610,2,-100,2015
107959,3.7,35534.0,22600,21700,68360,3,-900,2015
299148,4.8,3689.0,8525,9600,59100,1,1075,2015
448194,3.6,83901.0,6625,6200,56120,7,-425,2015
332947,1.9,39594.0,18000,14600,82750,4,-3400,2015
65727,4.3,79123.0,12350,13000,77030,3,650,2015
511858,4.3,27870.0,19800,18600,71660,4,-1200,2015
530228,2.7,111240.0,5725,6000,82150,8,275,2015
348576,3.9,40401.0,12650,13000,62960,1,350,2014
99530,3.1,83305.0,9750,11300,68360,7,1550,2015
451328,3.0,141467.0,2425,2000,61490,10,-425,2015
217595,2.9,187578.0,5050,6900,57290,11,1850,2015
403489,2.0,22959.0,12700,9200,61450,1,-3500,2015
312479,4.2,25157.0,25500,27000,59100,3,1500,2015
516030,4.1,21800.0,18950,18400,71660,2,-550,2015
20688,4.2,40596.0,10800,11500,77030,4,700,2015
177415,2.0,14141.0,17500,17500,83200,1,0,2015
456676,3.3,111451.0,2350,2700,61490,10,350,2015
416261,1.9,82301.0,7400,5500,61450,7,-1900,2015
71367,2.9,58789.0,8925,9100,77030,2,175,2015
140809,4.2,31773.0,11100,11300,73100,3,200,2015
24636,4.2,36445.0,11700,11800,77030,1,100,2015
504950,4.7,16268.0,31100,30000,80610,1,-1100,2015
14195,4.0,45580.0,28000,28000,77030,2,0,2015
92842,1.9,140334.0,3550,2400,68360,12,-1150,2015
80016,3.0,49637.0,5475,5800,68360,7,325,2015
400659,4.1,26519.0,13100,13000,61450,1,-100,2014
488769,3.1,30153.0,15650,15400,73130,3,-250,2015
288437,3.9,63736.0,25600,26800,59100,2,1200,2015
107463,1.7,85496.0,5775,3500,68360,6,-2275,2015
123252,3.8,24202.0,14250,12900,73100,2,-1350,2015
376679,4.7,14153.0,13500,14100,64520,2,600,2015
9541,2.1,154912.0,2350,2300,77030,12,-50,2014
238268,4.1,155024.0,8750,11850,59100,7,3100,2014
504971,4.2,29959.0,10950,11500,80610,4,550,2015
405965,4.5,14879.0,29300,27800,61450,1,-1500,2015
193338,3.8,63930.0,9550,9500,67090,3,-50,2015
323312,3.9,107349.0,9450,9600,82750,4,150,2015
114794,1.9,73083.0,10800,11500,68360,11,700,2015
347936,2.7,57800.0,11100,11500,62960,6,400,2014
168896,2.9,62106.0,8925,8300,73100,3,-625,2015
186265,3.8,88015.0,9675,9800,63250,3,125,2015
168444,2.5,34336.0,11600,11100,73100,3,-500,2015
63978,3.5,123297.0,4575,5900,77030,12,1325,2015
22497,2.9,143290.0,2150,2200,77030,11,50,2015
457685,4.2,29833.0,16900,15500,61490,1,-1400,2015
201126,3.3,47733.0,16100,18000,57290,3,1900,2014
367090,4.4,69662.0,17950,17500,64520,4,-450,2015
489004,3.2,62584.0,20000,18500,73130,4,-1500,2015
510029,4.5,129005.0,8150,8800,71660,4,650,2015
315372,4.9,7264.0,14700,14900,59100,1,200,2015
88810,4.9,11972.0,15250,16500,68360,1,1250,2015
419929,2.9,71078.0,11850,11500,61450,3,-350,2015
467031,1.9,170284.0,17950,17500,61490,7,-450,2015
337910,2.7,109479.0,4775,5100,82750,8,325,2015
501360,2.1,8180.0,28200,26000,80610,1,-2200,2015
168017,2.6,23778.0,21100,18750,73100,2,-2350,2015
30297,3.5,75743.0,5450,4000,77030,9,-1450,2015
54671,3.5,56724.0,15700,15700,77030,3,0,2015
338235,3.8,107750.0,10300,11000,82750,7,700,2015
390389,4.6,51418.0,12150,12700,65610,2,550,2015
430438,2.6,92564.0,10250,10400,61450,6,150,2015
405025,4.3,68342.0,5800,5300,61450,7,-500,2015
101401,4.9,25630.0,17450,18600,68360,3,1150,2015
487692,3.6,93045.0,18250,17600,73130,4,-650,2015
539499,2.3,83391.0,14000,14500,55590,12,500,2015
473943,1.0,153589.0,1025,600,62930,12,-425,2015
71248,2.4,8626.0,15900,14250,77030,1,-1650,2015
421130,3.7,184074.0,2175,2900,61450,10,725,2015
447656,4.5,60336.0,14550,15200,56120,2,650,2015
203670,2.8,33450.0,15850,16600,57290,4,750,2015
199246,2.7,15221.0,15300,14300,67090,1,-1000,2015
52516,1.9,94227.0,575,1400,77030,18,825,2015
433313,1.9,99048.0,2725,3400,74430,11,675,2014
315241,1.9,216106.0,5825,6200,59100,8,375,2015
222669,4.1,60231.0,14050,15000,89090,6,950,2014
94874,4.3,39757.0,12700,13100,68360,2,400,2015
124519,1.9,82497.0,12200,10200,73100,6,-2000,2015
496853,3.4,27379.0,11850,12800,73130,3,950,2015
366293,1.0,111955.0,2500,1250,64520,9,-1250,2015
450418,2.9,147826.0,5750,4800,61490,8,-950,2015
14544,3.5,39864.0,14300,14000,77030,2,-300,2015
225667,3.9,99109.0,7725,7700,89090,7,-25,2015
410228,3.8,336435.0,2775,3000,61450,12,225,2015
69245,4.3,17630.0,16250,16300,77030,3,50,2015
454106,1.9,191351.0,525,400,61490,17,-125,2015
110867,2.0,134941.0,7600,10100,68360,11,2500,2015
145425,2.8,101766.0,13050,14100,73100,8,1050,2015
16430,2.0,57524.0,10500,11200,77030,3,700,2015
403059,3.5,55849.0,6450,7500,61450,3,1050,2015
423701,4.5,26996.0,31200,35200,61450,3,4000,2015
360472,3.7,77518.0,15200,15700,64520,2,500,2014
252972,3.9,45842.0,13050,13100,59100,4,50,2015
365753,4.2,50883.0,26000,24500,64520,4,-1500,2015
484322,4.9,44540.0,11450,10600,73130,3,-850,2015
154457,3.5,60773.0,25000,27200,73100,6,2200,2015
530642,1.9,193043.0,1200,700,82150,10,-500,2015
350249,3.7,67845.0,6125,6300,62960,8,175,2014
197716,4.3,30694.0,13450,13200,67090,2,-250,2015
250719,3.6,38153.0,12300,12300,59100,2,0,2015
414398,3.2,48382.0,11250,10200,61450,2,-1050,2015
268163,1.9,108620.0,1925,2300,59100,11,375,2015
543367,3.5,13996.0,12050,12800,81400,2,750,2015
239243,4.8,23325.0,18800,18500,59100,0,-300,2015
518087,2.7,117997.0,5650,4300,71660,8,-1350,2015
154402,2.2,86426.0,12650,11100,73100,5,-1550,2015
525397,2.2,132187.0,5000,3300,70210,7,-1700,2015
418956,3.0,201768.0,6775,5600,61450,4,-1175,2015
17513,4.7,11458.0,53000,46500,77030,2,-6500,2015
227342,2.3,196023.0,1150,1200,89090,13,50,2015
192767,3.2,58553.0,34900,32600,67090,4,-2300,2015
38366,4.1,9682.0,24100,23400,77030,3,-700,2015
526434,4.8,30691.0,31700,30400,70210,3,-1300,2015
145204,3.6,58501.0,24500,25000,73100,3,500,2015
150248,4.2,35465.0,13650,13200,73100,2,-450,2015
499192,4.0,27967.0,16600,16000,80610,1,-600,2015
411946,3.6,106091.0,2650,3600,61450,8,950,2015
532564,4.0,76469.0,11300,10900,82150,3,-400,2015
529064,2.8,64797.0,15300,18100,70210,7,2800,2015
27996,4.3,79429.0,11800,13000,77030,4,1200,2015
100679,3.5,67603.0,18450,16000,68360,3,-2450,2015
102274,2.7,95351.0,25600,27800,68360,4,2200,2015
467550,2.0,213012.0,3250,3100,61490,11,-150,2015
59258,5.0,9679.0,36400,37000,77030,1,600,2015
15711,3.3,173215.0,1225,1700,77030,13,475,2015
213573,3.6,40964.0,13850,13400,57290,3,-450,2015
270420,2.3,76030.0,5400,5100,59100,7,-300,2015
294708,2.0,178541.0,3250,1500,59100,12,-1750,2015
251670,3.7,85362.0,5825,5600,59100,7,-225,2015
155850,3.7,37255.0,15700,14600,73100,2,-1100,2015
41699,4.3,87079.0,9400,11200,77030,9,1800,2015
46202,3.7,117260.0,3400,4000,77030,8,600,2015
502421,3.5,49742.0,17900,18700,80610,2,800,2015
442833,2.2,141192.0,2225,2350,74430,11,125,2015
157431,3.6,35615.0,12350,12000,73100,3,-350,2015
225171,2.9,142012.0,5675,3100,89090,6,-2575,2015
477697,4.0,20196.0,16700,17100,73130,1,400,2015
303056,2.7,29485.0,11900,11200,59100,3,-700,2015
65557,4.8,37675.0,33600,34500,77030,3,900,2015
70316,3.6,17194.0,11150,9750,77030,2,-1400,2015
117243,2.5,124284.0,3050,2100,68360,10,-950,2015
267656,4.2,39375.0,12950,13100,59100,3,150,2015
315145,3.9,29295.0,40500,41000,59100,3,500,2015
468772,3.3,79862.0,12350,11900,61490,11,-450,2015
226837,2.7,204899.0,2700,1800,89090,11,-900,2015
57189,4.2,47757.0,13250,13200,77030,1,-50,2015
137385,4.0,56617.0,8000,7700,73100,3,-300,2015
483544,1.9,157399.0,1050,850,73130,13,-200,2015
471206,2.8,121939.0,4375,5200,62930,6,825,2015
21288,3.5,110823.0,3500,3500,77030,10,0,2015
237541,4.3,30494.0,14500,15400,59100,2,900,2014
259227,3.3,115064.0,6075,7300,59100,8,1225,2015
488707,4.0,31576.0,16500,15400,73130,1,-1100,2015
445229,3.8,176992.0,3475,5200,56120,9,1725,2015
429315,2.9,145923.0,6600,6900,61450,7,300,2015
414411,3.9,72624.0,8700,8000,61450,3,-700,2015
529333,3.4,97319.0,12050,11500,70210,7,-550,2015
489884,4.0,14520.0,17950,18500,73130,0,550,2015
50703,4.2,47395.0,30500,30500,77030,3,0,2015
116111,2.9,86723.0,17000,14250,68360,3,-2750,2015
486245,4.2,31617.0,12200,12800,73130,3,600,2015
543703,4.8,14596.0,26700,30500,81400,1,3800,2015
35725,3.7,144982.0,9650,10600,77030,8,950,2015
173242,,88109.0,16900,16500,83200,6,-400,2014
429453,3.2,40695.0,21800,21800,61450,3,0,2015
135085,2.9,39746.0,15800,14000,73100,3,-1800,2015
449694,2.8,87321.0,7450,8200,61490,2,750,2014
152226,2.0,69705.0,7900,6000,73100,3,-1900,2015
195556,3.1,47406.0,16500,16000,67090,2,-500,2015
13735,3.9,39319.0,18850,19250,77030,4,400,2015
518954,4.2,37589.0,19650,21600,71660,4,1950,2015
317972,4.2,37973.0,14900,15600,73200,3,700,2015
20368,5.0,48846.0,30300,32250,77030,2,1950,2015
529927,3.5,105816.0,7375,6500,82150,6,-875,2014
38866,1.0,126507.0,6725,4500,77030,10,-2225,2015
306927,4.5,83264.0,11150,10400,59100,3,-750,2015
221639,2.6,49306.0,8725,6600,57290,2,-2125,2015
290627,3.0,114985.0,10300,10800,59100,8,500,2015
440292,2.8,76443.0,18050,18100,74430,5,50,2015
321752,3.6,67647.0,13500,11800,82750,4,-1700,2014
536868,1.0,44504.0,10400,4000,73640,2,-6400,2015
416001,4.8,26641.0,20400,22900,61450,3,2500,2015
525556,2.6,55946.0,9975,9900,70210,6,-75,2015
2221,2.0,46156.0,17150,12100,77030,0,-5050,2014
281654,4.7,73243.0,8600,9500,59100,6,900,2015
529736,2.5,175058.0,1675,1000,82150,13,-675,2015
135414,4.8,14043.0,41200,40500,73100,1,-700,2015
475348,,38579.0,6725,6900,73130,6,175,2014
180407,4.1,47614.0,9900,10500,83200,3,600,2015
318888,2.5,115426.0,3625,4600,73200,10,975,2015
39358,3.9,29941.0,13700,18750,77030,2,5050,2015
361175,4.0,122775.0,8725,9400,64520,7,675,2014
312061,4.7,1748.0,55400,54200,59100,0,-1200,2015
188596,1.9,118034.0,2625,3300,63250,13,675,2015
414709,2.4,7025.0,15850,14000,61450,1,-1850,2015
175835,4.2,103758.0,6750,7100,83200,4,350,2015
138702,3.6,153762.0,7325,7300,73100,12,-25,2015
88787,1.0,165444.0,1950,1050,68360,9,-900,2015
15461,2.4,155591.0,5550,6300,77030,10,750,2015
137920,4.3,13777.0,11600,11600,73100,1,0,2015
70341,3.6,28916.0,10900,11000,77030,2,100,2015
263112,2.1,46768.0,17050,15200,59100,3,-1850,2015
257257,2.7,205617.0,1250,1250,59100,13,0,2015
406149,4.4,33954.0,14850,14900,61450,1,50,2015
345265,2.9,49824.0,22900,21800,82750,3,-1100,2015
496187,4.3,10315.0,22700,24000,73130,2,1300,2015
465974,1.9,117897.0,6725,6200,61490,6,-525,2015
71985,3.9,32161.0,26100,26000,77030,2,-100,2015
401476,2.6,142626.0,3175,3400,61450,9,225,2015
386980,3.8,57396.0,20700,19700,65610,4,-1000,2015
530322,3.5,59118.0,13450,12000,82150,4,-1450,2015
479192,3.3,37789.0,13550,12400,73130,2,-1150,2015
224536,3.3,87469.0,7950,9800,89090,11,1850,2015
249255,4.0,19647.0,16250,15800,59100,1,-450,2015
487736,1.9,121299.0,4025,2300,73130,8,-1725,2015
381465,2.9,98596.0,11200,9750,64520,7,-1450,2015
72374,4.2,12614.0,26200,25800,77030,2,-400,2015
87949,4.9,13128.0,14950,16000,68360,1,1050,2015
60366,3.7,35180.0,17750,18750,77030,4,1000,2015
451036,1.9,136412.0,1775,1800,61490,11,25,2015
514836,2.9,139499.0,2125,2700,71660,13,575,2015
519122,1.9,146731.0,2850,3850,71660,10,1000,2015
454398,3.4,132078.0,5525,7100,61490,11,1575,2015
179850,3.7,21484.0,11350,10600,83200,2,-750,2015
106094,4.0,30065.0,31500,28300,68360,1,-3200,2015
274141,2.8,45604.0,14000,13600,59100,3,-400,2015
237385,3.4,40265.0,13400,13400,59100,1,0,2014
218234,4.2,32330.0,27300,27000,57290,2,-300,2015
178187,4.7,23009.0,26100,25500,83200,2,-600,2015
521589,3.1,23615.0,20100,19500,71660,3,-600,2015
95705,3.8,100576.0,11550,11000,68360,2,-550,2015
467879,1.9,127417.0,4500,4500,61490,9,0,2015
137805,4.4,49280.0,33400,34000,73100,2,600,2015
319773,3.5,37582.0,9475,9000,73200,3,-475,2015
399524,2.9,141764.0,3350,2900,61450,7,-450,2014
1699,3.2,40401.0,12000,12200,77030,2,200,2014
339328,4.6,36449.0,15250,10100,82750,3,-5150,2015
509941,4.2,67074.0,11100,12000,71660,3,900,2015
437493,2.9,120222.0,8350,7200,74430,8,-1150,2015
192615,2.1,141905.0,1900,1300,67090,9,-600,2015
318543,3.8,53642.0,12100,12100,73200,2,0,2015
457896,3.5,126139.0,5825,6300,61490,3,475,2015
192005,1.9,74145.0,3800,1000,67090,7,-2800,2014
434944,3.5,68791.0,7250,10200,74430,9,2950,2015
467529,2.0,35210.0,7200,8400,61490,11,1200,2015
121022,2.0,39030.0,12450,11100,73100,1,-1350,2014
178415,4.2,51084.0,15650,16500,83200,2,850,2015
338501,4.6,22559.0,11200,11100,82750,3,-100,2015
547350,2.8,29274.0,9425,9000,78090,2,-425,2015
136860,3.6,71637.0,12800,15000,73100,5,2200,2015
449414,,189306.0,1525,1500,61490,12,-25,2014
41029,4.1,10711.0,29500,31500,77030,1,2000,2015
77060,4.9,66677.0,10300,13000,68360,2,2700,2014
495779,4.4,48470.0,18300,19300,73130,2,1000,2015
159818,2.8,105093.0,22100,18300,73100,8,-3800,2015
244178,1.9,102748.0,6650,2700,59100,9,-3950,2015
34097,3.4,170080.0,5100,5700,77030,8,600,2015
543671,4.8,15885.0,43200,44200,81400,1,1000,2015
442208,3.7,72757.0,11750,9900,74430,3,-1850,2015
266123,3.1,34673.0,20200,19600,59100,2,-600,2015
15400,2.0,132806.0,3575,3500,77030,10,-75,2015
424784,4.6,35559.0,18650,18200,61450,3,-450,2015
148448,4.1,43872.0,24400,24700,73100,7,300,2015
440499,1.9,104998.0,4400,1700,74430,9,-2700,2015
287130,2.9,62499.0,10050,10000,59100,3,-50,2015
117172,1.9,100093.0,4000,4700,68360,8,700,2015
192816,3.7,60113.0,9550,10000,67090,7,450,2015
240982,2.7,129843.0,1075,700,59100,15,-375,2014
395229,4.9,103800.0,7775,8000,65610,6,225,2015
294224,2.1,84742.0,13500,12500,59100,5,-1000,2015
121660,3.7,28313.0,18300,17900,73100,2,-400,2014
409381,2.4,181110.0,2475,750,61450,14,-1725,2015
122842,,31991.0,110000,94500,73100,0,-15500,2014
3178,1.9,85074.0,6150,6500,77030,6,350,2014
457049,2.0,171652.0,3325,1200,61490,7,-2125,2015
79582,3.4,43638.0,8800,9900,68360,2,1100,2015
413215,1.9,214009.0,2400,800,61450,12,-1600,2015
467922,2.7,191107.0,1350,1800,61490,14,450,2015
444582,,161109.0,2600,3400,56120,10,800,2014
432879,,75208.0,6150,2300,74430,8,-3850,2014
422379,3.3,57996.0,8950,8800,61450,3,-150,2015
158566,4.1,67811.0,13500,13300,73100,2,-200,2015
439722,4.4,38408.0,21500,20300,74430,4,-1200,2015
460429,2.5,132921.0,3450,4100,61490,8,650,2015
437471,2.7,90250.0,6500,5000,74430,5,-1500,2015
462990,2.5,146852.0,5950,5900,61490,11,-50,2015
10150,3.5,50340.0,17400,16100,77030,2,-1300,2015
201267,4.0,8379.0,36000,36600,57290,0,600,2014
40511,2.8,117713.0,6500,7000,77030,11,500,2015
148673,4.5,96101.0,10100,9400,73100,5,-700,2015
426441,1.9,152994.0,550,900,61450,18,350,2015
293829,3.8,51278.0,8775,8601,59100,2,-174,2015
108219,4.8,51091.0,9975,10600,68360,2,625,2015
110970,2.8,89391.0,8775,8500,68360,3,-275,2015
528926,1.0,49351.0,9825,1100,70210,2,-8725,2015
158591,3.6,42217.0,16100,15500,73100,2,-600,2015
215488,3.9,13810.0,17800,17200,57290,1,-600,2015
252234,3.9,53456.0,35500,34600,59100,3,-900,2015
178984,3.8,28307.0,28600,29500,83200,4,900,2015
526932,1.9,139012.0,1675,2500,70210,9,825,2015
23513,2.9,30663.0,22900,23500,77030,2,600,2015
314123,4.1,35997.0,16550,17700,59100,2,1150,2015
187385,3.7,35407.0,15300,15700,63250,1,400,2015
493509,5.0,38623.0,11750,13000,73130,2,1250,2015
450235,4.4,19658.0,17250,19800,61490,3,2550,2014
55254,2.5,127781.0,6075,7900,77030,8,1825,2015
483447,2.5,56724.0,9050,8800,73130,2,-250,2015
265664,3.5,24970.0,11100,9800,59100,2,-1300,2015
539013,2.3,70122.0,8025,7900,55590,3,-125,2015
83878,3.8,99685.0,14750,16400,68360,7,1650,2015
341685,3.7,63050.0,9200,9800,82750,8,600,2015
177922,3.7,35478.0,11350,13200,83200,3,1850,2015
406226,4.6,16723.0,14300,15200,61450,3,900,2015
440897,4.0,49085.0,8300,8900,74430,3,600,2015
431130,3.6,20768.0,8950,9000,61450,2,50,2015
313664,3.5,40571.0,12550,12900,59100,2,350,2015
80435,4.4,16212.0,20500,20200,68360,1,-300,2015
214380,1.9,108998.0,9250,7000,57290,7,-2250,2015
386869,3.6,124197.0,5500,6000,65610,11,500,2015
315972,4.4,22267.0,19000,18000,59100,1,-1000,2015
158000,4.5,12406.0,16050,16500,73100,2,450,2015
126620,3.0,16292.0,14950,14600,73100,1,-350,2015
167076,2.8,147428.0,5800,5900,73100,9,100,2015
3367,2.0,102388.0,5875,2600,77030,8,-3275,2015
359916,4.8,38140.0,27600,27700,62960,1,100,2015
353686,4.4,18009.0,24600,22900,62960,1,-1700,2015
509976,4.3,91643.0,19150,19600,71660,4,450,2015
334771,3.5,136477.0,3725,3800,82750,8,75,2015
127546,4.2,9614.0,26400,25400,73100,3,-1000,2015
161455,3.2,109295.0,8600,9200,73100,7,600,2015
386389,1.9,108628.0,3075,2400,65610,9,-675,2015
462716,1.9,159481.0,5150,5400,61490,8,250,2015
24054,4.4,21413.0,21500,21000,77030,1,-500,2015
380367,4.7,16677.0,28600,27900,64520,1,-700,2015
360824,2.0,86890.0,2300,500,64520,9,-1800,2014
453531,3.7,81291.0,10900,11200,61490,3,300,2015
320624,2.1,108395.0,3450,2800,82750,11,-650,2015
498478,,11002.0,28200,30500,80610,1,2300,2014
517716,4.0,57941.0,21700,22500,71660,8,800,2015
479669,3.9,40992.0,19000,18100,73130,3,-900,2015
462458,3.2,93078.0,3575,4300,61490,10,725,2015
377964,2.1,90798.0,11000,6000,64520,4,-5000,2015
541775,4.2,120011.0,8350,8400,81400,7,50,2015
529291,4.5,36681.0,12900,14000,70210,2,1100,2015
352101,2.0,148681.0,4550,4500,62960,6,-50,2015
407928,2.9,193535.0,1475,2800,61450,16,1325,2015
309412,4.3,22571.0,25900,26300,59100,1,400,2015
524032,3.9,25636.0,18850,17800,70210,0,-1050,2014
428183,3.3,173511.0,3500,4100,61450,11,600,2015
155747,3.2,65402.0,32100,25500,73100,2,-6600,2015
242887,4.1,84740.0,10350,11900,59100,7,1550,2015
309178,3.7,45672.0,8450,9500,59100,3,1050,2015
28638,2.1,34649.0,17950,16800,77030,3,-1150,2015
166518,1.9,138269.0,3025,3200,73100,13,175,2015
112500,2.9,85311.0,6775,6500,68360,4,-275,2015
178728,4.0,22948.0,19250,20100,83200,1,850,2015
273576,2.4,38755.0,22300,19800,59100,4,-2500,2015
485564,4.1,22901.0,18400,16800,73130,3,-1600,2015
459216,2.8,72789.0,9600,9800,61490,3,200,2015
120073,,84355.0,7775,8300,73100,5,525,2014
354653,3.7,22566.0,16050,16300,62960,1,250,2015
500102,2.7,51088.0,10550,10300,80610,2,-250,2015
305584,4.8,15009.0,20800,20200,59100,2,-600,2015
324014,3.4,162595.0,3875,4200,82750,9,325,2015
108127,4.3,49415.0,16900,16600,68360,2,-300,2015
494620,4.0,28207.0,35900,35700,73130,1,-200,2015
225972,1.9,77317.0,5400,4000,89090,6,-1400,2015
232160,3.1,18359.0,14400,12500,89090,2,-1900,2015
380192,3.7,19885.0,14850,15300,64520,1,450,2015
348830,,97197.0,14600,14800,62960,6,200,2014
27236,2.5,129224.0,3750,4500,77030,12,750,2015
356496,3.3,77774.0,25500,25000,62960,5,-500,2015
444245,2.6,120831.0,4250,2300,74430,6,-1950,2015
385681,5.0,93464.0,9575,11600,65610,10,2025,2015
337132,4.3,102144.0,19250,18100,82750,4,-1150,2015
15450,2.0,202667.0,3075,1900,77030,10,-1175,2015
439041,2.0,140126.0,1925,2400,74430,13,475,2015
499836,3.6,73270.0,6650,8900,80610,9,2250,2015
383750,2.5,82915.0,12800,11100,65610,8,-1700,2015
272357,3.2,22424.0,22400,21400,59100,3,-1000,2015
15657,3.6,148761.0,2875,2800,77030,13,-75,2015
471919,2.0,29697.0,11300,6400,62930,1,-4900,2015
72491,4.9,29673.0,14650,16000,77030,2,1350,2015
119947,2.0,78280.0,10850,10500,73100,5,-350,2015
174398,3.9,39932.0,20800,20801,83200,2,1,2015
276910,3.9,7622.0,31200,32200,59100,1,1000,2015
287681,2.3,121609.0,2200,2500,59100,13,300,2015
125800,2.8,63637.0,12250,12000,73100,2,-250,2015
416652,3.9,60636.0,10550,10800,61450,3,250,2015
225550,2.0,183799.0,1475,450,89090,16,-1025,2015
138984,4.2,40304.0,13800,13000,73100,3,-800,2015
412532,3.6,52501.0,12800,12701,61450,2,-99,2015
452623,3.8,14541.0,18650,17500,61490,2,-1150,2015
333091,4.3,69113.0,2625,2900,82750,12,275,2015
213911,4.3,29743.0,37300,39000,57290,1,1700,2015
4905,2.0,118198.0,1500,700,77030,14,-800,2015
539666,3.5,64495.0,24800,23750,81400,4,-1050,2015
265822,4.2,30641.0,11600,12000,59100,2,400,2015
509456,4.7,16771.0,21700,21700,71660,1,0,2015
155752,3.6,40437.0,27700,26600,73100,3,-1100,2015
308582,3.9,46101.0,22800,22400,59100,4,-400,2015
223419,3.4,39445.0,11600,11600,89090,2,0,2015
289372,2.7,67036.0,12450,11900,59100,5,-550,2015
482350,4.9,10665.0,13550,13300,73130,1,-250,2015
405190,2.1,142595.0,6975,5200,61450,9,-1775,2015
176787,4.5,46803.0,22200,24000,83200,5,1800,2015
40795,2.9,62476.0,10900,10200,77030,2,-700,2015
40656,4.1,15477.0,28600,25750,77030,1,-2850,2015
302621,3.3,115970.0,10550,10000,59100,8,-550,2015
35204,4.3,15520.0,16550,16100,77030,2,-450,2015
272858,3.9,169971.0,10000,10600,59100,8,600,2015
201055,3.5,31557.0,18750,16800,57290,4,-1950,2015
474109,1.0,128632.0,4525,2300,62930,6,-2225,2015
546627,4.7,22885.0,8900,9900,81400,2,1000,2015
296707,4.6,29137.0,42400,42000,59100,3,-400,2015
406165,4.0,28747.0,12800,13400,61450,1,600,2015
1559,4.2,28412.0,21900,21250,77030,2,-650,2014
26814,2.7,102926.0,14550,15500,77030,7,950,2015
421365,4.0,41029.0,21800,22500,61450,3,700,2015
275723,2.7,38681.0,18400,17500,59100,4,-900,2015
95105,3.8,37795.0,13000,13100,68360,2,100,2015
90164,4.2,51105.0,16250,16300,68360,2,50,2015
78338,1.9,129950.0,3725,2800,68360,9,-925,2014
102374,2.1,134666.0,3025,2200,68360,9,-825,2015
145361,4.3,96659.0,21300,21800,73100,6,500,2015
122673,,92580.0,9975,9000,73100,4,-975,2014
90719,3.8,41947.0,9550,8400,68360,3,-1150,2015
111977,2.7,81192.0,9650,8700,68360,3,-950,2015
92871,1.9,225732.0,1725,1200,68360,15,-525,2015
163294,4.6,18521.0,36400,36400,73100,1,0,2015
91215,2.2,106668.0,4650,4500,68360,7,-150,2015
208440,4.1,44377.0,13600,14300,57290,2,700,2015
429150,3.8,61191.0,11600,12100,61450,2,500,2015
348473,2.0,152625.0,500,550,62960,22,50,2015
95416,2.8,41821.0,18100,17750,68360,4,-350,2015
490970,3.7,30899.0,18850,19600,73130,3,750,2015
235409,,93762.0,3600,3600,59100,11,0,2014
29933,4.6,22489.0,20800,21750,77030,3,950,2015
390921,4.9,58718.0,11650,14500,65610,5,2850,2015
280417,4.4,88959.0,9975,9800,59100,6,-175,2015
142213,2.9,89770.0,9150,7600,73100,5,-1550,2015
535082,3.5,48056.0,9900,9500,82150,2,-400,2015
262931,4.6,106554.0,23000,21400,59100,2,-1600,2015
68458,1.9,129888.0,7725,5350,77030,12,-2375,2015
69292,2.5,39536.0,15400,14500,77030,5,-900,2015
309891,4.0,78762.0,8525,8000,59100,3,-525,2015
67336,4.6,10920.0,36100,38250,77030,2,2150,2015
419977,2.9,34062.0,19600,18400,61450,3,-1200,2015
526953,3.6,47051.0,19000,18500,70210,4,-500,2015
11431,3.4,96444.0,7875,5600,77030,2,-2275,2014
97512,4.9,143497.0,10100,9100,68360,8,-1000,2015
491533,3.7,33475.0,18200,27900,73130,1,9700,2015
246610,2.2,96462.0,6375,6200,59100,7,-175,2015
267295,4.5,20635.0,15000,15100,59100,1,100,2015
299440,4.8,8540.0,40200,38000,59100,0,-2200,2015
175108,3.9,16535.0,24500,25700,83200,2,1200,2015
126799,4.1,47758.0,19150,21500,73100,7,2350,2015
47793,4.3,35184.0,27500,27000,77030,3,-500,2015
454807,3.4,98348.0,4750,9300,61490,7,4550,2015
392621,5.0,12996.0,13850,15100,65610,0,1250,2015
50416,2.9,83094.0,7850,9700,77030,5,1850,2015
323516,2.9,77031.0,15800,12800,82750,8,-3000,2015
443064,3.5,236626.0,50,800,74430,12,750,2015
358749,5.0,17144.0,20000,20000,62960,0,0,2015
448460,4.1,55642.0,9150,9700,56120,2,550,2015
378006,4.9,25702.0,21700,22800,64520,2,1100,2015
72470,2.9,136119.0,5250,5500,77030,12,250,2015
299817,4.0,21291.0,14000,12400,59100,2,-1600,2015
523061,4.1,37758.0,27300,26300,71660,0,-1000,2015
401033,3.3,103182.0,7650,3700,61450,9,-3950,2014
172929,2.8,98708.0,30500,30900,73100,4,400,2015
299886,4.2,55620.0,13600,13500,59100,2,-100,2015
286401,4.6,11941.0,34300,34000,59100,2,-300,2015
254400,2.4,172300.0,3450,2600,59100,12,-850,2015
24170,2.0,14466.0,13450,7000,77030,1,-6450,2015
495559,3.4,33903.0,11750,12800,73130,3,1050,2015
264091,4.4,31902.0,13850,14000,59100,4,150,2015
316495,4.9,4374.0,28000,31000,73200,2,3000,2014
334454,3.6,141968.0,7525,6000,82750,9,-1525,2015
455712,4.2,41653.0,12400,13900,61490,5,1500,2015
517850,2.0,78490.0,9300,9700,71660,3,400,2015
113340,4.3,41918.0,35700,34000,68360,3,-1700,2015
534481,3.2,46146.0,27800,28800,82150,3,1000,2015
415109,4.6,38479.0,10600,12100,61450,3,1500,2015
388079,4.8,83627.0,5575,6100,65610,8,525,2015
543670,5.0,10659.0,22200,22800,81400,1,600,2015
300572,3.3,59629.0,11400,11000,59100,5,-400,2015
252358,4.4,16421.0,22300,23000,59100,3,700,2015
412867,3.6,81819.0,11300,11100,61450,4,-200,2015
535316,2.4,21344.0,13400,11900,82150,2,-1500,2015
298026,1.0,165393.0,1325,1800,59100,22,475,2015
95404,4.1,27416.0,19100,18000,68360,4,-1100,2015
352346,4.7,3469.0,18600,20300,62960,1,1700,2015
530579,3.5,62893.0,9975,9400,82150,3,-575,2015
391973,4.3,51119.0,10800,11200,65610,8,400,2015
483240,3.4,29233.0,13700,12500,73130,2,-1200,2015
221735,4.2,48729.0,41600,43600,57290,4,2000,2015
178412,4.7,51157.0,16350,16000,83200,2,-350,2015
36888,2.8,50765.0,7200,5100,77030,6,-2100,2015
129210,4.8,25323.0,17450,16400,73100,3,-1050,2015
162679,2.9,54280.0,9100,9100,73100,3,0,2015
413621,4.2,81825.0,15750,16800,61450,4,1050,2015
103453,1.9,103354.0,9725,11700,68360,9,1975,2015
486151,4.4,18299.0,14700,16000,73130,2,1300,2015
136493,2.5,120694.0,10050,8800,73100,6,-1250,2015
342797,2.8,34691.0,16500,16000,82750,3,-500,2015
430526,3.7,81982.0,25400,22000,61450,7,-3400,2015
493827,2.4,30607.0,25300,23200,73130,3,-2100,2015
389490,4.3,77353.0,21900,19500,65610,4,-2400,2015
513431,3.7,40208.0,11000,10700,71660,2,-300,2015
9682,4.9,6127.0,17150,18700,77030,0,1550,2014
239207,1.9,11009.0,18050,15400,59100,0,-2650,2014
409522,1.9,29126.0,15450,11700,61450,3,-3750,2015
378662,4.1,26698.0,26200,28100,64520,2,1900,2015
398421,1.9,118384.0,3550,2000,61450,10,-1550,2015
476093,,154452.0,2525,2300,73130,12,-225,2014
16839,3.8,71722.0,12700,13800,77030,5,1100,2015
264922,4.0,30136.0,18300,17500,59100,1,-800,2015
442193,2.3,61019.0,15800,14500,74430,7,-1300,2015
427825,1.9,13488.0,13350,10200,61450,0,-3150,2015
521679,4.1,24126.0,22300,20200,71660,3,-2100,2015
259378,3.7,21133.0,18650,18300,59100,1,-350,2015
36953,3.4,114839.0,5125,4500,77030,7,-625,2015
297150,4.0,17406.0,11500,11400,59100,1,-100,2015
323050,3.5,34691.0,16400,16000,82750,3,-400,2015
135966,2.4,106452.0,6400,6500,73100,10,100,2015
379955,2.2,119050.0,4600,5100,64520,7,500,2015
185668,1.9,158369.0,1250,1100,63250,10,-150,2015
227363,2.0,170237.0,3325,3500,89090,14,175,2015
266578,3.4,51658.0,10550,11200,59100,5,650,2015
384838,4.2,39895.0,26200,24200,65610,2,-2000,2015
480134,2.5,127760.0,6925,5500,73130,10,-1425,2015
430126,3.7,101323.0,13400,14300,61450,3,900,2015
478291,4.2,25432.0,14600,18600,73130,4,4000,2015
206471,2.0,207073.0,475,1050,57290,11,575,2015
239365,2.5,36530.0,17750,15200,59100,1,-2550,2014
149628,4.8,30244.0,16400,16500,73100,3,100,2015
512655,1.9,61242.0,10500,8800,71660,3,-1700,2015
140417,3.5,28624.0,23000,22800,73100,4,-200,2015
3242,3.6,98270.0,20400,19800,77030,6,-600,2014
64613,2.9,89466.0,9125,11000,77030,8,1875,2015
170018,4.4,12752.0,37900,37000,73100,1,-900,2015
45006,2.0,108554.0,4875,5900,77030,7,1025,2015
287495,2.8,105537.0,6675,6800,59100,6,125,2015
170507,4.7,5268.0,81000,92750,73100,2,11750,2015
95887,4.2,24133.0,21000,20000,68360,3,-1000,2015
330515,1.9,32058.0,17500,16000,82750,3,-1500,2015
506876,2.9,64919.0,4750,6000,80200,4,1250,2015
193542,2.4,148259.0,2000,1000,67090,9,-1000,2015
172355,2.7,50841.0,9175,9100,73100,2,-75,2015
85752,4.7,39273.0,22600,24200,68360,3,1600,2015
334700,4.1,15619.0,14800,15700,82750,3,900,2015
88626,3.7,37259.0,11250,11400,68360,2,150,2015
431398,1.9,169651.0,1100,1500,61450,8,400,2015
393783,4.8,9327.0,33900,32600,65610,0,-1300,2015
270673,4.7,15090.0,29400,28800,59100,1,-600,2015
439437,2.8,81386.0,9725,9300,74430,7,-425,2015
233021,2.0,78577.0,1575,250,89090,15,-1325,2015
142908,2.1,166465.0,4075,4000,73100,11,-75,2015
357174,4.3,26981.0,5400,5500,62960,3,100,2015
91381,4.0,14058.0,20000,19900,68360,1,-100,2015
230274,1.9,100157.0,7550,5000,89090,6,-2550,2015
79490,4.4,19420.0,17100,17000,68360,1,-100,2015
335574,2.1,230966.0,4375,5700,82750,10,1325,2015
251089,2.0,143271.0,1250,1500,59100,18,250,2015
44817,2.8,48531.0,9050,9200,77030,3,150,2015
82348,4.2,19875.0,20400,19800,68360,1,-600,2015
255510,2.8,101741.0,7675,7000,59100,6,-675,2015
534872,2.6,156359.0,5625,5200,82150,10,-425,2015
272248,4.8,33318.0,9850,11300,59100,3,1450,2015
401748,3.6,193971.0,4675,5200,61450,8,525,2015
456379,2.8,127238.0,4575,4600,61490,6,25,2015
544391,3.5,36496.0,15300,16200,81400,4,900,2015
487061,4.0,9298.0,18300,17500,73130,0,-800,2015
389213,3.9,65912.0,13100,13300,65610,6,200,2015
64773,3.2,106717.0,5775,6250,77030,8,475,2015
24956,3.4,57937.0,17250,17900,77030,4,650,2015
37509,4.2,17146.0,14800,15500,77030,3,700,2015
239660,3.2,51120.0,10750,10800,59100,1,50,2014
315847,3.1,48093.0,9075,9000,59100,2,-75,2015
202668,4.1,72197.0,14650,16200,57290,3,1550,2014
256037,3.3,81191.0,7325,6000,59100,4,-1325,2015
339748,2.9,20350.0,29900,24000,82750,2,-5900,2015
56846,3.6,60635.0,13400,13100,77030,2,-300,2015
325159,2.8,28228.0,9450,8300,82750,4,-1150,2015
284387,4.4,23990.0,12500,13500,59100,3,1000,2015
266700,1.9,102255.0,8650,8300,59100,7,-350,2015
398527,2.8,95160.0,3225,4100,61450,10,875,2014
507970,4.3,32372.0,18150,18500,71660,0,350,2014
433471,,209481.0,675,750,74430,13,75,2014
192074,5.0,1295.0,14650,15000,67090,1,350,2015
508610,2.8,33028.0,19650,18900,71660,3,-750,2014
138255,3.0,20756.0,18850,18900,73100,1,50,2015
151795,3.2,42528.0,10600,10200,73100,3,-400,2015
193121,4.1,41403.0,23000,23250,67090,4,250,2015
80237,2.5,138537.0,4400,2600,68360,10,-1800,2015
45946,3.5,28421.0,11100,11500,77030,3,400,2015
11550,3.4,59359.0,8350,8700,77030,3,350,2014
150932,4.1,13142.0,16800,16800,73100,1,0,2015
403575,3.7,34584.0,12500,12700,61450,2,200,2015
192002,2.9,77118.0,15250,11200,67090,7,-4050,2014
367135,4.6,16607.0,19700,18800,64520,1,-900,2015
433663,4.1,91190.0,9750,8300,74430,1,-1450,2014
384416,4.8,39365.0,26100,25600,65610,4,-500,2015
137972,2.6,12394.0,8100,7900,73100,1,-200,2015
493100,1.9,122076.0,6175,3900,73130,7,-2275,2015
141358,1.9,138241.0,1625,700,73100,15,-925,2015
230809,2.9,78630.0,13900,9800,89090,5,-4100,2015
314815,4.2,42282.0,13950,13800,59100,2,-150,2015
241631,4.2,35321.0,15100,16300,59100,3,1200,2014
190745,2.4,50305.0,9525,8100,63250,2,-1425,2015
