,condition,odometer,mmr,sellingprice,income,using_time,difference,selling_year,make
323490,2.6,116385.0,6550,7100,82750,7,550,2015,Ford
146137,3.5,51524.0,10550,11100,73100,3,550,2015,Ford
403551,4.7,28844.0,17550,17800,61450,2,250,2015,Ford
437525,3.5,20185.0,11600,11400,74430,2,-200,2015,Nissan
28969,3.4,103732.0,6675,8500,77030,6,1825,2015,Nissan
513341,4.1,36666.0,16500,16500,71660,1,0,2015,Ford
28318,3.4,101897.0,3725,5300,77030,13,1575,2015,Nissan
312564,3.6,83813.0,9325,10200,59100,4,875,2015,Ford
533485,3.9,57829.0,10550,9800,82150,3,-750,2015,Ford
432895,4.2,180535.0,3550,4800,74430,8,1250,2014,Ford
514313,4.1,37250.0,23300,23600,71660,2,300,2015,Chevrolet
548254,4.6,23619.0,17300,15200,78090,2,-2100,2015,Chevrolet
516400,3.7,28274.0,14850,14600,71660,2,-250,2015,Ford
220766,4.1,33235.0,20800,22500,57290,2,1700,2015,Ford
527641,4.4,13917.0,32500,33200,70210,1,700,2015,Ford
435420,1.9,111859.0,5625,4700,74430,9,-925,2015,Nissan
477908,4.1,37550.0,11150,12100,73130,2,950,2015,Ford
543116,4.5,140305.0,1350,2200,81400,14,850,2015,Ford
113170,4.4,54394.0,9350,9700,68360,2,350,2015,Nissan
199949,4.5,95900.0,16950,18300,67090,5,1350,2015,Ford
262843,4.5,15480.0,25300,25700,59100,1,400,2015,Chevrolet
171882,2.6,31463.0,16350,14100,73100,1,-2250,2015,Chevrolet
474965,4.2,37548.0,15750,17200,73130,3,1450,2014,Nissan
139057,4.3,44016.0,12150,11900,73100,3,-250,2015,Ford
259806,4.4,26654.0,15100,15700,59100,3,600,2015,Ford
140803,4.2,22455.0,24600,23500,73100,3,-1100,2015,Chevrolet
132988,3.7,109766.0,19950,18000,73100,6,-1950,2015,Chevrolet
268263,1.9,210892.0,950,700,59100,15,-250,2015,Nissan
518360,4.6,52873.0,26500,28100,71660,4,1600,2015,Ford
137460,3.7,36606.0,11850,13400,73100,3,1550,2015,Nissan
262059,4.2,17661.0,19900,19800,59100,1,-100,2015,Ford
505863,4.2,49428.0,12600,12100,80610,2,-500,2015,Ford
93586,2.9,77325.0,15450,17100,68360,7,1650,2015,Chevrolet
110673,2.3,176244.0,3400,2500,68360,14,-900,2015,Chevrolet
453591,3.3,57140.0,14100,15000,61490,5,900,2015,Chevrolet
304208,3.9,69009.0,11300,11500,59100,2,200,2015,Ford
488990,3.0,13199.0,13500,13900,73130,1,400,2015,Chevrolet
422401,4.4,27191.0,30500,27000,61450,3,-3500,2015,Ford
113391,3.6,38196.0,16700,17400,68360,3,700,2015,Nissan
383502,4.3,47051.0,14100,15100,65610,2,1000,2014,Ford
338572,2.6,18778.0,15250,14300,82750,1,-950,2015,Chevrolet
120476,,115526.0,6325,6000,73100,8,-325,2014,Ford
121016,4.4,7031.0,12250,12600,73100,1,350,2014,Chevrolet
213805,4.9,9070.0,24800,26600,57290,1,1800,2015,Ford
135640,4.3,31024.0,11750,11400,73100,2,-350,2015,Chevrolet
333425,2.9,114684.0,4050,3600,82750,7,-450,2015,Ford
389798,2.9,56880.0,19200,16700,65610,7,-2500,2015,Chevrolet
147784,1.9,50240.0,10050,7900,73100,3,-2150,2015,Ford
228495,2.1,116461.0,9900,6100,89090,6,-3800,2015,Nissan
338950,3.9,51766.0,13100,12500,82750,3,-600,2015,Chevrolet
229193,2.7,98314.0,6325,6600,89090,6,275,2015,Chevrolet
365850,1.9,127533.0,4800,2800,64520,9,-2000,2015,Chevrolet
399649,2.3,259338.0,4775,3100,61450,9,-1675,2014,Chevrolet
459613,3.3,77340.0,7775,8500,61490,4,725,2015,Chevrolet
505364,3.7,23575.0,13450,13600,80610,3,150,2015,Ford
176999,4.3,29218.0,20000,19900,83200,3,-100,2015,Chevrolet
139479,4.6,41046.0,28100,28400,73100,4,300,2015,Ford
433434,1.9,186939.0,575,300,74430,13,-275,2014,Chevrolet
535085,3.7,49593.0,9800,9400,82150,2,-400,2015,Chevrolet
95686,3.8,35403.0,15850,15700,68360,2,-150,2015,Ford
175936,4.0,53852.0,11600,12200,83200,2,600,2015,Chevrolet
58038,2.7,66403.0,12500,12100,77030,2,-400,2015,Ford
482995,3.9,29433.0,13800,14700,73130,2,900,2015,Nissan
511917,1.9,158116.0,3100,2000,71660,8,-1100,2015,Ford
44689,4.1,25748.0,12500,12000,77030,2,-500,2015,Nissan
309763,3.5,39896.0,8825,8600,59100,2,-225,2015,Nissan
191409,,104718.0,6250,6600,67090,11,350,2014,Chevrolet
199053,2.6,285499.0,3300,2300,67090,9,-1000,2015,Ford
430296,4.1,76130.0,10700,9800,61450,4,-900,2015,Ford
549867,3.7,53997.0,12600,12200,48460,3,-400,2015,Ford
63277,2.6,116041.0,7175,8200,77030,8,1025,2015,Ford
24339,2.7,28888.0,18050,19000,77030,3,950,2015,Nissan
8970,3.5,116505.0,4150,4600,77030,4,450,2014,Chevrolet
502694,3.0,20391.0,15000,14800,80610,1,-200,2015,Chevrolet
531589,4.4,44417.0,11850,11600,82150,3,-250,2015,Ford
205756,4.4,41465.0,15550,15600,57290,3,50,2015,Ford
437654,4.1,57213.0,38000,37200,74430,4,-800,2015,Ford
211351,3.9,39508.0,19750,19800,57290,3,50,2015,Ford
452480,2.1,117494.0,1500,1700,61490,11,200,2015,Chevrolet
503925,1.9,91765.0,28600,28000,80610,5,-600,2015,Ford
52091,3.4,79041.0,5600,6500,77030,6,900,2015,Ford
476746,3.1,82955.0,17200,16600,73130,2,-600,2014,Ford
206311,4.8,28306.0,12350,14600,57290,3,2250,2015,Nissan
253248,4.2,44908.0,12900,12200,59100,1,-700,2015,Ford
357225,4.5,38830.0,17550,17700,62960,1,150,2015,Chevrolet
509518,4.3,12719.0,18350,19800,71660,1,1450,2015,Ford
346441,1.9,132368.0,1800,850,82750,10,-950,2015,Ford
24727,4.5,23271.0,24300,24900,77030,1,600,2015,Chevrolet
109789,4.2,56025.0,30900,31000,68360,7,100,2015,Chevrolet
396089,3.6,74448.0,19150,17500,65610,2,-1650,2015,Ford
284854,2.7,92691.0,8675,9600,59100,4,925,2015,Nissan
240082,2.0,68424.0,6350,5400,59100,3,-950,2014,Chevrolet
103608,2.2,99122.0,15550,13200,68360,7,-2350,2015,Ford
149022,4.1,162690.0,2475,3000,73100,10,525,2015,Chevrolet
51738,3.4,38137.0,13050,13500,77030,2,450,2015,Chevrolet
505171,4.2,45900.0,13450,15500,80610,3,2050,2015,Nissan
132823,4.2,43399.0,17050,16500,73100,4,-550,2015,Nissan
190753,3.4,52985.0,8950,9000,63250,2,50,2015,Ford
103713,2.0,196090.0,4075,3800,68360,10,-275,2015,Chevrolet
371788,4.4,26601.0,12550,12700,64520,3,150,2015,Nissan
406734,4.9,33364.0,18150,18300,61450,1,150,2015,Ford
1730,2.6,29636.0,12700,10750,77030,2,-1950,2014,Nissan
390388,2.5,54295.0,13400,13300,65610,2,-100,2015,Chevrolet
407920,1.9,209511.0,2125,1800,61450,13,-325,2015,Nissan
273117,1.9,112402.0,650,1000,59100,15,350,2015,Ford
96382,1.9,107679.0,3000,3500,68360,10,500,2015,Ford
448542,2.9,81061.0,4075,5200,56120,9,1125,2015,Nissan
547937,3.2,40510.0,13600,14750,78090,5,1150,2015,Ford
201375,4.7,23263.0,15700,20200,57290,1,4500,2015,Nissan
102921,2.9,96231.0,17150,16900,68360,5,-250,2015,Chevrolet
240868,2.9,142228.0,1300,800,59100,12,-500,2014,Ford
416662,3.6,57565.0,12300,12300,61450,4,0,2015,Ford
522670,4.2,27500.0,26200,25800,71660,2,-400,2015,Ford
486799,4.4,69841.0,12450,13600,73130,2,1150,2015,Ford
291832,2.9,55442.0,3725,7400,59100,10,3675,2015,Chevrolet
337325,3.2,55549.0,11150,11400,82750,4,250,2015,Ford
534823,1.9,153793.0,6800,4300,82150,7,-2500,2015,Chevrolet
130688,5.0,40074.0,24200,22500,73100,3,-1700,2015,Ford
319113,2.0,292492.0,450,200,73200,18,-250,2015,Chevrolet
334483,4.4,28449.0,20200,18600,82750,3,-1600,2015,Ford
334868,4.6,23482.0,17550,17100,82750,1,-450,2015,Chevrolet
51741,3.6,23492.0,9750,11100,77030,2,1350,2015,Ford
385226,3.4,84378.0,4800,4200,65610,6,-600,2015,Nissan
391901,4.4,14722.0,16100,15500,65610,2,-600,2015,Ford
213799,4.4,33038.0,32200,32600,57290,1,400,2015,Ford
61008,1.8,98224.0,5925,3100,77030,5,-2825,2015,Chevrolet
113630,3.2,19970.0,11800,12200,68360,1,400,2015,Nissan
417033,4.2,33706.0,15300,15200,61450,4,-100,2015,Ford
430079,3.7,71570.0,9775,10400,61450,3,625,2015,Ford
138989,1.9,37257.0,18300,14200,73100,3,-4100,2015,Ford
312053,4.6,19597.0,23300,23000,59100,2,-300,2015,Nissan
406701,3.7,19371.0,20600,19400,61450,1,-1200,2015,Ford
40806,4.1,71967.0,12250,12250,77030,2,0,2015,Ford
94041,2.0,269323.0,725,900,68360,14,175,2015,Ford
324501,2.7,65562.0,13650,15000,82750,10,1350,2015,Ford
539589,2.0,105884.0,7050,5100,55590,6,-1950,2015,Chevrolet
144044,3.8,203552.0,4725,4800,73100,12,75,2015,Ford
480328,2.7,22821.0,15100,13600,73130,2,-1500,2015,Ford
143974,4.2,132545.0,5650,6700,73100,8,1050,2015,Ford
510220,2.7,108212.0,15800,16300,71660,6,500,2015,Chevrolet
374188,1.9,148662.0,975,1100,64520,14,125,2015,Chevrolet
410266,2.8,130594.0,6275,6200,61450,4,-75,2015,Chevrolet
262826,4.6,19621.0,12250,11700,59100,2,-550,2015,Chevrolet
313409,4.5,43480.0,14950,15700,59100,2,750,2015,Chevrolet
88696,4.3,75669.0,28100,28400,68360,4,300,2015,Chevrolet
440012,4.3,112795.0,4475,4400,74430,5,-75,2015,Nissan
299449,4.4,49826.0,8925,8900,59100,3,-25,2015,Ford
345436,4.2,25244.0,10350,10700,82750,3,350,2015,Nissan
500062,4.1,28453.0,27900,29200,80610,2,1300,2015,Ford
406287,3.2,36801.0,16650,15800,61450,4,-850,2015,Nissan
56481,3.1,107953.0,15100,14500,77030,9,-600,2015,Ford
364971,4.9,23680.0,21800,22400,64520,1,600,2015,Chevrolet
140639,3.3,15121.0,21200,21700,73100,1,500,2015,Nissan
57816,4.2,49625.0,8250,8600,77030,2,350,2015,Chevrolet
446021,2.0,92650.0,8325,7400,56120,2,-925,2015,Chevrolet
451367,2.0,146793.0,2400,1100,61490,11,-1300,2015,Chevrolet
320136,2.1,60710.0,6825,5400,82750,5,-1425,2015,Ford
290377,1.9,175140.0,950,1600,59100,18,650,2015,Nissan
101928,3.2,141661.0,3625,3100,68360,10,-525,2015,Nissan
459926,1.9,127966.0,3800,4000,61490,11,200,2015,Ford
444183,3.2,34579.0,16650,17500,74430,2,850,2015,Chevrolet
12655,2.0,53116.0,3825,4000,77030,9,175,2014,Chevrolet
103000,2.7,97017.0,6225,6200,68360,7,-25,2015,Ford
479240,3.0,24009.0,15700,15600,73130,1,-100,2015,Chevrolet
421720,2.1,68103.0,14450,17200,61450,4,2750,2015,Chevrolet
199793,4.3,28174.0,24200,26300,67090,1,2100,2015,Chevrolet
387038,4.7,64388.0,9600,10200,65610,3,600,2015,Ford
38744,3.5,31414.0,9425,10100,77030,4,675,2015,Nissan
274997,4.3,64631.0,9975,11200,59100,3,1225,2015,Chevrolet
543549,4.1,16141.0,20000,19700,81400,1,-300,2015,Ford
101416,3.7,32305.0,17600,18900,68360,3,1300,2015,Ford
302605,4.3,59381.0,9750,10200,59100,7,450,2015,Chevrolet
416767,3.5,99522.0,3425,4200,61450,8,775,2015,Ford
445610,3.5,26684.0,14950,12600,56120,1,-2350,2015,Chevrolet
211335,4.9,9445.0,22400,22600,57290,3,200,2015,Ford
442290,2.6,205175.0,2150,2000,74430,8,-150,2015,Ford
104985,3.6,66601.0,5950,7400,68360,6,1450,2015,Chevrolet
489905,4.0,15915.0,15400,16500,73130,1,1100,2015,Chevrolet
228390,1.9,257521.0,4225,4800,89090,9,575,2015,Ford
192427,4.0,108855.0,15300,17800,67090,6,2500,2014,Chevrolet
203937,4.4,26839.0,13400,13900,57290,3,500,2015,Ford
48985,3.4,81091.0,3275,5000,77030,11,1725,2015,Ford
499288,4.0,20792.0,13200,13000,80610,1,-200,2015,Chevrolet
107933,2.1,48367.0,12800,12800,68360,2,0,2015,Nissan
365807,4.2,44750.0,16050,16000,64520,4,-50,2015,Nissan
512827,4.7,13399.0,21600,20700,71660,1,-900,2015,Ford
175456,4.6,9190.0,11450,11600,83200,1,150,2015,Ford
482663,4.6,19086.0,18800,16900,73130,3,-1900,2015,Nissan
90360,1.9,36639.0,22200,14700,68360,2,-7500,2015,Ford
532160,1.9,263321.0,475,1100,82150,11,625,2015,Chevrolet
372419,2.5,205622.0,2500,4500,64520,9,2000,2015,Chevrolet
110162,4.0,50138.0,44200,44250,68360,2,50,2015,Ford
509386,2.5,103195.0,4450,4400,71660,6,-50,2014,Ford
395461,2.5,68872.0,10800,10600,65610,2,-200,2015,Ford
449350,2.0,232017.0,1375,600,61490,12,-775,2015,Ford
204935,5.0,22741.0,22800,22900,57290,1,100,2015,Ford
61873,4.8,22454.0,22100,23000,77030,2,900,2015,Ford
283740,4.4,16696.0,12550,13200,59100,1,650,2015,Ford
484360,4.0,15819.0,15000,15000,73130,1,0,2015,Chevrolet
506034,3.3,92369.0,17050,16000,80200,5,-1050,2015,Ford
384326,5.0,39866.0,10100,10300,65610,3,200,2015,Chevrolet
155872,4.5,44789.0,10250,16400,73100,3,6150,2015,Nissan
225971,2.7,155767.0,2875,2900,89090,6,25,2015,Ford
112382,4.0,36319.0,20300,20600,68360,2,300,2015,Nissan
362860,4.3,50331.0,15000,15000,64520,3,0,2014,Chevrolet
207732,3.6,24465.0,60000,55000,57290,5,-5000,2015,Nissan
137902,2.8,28017.0,17850,16800,73100,3,-1050,2015,Ford
128466,4.8,7880.0,12050,11700,73100,3,-350,2015,Nissan
270390,4.3,97623.0,6825,7000,59100,6,175,2015,Ford
155694,4.0,11415.0,29400,34600,73100,0,5200,2015,Chevrolet
81081,4.3,32324.0,34600,41500,68360,1,6900,2015,Chevrolet
499803,4.4,90825.0,7925,10300,80610,7,2375,2015,Nissan
468872,2.7,138617.0,2575,2900,61490,10,325,2015,Chevrolet
476421,2.5,10915.0,13100,13900,73130,0,800,2014,Nissan
237995,3.0,94165.0,7525,6500,59100,5,-1025,2014,Ford
123843,4.4,14841.0,48000,47900,73100,0,-100,2015,Chevrolet
398301,,113851.0,7875,8500,61450,8,625,2014,Ford
453132,4.9,14600.0,19500,18900,61490,1,-600,2015,Ford
279702,3.1,64974.0,8550,8000,59100,4,-550,2015,Ford
180057,3.9,43960.0,8275,8201,83200,2,-74,2015,Chevrolet
83419,1.0,117865.0,925,350,68360,20,-575,2015,Nissan
532190,2.8,81611.0,7625,6800,82150,3,-825,2015,Chevrolet
509741,3.9,35890.0,12150,11400,71660,3,-750,2015,Nissan
141688,4.2,148298.0,4300,6100,73100,5,1800,2015,Ford
186666,4.0,31552.0,15650,17500,63250,3,1850,2015,Chevrolet
62387,4.3,30971.0,10700,10300,77030,3,-400,2015,Ford
53048,4.1,50565.0,13200,14750,77030,14,1550,2015,Chevrolet
28766,4.0,16396.0,11600,11300,77030,3,-300,2015,Nissan
376007,4.1,42765.0,12150,11500,64520,3,-650,2015,Nissan
464003,2.7,115366.0,10300,10500,61490,5,200,2015,Chevrolet
197556,4.4,14452.0,11700,12400,67090,3,700,2015,Chevrolet
373729,4.5,88371.0,11000,14500,64520,9,3500,2015,Nissan
372111,3.9,44884.0,12350,11500,64520,3,-850,2015,Ford
429026,3.5,59469.0,14300,12300,61450,5,-2000,2015,Nissan
392574,2.8,40097.0,20200,19000,65610,1,-1200,2015,Ford
222871,4.1,52113.0,12350,12000,89090,2,-350,2015,Ford
290696,4.0,18490.0,15050,15400,59100,1,350,2015,Chevrolet
501768,3.6,21564.0,29400,29700,80610,2,300,2015,Ford
26495,4.0,53565.0,13200,13100,77030,3,-100,2015,Ford
258526,4.4,12010.0,14850,17200,59100,3,2350,2015,Nissan
519804,2.1,111141.0,11700,12600,71660,9,900,2015,Ford
283451,3.3,164940.0,6400,8100,59100,7,1700,2015,Ford
174946,3.8,29535.0,11800,11400,83200,3,-400,2015,Ford
351049,2.9,40244.0,13150,13900,62960,2,750,2015,Nissan
289548,3.3,37689.0,11700,11300,59100,3,-400,2015,Ford
112758,3.5,35768.0,21400,20900,68360,1,-500,2015,Ford
138766,3.8,23331.0,17300,18900,73100,2,1600,2015,Nissan
398433,3.4,86789.0,5500,6400,61450,9,900,2014,Ford
382384,4.0,60377.0,10200,8900,65610,5,-1300,2014,Ford
153790,2.5,27379.0,10100,4700,73100,3,-5400,2015,Ford
31331,3.4,72856.0,8725,7300,77030,9,-1425,2015,Ford
176836,2.0,140184.0,3000,4700,83200,9,1700,2015,Chevrolet
32795,4.1,15884.0,25200,25500,77030,1,300,2015,Chevrolet
526627,3.4,32185.0,33500,30500,70210,2,-3000,2015,Ford
440682,1.9,174389.0,1125,1100,74430,12,-25,2015,Ford
243355,5.0,5400.0,15300,15600,59100,2,300,2015,Nissan
153178,4.1,26033.0,16400,17400,73100,2,1000,2015,Nissan
329752,1.9,144167.0,3150,2300,82750,8,-850,2015,Ford
335258,1.0,2119.0,22100,10900,82750,0,-11200,2015,Chevrolet
495699,4.4,17514.0,31900,32800,73130,1,900,2015,Nissan
376200,2.9,164466.0,4850,4700,64520,7,-150,2015,Nissan
144207,4.8,30449.0,16850,16500,73100,3,-350,2015,Ford
161991,4.4,24103.0,17650,19500,73100,3,1850,2015,Nissan
208495,4.2,17593.0,12150,12800,57290,2,650,2015,Nissan
294823,3.7,36806.0,11500,11200,59100,1,-300,2015,Chevrolet
276063,3.0,18177.0,12450,12600,59100,1,150,2015,Chevrolet
193434,4.0,76803.0,9175,9800,67090,4,625,2015,Ford
28461,3.9,41712.0,13000,13600,77030,2,600,2015,Chevrolet
208254,3.6,44142.0,15250,15000,57290,3,-250,2015,Nissan
483112,2.3,75326.0,7950,5700,73130,4,-2250,2015,Chevrolet
413523,1.0,73900.0,8925,3300,61450,3,-5625,2015,Ford
438266,2.4,106122.0,5450,6000,74430,7,550,2015,Nissan
311350,4.7,23335.0,24300,22400,59100,1,-1900,2015,Chevrolet
437075,2.0,173186.0,14300,10200,74430,11,-4100,2015,Chevrolet
319317,3.6,49013.0,9275,10000,73200,2,725,2015,Chevrolet
523652,3.1,136510.0,3875,4800,71660,6,925,2015,Chevrolet
504043,2.4,19818.0,18050,16800,80610,3,-1250,2015,Nissan
162050,4.4,29109.0,14750,15600,73100,3,850,2015,Nissan
146897,1.9,23025.0,29300,22700,73100,2,-6600,2015,Ford
548292,4.0,112589.0,6325,5200,56990,6,-1125,2014,Chevrolet
510526,4.2,27942.0,29600,30100,71660,4,500,2015,Ford
185625,1.9,132167.0,6125,4900,63250,9,-1225,2015,Nissan
382077,4.4,72425.0,8200,8500,65610,3,300,2014,Chevrolet
319785,3.3,76998.0,13750,14300,73200,3,550,2015,Nissan
58409,4.2,40755.0,9225,10000,77030,1,775,2015,Nissan
215270,4.2,35901.0,17550,19100,57290,1,1550,2015,Ford
964,3.9,68306.0,8700,8200,77030,2,-500,2014,Ford
112656,3.5,124148.0,4675,5300,68360,8,625,2015,Nissan
71253,4.4,14686.0,17850,17250,77030,1,-600,2015,Nissan
151013,2.8,111793.0,10350,9000,73100,3,-1350,2015,Chevrolet
476903,4.2,38986.0,12100,13400,73130,2,1300,2014,Nissan
283946,2.8,47666.0,10100,9800,59100,2,-300,2015,Ford
497223,3.5,48507.0,7950,8600,73130,4,650,2015,Nissan
416369,4.9,30542.0,18850,18000,61450,1,-850,2015,Ford
426646,3.5,70772.0,8325,7000,61450,4,-1325,2015,Chevrolet
160031,4.9,28779.0,20500,17100,73100,3,-3400,2015,Ford
176061,3.3,80450.0,13100,12900,83200,7,-200,2015,Chevrolet
549168,4.9,43189.0,18600,19500,48460,2,900,2015,Ford
461118,2.0,243044.0,1300,2000,61490,10,700,2015,Nissan
466412,2.7,37166.0,24700,22700,61490,2,-2000,2015,Ford
417919,1.9,192013.0,525,1800,61450,17,1275,2015,Chevrolet
387055,4.0,8007.0,19650,19600,65610,1,-50,2015,Chevrolet
335125,3.6,75193.0,5875,6800,82750,5,925,2015,Chevrolet
263206,3.6,67236.0,10200,9900,59100,3,-300,2015,Ford
550272,2.0,156790.0,3475,1600,54620,9,-1875,2015,Ford
529061,3.3,72451.0,9750,8300,70210,6,-1450,2015,Ford
117673,3.7,19573.0,28300,29400,68360,1,1100,2015,Chevrolet
467031,1.9,170284.0,17950,17500,61490,7,-450,2015,Ford
367099,3.7,80720.0,12950,13300,64520,6,350,2015,Nissan
10229,4.4,33648.0,8625,9300,77030,3,675,2015,Ford
220821,1.9,48501.0,32200,28100,57290,3,-4100,2015,Ford
448002,3.9,86463.0,8950,13500,56120,8,4550,2015,Ford
344441,1.9,76254.0,3650,4200,82750,11,550,2015,Nissan
19741,4.7,12762.0,16500,13500,77030,1,-3000,2015,Nissan
408148,3.8,76266.0,5525,5800,61450,5,275,2015,Chevrolet
202803,1.9,104007.0,6400,3600,57290,3,-2800,2014,Chevrolet
262960,3.0,20718.0,14400,14500,59100,1,100,2015,Chevrolet
20115,3.5,18018.0,14600,13750,77030,2,-850,2015,Nissan
321481,4.1,38601.0,6300,4500,82750,8,-1800,2014,Ford
496113,4.0,16058.0,21600,20700,73130,0,-900,2015,Chevrolet
178269,4.7,35299.0,9875,10300,83200,3,425,2015,Ford
488344,2.3,8236.0,20900,19800,73130,2,-1100,2015,Ford
374783,4.0,63903.0,12500,13400,64520,4,900,2015,Ford
262743,2.4,155595.0,2650,1800,59100,10,-850,2015,Nissan
492975,3.6,37381.0,13900,13700,73130,1,-200,2015,Nissan
175236,2.0,141396.0,12450,10300,83200,8,-2150,2015,Chevrolet
531270,2.0,103188.0,8375,7900,82150,7,-475,2015,Ford
382994,,101617.0,1275,1700,65610,16,425,2014,Chevrolet
207521,4.4,13817.0,15850,16200,57290,1,350,2015,Nissan
112458,3.9,20740.0,18350,18900,68360,3,550,2015,Nissan
154109,3.4,11140.0,11450,8400,73100,2,-3050,2015,Chevrolet
318875,3.6,55904.0,11950,12000,73200,2,50,2015,Nissan
508378,3.8,39709.0,14900,14500,71660,1,-400,2014,Nissan
152242,4.9,4343.0,28200,28200,73100,1,0,2015,Chevrolet
518458,4.0,38983.0,14000,14500,71660,1,500,2015,Ford
219568,3.4,73063.0,29300,29000,57290,3,-300,2015,Ford
211615,4.3,19396.0,14000,14500,57290,3,500,2015,Ford
508600,4.3,14671.0,11800,12036,71660,2,236,2014,Nissan
20535,2.0,15422.0,19300,12600,77030,1,-6700,2015,Chevrolet
49474,3.6,20406.0,10850,12200,77030,2,1350,2015,Nissan
124760,4.1,21824.0,14450,13400,73100,2,-1050,2015,Chevrolet
498199,4.0,7876.0,24900,21700,73130,1,-3200,2015,Nissan
186063,2.8,155918.0,2100,2000,63250,11,-100,2015,Nissan
519549,4.7,95741.0,7400,8400,71660,6,1000,2015,Chevrolet
308700,2.5,109336.0,5800,4700,59100,11,-1100,2015,Chevrolet
78846,4.4,33455.0,11200,11600,68360,2,400,2015,Ford
421412,2.7,78673.0,7650,8500,61450,4,850,2015,Chevrolet
283051,4.6,29802.0,32900,29500,59100,2,-3400,2015,Ford
264742,2.8,119478.0,7825,11500,59100,9,3675,2015,Ford
172510,3.8,59612.0,13250,13100,73100,3,-150,2015,Chevrolet
265623,2.0,42947.0,9225,7000,59100,2,-2225,2015,Chevrolet
537910,2.8,182177.0,3650,6100,55590,3,2450,2014,Ford
137929,3.5,51291.0,18450,19500,73100,3,1050,2015,Ford
521106,4.9,33886.0,18150,18400,71660,1,250,2015,Ford
328270,2.7,56804.0,11500,8800,82750,7,-2700,2015,Ford
70004,4.9,43216.0,6800,7000,77030,4,200,2015,Nissan
298053,4.3,32198.0,17550,17400,59100,1,-150,2015,Nissan
536739,2.6,57914.0,12200,9500,73640,2,-2700,2015,Ford
513276,3.7,111869.0,5125,6700,71660,6,1575,2015,Ford
58498,4.8,51873.0,13400,15800,77030,11,2400,2015,Ford
52621,3.5,58091.0,9600,9900,77030,2,300,2015,Ford
305491,3.2,43997.0,23400,20000,59100,4,-3400,2015,Chevrolet
44807,2.9,51682.0,7800,7800,77030,3,0,2015,Nissan
373928,4.2,51444.0,12200,12700,64520,2,500,2015,Nissan
74786,1.0,195750.0,775,1300,68360,11,525,2014,Chevrolet
420340,4.9,20477.0,24300,24500,61450,1,200,2015,Ford
480694,5.0,9093.0,14500,14600,73130,1,100,2015,Chevrolet
374416,4.1,38732.0,17400,16700,64520,3,-700,2015,Nissan
365801,2.8,60018.0,11100,12100,64520,4,1000,2015,Ford
97480,4.0,57033.0,27400,28400,68360,3,1000,2015,Chevrolet
287771,3.5,40541.0,16550,16300,59100,1,-250,2015,Ford
257929,2.9,44458.0,10550,12600,59100,4,2050,2015,Nissan
277337,3.8,36631.0,10150,11200,59100,4,1050,2015,Ford
230785,4.4,41610.0,13600,12800,89090,1,-800,2015,Ford
466740,3.8,77045.0,8750,10000,61490,4,1250,2015,Chevrolet
530926,1.9,176274.0,1975,1300,82150,11,-675,2015,Ford
304893,4.9,13742.0,20500,20700,59100,0,200,2015,Ford
522759,2.9,32650.0,16900,16800,71660,2,-100,2015,Ford
117635,1.9,153816.0,2775,2000,68360,8,-775,2015,Chevrolet
372107,4.6,43831.0,19700,20100,64520,3,400,2015,Ford
238722,3.2,147158.0,3325,4000,59100,11,675,2014,Ford
535856,2.0,67456.0,14300,9000,82150,3,-5300,2015,Nissan
106860,4.3,7711.0,17000,17300,68360,0,300,2015,Chevrolet
111128,2.0,104648.0,22300,17750,68360,7,-4550,2015,Ford
416692,1.9,124205.0,7475,5600,61450,5,-1875,2015,Ford
108762,3.6,39946.0,9800,10500,68360,2,700,2015,Ford
304411,2.0,71156.0,1800,700,59100,12,-1100,2015,Ford
521402,3.7,27037.0,21400,22300,71660,1,900,2015,Nissan
215063,4.1,100729.0,31900,31600,57290,3,-300,2015,Ford
139596,2.5,61178.0,10300,10300,73100,5,0,2015,Chevrolet
437271,3.1,100894.0,4250,3700,74430,4,-550,2015,Chevrolet
388610,3.4,86065.0,8900,8800,65610,5,-100,2015,Chevrolet
535611,1.9,115160.0,1925,1300,82150,10,-625,2015,Ford
526452,4.3,8683.0,12450,12900,70210,4,450,2015,Ford
288172,4.7,63607.0,15600,18100,59100,4,2500,2015,Ford
519119,2.3,68907.0,6425,7100,71660,9,675,2015,Ford
184145,2.8,143908.0,3850,3800,63250,12,-50,2015,Chevrolet
261945,3.1,115055.0,10000,11600,59100,9,1600,2015,Ford
532980,3.4,171453.0,6175,7000,82150,9,825,2015,Ford
10248,4.2,105575.0,6550,6800,77030,2,250,2014,Ford
211534,3.6,74042.0,40200,38500,57290,2,-1700,2015,Ford
98670,3.9,36012.0,10600,10600,68360,2,0,2015,Ford
524862,4.5,36938.0,32500,34000,70210,1,1500,2014,Ford
211717,1.0,41302.0,8275,3800,57290,3,-4475,2015,Nissan
259742,4.7,15319.0,17300,18400,59100,2,1100,2015,Nissan
297975,1.9,175073.0,2250,1400,59100,12,-850,2015,Ford
200868,4.1,25448.0,17050,19500,67090,2,2450,2015,Chevrolet
332382,4.2,21932.0,11950,11800,82750,2,-150,2015,Ford
449466,1.9,127340.0,2025,2000,61490,13,-25,2014,Chevrolet
468124,2.0,148157.0,1700,2200,61490,13,500,2015,Ford
185282,4.4,10900.0,16300,15900,63250,2,-400,2015,Nissan
480818,5.0,28174.0,12350,12300,73130,3,-50,2015,Nissan
385607,3.2,63971.0,25500,23600,65610,7,-1900,2015,Ford
393064,3.2,90222.0,20700,18500,65610,4,-2200,2015,Chevrolet
42252,4.2,55191.0,10250,10300,77030,2,50,2015,Chevrolet
111209,4.1,30472.0,23000,24300,68360,2,1300,2015,Ford
14424,2.6,106945.0,3975,3300,77030,5,-675,2015,Nissan
382123,5.0,21300.0,25700,27100,65610,3,1400,2014,Ford
528711,3.6,149456.0,2700,2200,70210,9,-500,2015,Chevrolet
179911,2.8,56057.0,15250,14900,83200,2,-350,2015,Ford
284294,4.6,23994.0,14650,16200,59100,2,1550,2015,Nissan
341261,3.5,34804.0,16550,15900,82750,2,-650,2015,Ford
377101,3.4,45172.0,18400,17600,64520,2,-800,2015,Nissan
437350,2.7,214133.0,2850,2900,74430,8,50,2015,Nissan
510830,4.2,22204.0,12400,13200,71660,1,800,2015,Ford
194999,4.7,94775.0,11300,6900,67090,2,-4400,2015,Nissan
243680,4.8,24634.0,12850,15400,59100,3,2550,2015,Nissan
226918,3.5,46415.0,18350,19000,89090,3,650,2015,Chevrolet
6512,4.3,36423.0,23500,24250,77030,2,750,2014,Ford
321014,1.9,43711.0,16550,14400,82750,3,-2150,2015,Chevrolet
542017,2.7,72639.0,8825,10500,81400,7,1675,2015,Ford
319886,4.8,54505.0,9200,11600,73200,2,2400,2015,Chevrolet
127388,4.6,11156.0,15000,16500,73100,2,1500,2015,Chevrolet
281301,2.8,270398.0,2200,3900,59100,12,1700,2015,Chevrolet
358964,2.7,83053.0,7700,8200,62960,7,500,2015,Nissan
506661,2.0,143275.0,3725,3000,80200,8,-725,2015,Ford
169931,3.1,23364.0,13600,12700,73100,1,-900,2015,Ford
335427,2.9,24561.0,14150,13600,82750,2,-550,2015,Nissan
369540,4.1,38819.0,26100,28900,64520,2,2800,2015,Ford
528416,4.6,1436.0,45500,43500,70210,1,-2000,2015,Chevrolet
238736,5.0,5780.0,38900,38000,59100,1,-900,2015,Ford
287070,3.4,57351.0,14350,14500,59100,2,150,2015,Nissan
321231,3.6,47487.0,15000,16400,82750,3,1400,2015,Nissan
213779,4.8,15872.0,30100,31300,57290,1,1200,2015,Ford
338500,3.2,35213.0,10550,10300,82750,3,-250,2015,Nissan
546958,3.1,7821.0,9125,8100,81400,3,-1025,2015,Nissan
284605,4.8,26964.0,12800,16200,59100,3,3400,2015,Nissan
284071,2.4,184456.0,3600,4300,59100,8,700,2015,Ford
471947,2.0,12365.0,18850,11100,62930,0,-7750,2015,Ford
110004,4.4,15148.0,16200,16400,68360,1,200,2015,Ford
222707,2.4,132607.0,8125,7900,89090,7,-225,2014,Ford
520979,3.6,28103.0,24500,24100,71660,1,-400,2015,Ford
202740,4.3,39350.0,39100,38400,57290,0,-700,2014,Chevrolet
283515,2.7,120112.0,7550,7900,59100,8,350,2015,Ford
383860,4.2,71709.0,15350,15400,65610,3,50,2015,Ford
388976,4.4,60202.0,4175,5100,65610,10,925,2015,Ford
520984,3.6,71258.0,15850,17000,71660,3,1150,2015,Chevrolet
500068,4.9,15764.0,34800,34400,80610,2,-400,2015,Ford
349297,2.3,76361.0,5350,4600,62960,13,-750,2014,Chevrolet
470735,4.1,13242.0,31300,30900,62930,0,-400,2014,Chevrolet
396302,4.1,98087.0,31500,31000,65610,4,-500,2015,Ford
548626,3.6,104619.0,3425,5500,48460,8,2075,2015,Chevrolet
228089,3.8,58638.0,11850,11500,89090,2,-350,2015,Nissan
233324,,47026.0,8900,7800,59100,3,-1100,2014,Nissan
396924,4.8,25784.0,19150,20200,65610,3,1050,2015,Ford
55101,2.6,57962.0,7425,9250,77030,5,1825,2015,Nissan
211510,4.4,24878.0,22700,21800,57290,2,-900,2015,Ford
102064,3.9,73148.0,22700,23500,68360,6,800,2015,Ford
548350,2.0,120136.0,2875,2200,56990,14,-675,2015,Ford
196557,3.5,109797.0,9225,8500,67090,4,-725,2015,Ford
19896,4.2,62186.0,15450,14800,77030,2,-650,2015,Ford
491846,3.7,23130.0,31600,32000,73130,0,400,2015,Ford
345396,3.4,24819.0,15000,14400,82750,3,-600,2015,Nissan
442217,2.0,54445.0,9375,6200,74430,3,-3175,2015,Chevrolet
459599,2.6,98213.0,7925,8100,61490,3,175,2015,Nissan
502781,3.7,85409.0,9700,10100,80610,7,400,2015,Chevrolet
123947,1.0,65641.0,8950,8500,73100,3,-450,2015,Chevrolet
262142,4.7,33902.0,16200,17700,59100,1,1500,2015,Ford
228070,4.1,57237.0,17900,17700,89090,2,-200,2015,Chevrolet
95639,4.4,29394.0,11900,12700,68360,1,800,2015,Nissan
528302,1.9,269851.0,1950,1700,70210,13,-250,2015,Chevrolet
231108,2.8,112337.0,6850,8000,89090,12,1150,2015,Chevrolet
438106,2.7,322887.0,1375,2600,74430,11,1225,2015,Ford
316504,,121948.0,16700,14300,73200,2,-2400,2014,Ford
502415,1.9,45773.0,22700,24100,80610,2,1400,2015,Chevrolet
332875,3.6,21265.0,14950,14200,82750,3,-750,2015,Nissan
269954,3.0,18884.0,13350,13300,59100,1,-50,2015,Chevrolet
311203,1.9,167994.0,1175,500,59100,12,-675,2015,Nissan
182998,,,1200,700,63250,9,-500,2014,Ford
110002,4.4,19791.0,11450,11200,68360,1,-250,2015,Ford
406438,3.8,11350.0,21100,20800,61450,2,-300,2015,Nissan
483821,2.8,21370.0,14250,13500,73130,2,-750,2015,Nissan
527209,3.3,145926.0,8900,6500,70210,8,-2400,2015,Ford
345167,2.8,46957.0,20400,19700,82750,2,-700,2015,Ford
498708,4.4,55905.0,14600,14500,80610,3,-100,2014,Nissan
514962,4.4,35927.0,14600,14500,71660,1,-100,2015,Ford
325133,2.7,40383.0,17850,15800,82750,4,-2050,2015,Nissan
165363,3.5,18383.0,19250,19500,73100,1,250,2015,Ford
478882,4.3,29687.0,22400,26000,73130,1,3600,2015,Ford
220390,3.9,13579.0,26200,26700,57290,0,500,2015,Chevrolet
250170,4.6,30430.0,10450,11000,59100,3,550,2015,Chevrolet
142688,4.0,31893.0,13350,13900,73100,4,550,2015,Nissan
513145,5.0,12377.0,19450,22300,71660,1,2850,2015,Ford
264148,2.7,65401.0,18450,13990,59100,5,-4460,2015,Ford
4121,,194988.0,9425,10500,77030,9,1075,2014,Chevrolet
437745,2.7,102335.0,3050,3100,74430,5,50,2015,Chevrolet
459786,3.1,146815.0,2750,3200,61490,8,450,2015,Chevrolet
467351,3.7,118720.0,14700,15100,61490,8,400,2015,Chevrolet
70634,4.2,32087.0,10900,10300,77030,3,-600,2015,Ford
51566,4.0,5456.0,18350,19100,77030,1,750,2015,Ford
270901,3.5,45052.0,12800,13200,59100,2,400,2015,Nissan
379686,1.9,129111.0,2025,800,64520,12,-1225,2015,Nissan
128270,2.0,106982.0,2675,1600,73100,12,-1075,2015,Ford
127438,3.5,16498.0,15400,15200,73100,2,-200,2015,Ford
388804,4.8,25775.0,28300,29500,65610,2,1200,2015,Ford
308724,4.0,36196.0,13850,14000,59100,1,150,2015,Chevrolet
80696,2.5,40575.0,11900,9800,68360,3,-2100,2015,Nissan
455148,2.7,62808.0,9075,8900,61490,3,-175,2015,Ford
52972,3.5,105606.0,4550,8700,77030,10,4150,2015,Ford
507372,3.6,52598.0,14600,14800,80200,3,200,2015,Chevrolet
113351,2.5,33164.0,11650,10200,68360,3,-1450,2015,Nissan
266535,3.2,78474.0,6350,6000,59100,5,-350,2015,Ford
424909,4.7,16722.0,15800,15000,61450,3,-800,2015,Nissan
273305,4.0,34613.0,18950,19400,59100,1,450,2015,Ford
499087,4.6,40695.0,12900,13200,80610,1,300,2014,Nissan
92729,2.8,63835.0,10500,10200,68360,8,-300,2015,Nissan
12564,2.8,96095.0,7000,8000,77030,6,1000,2014,Nissan
152192,4.4,17939.0,11700,12200,73100,3,500,2015,Chevrolet
242881,2.6,163077.0,2950,2900,59100,7,-50,2015,Ford
531426,3.8,60742.0,12200,11500,82150,2,-700,2015,Nissan
473782,2.9,21924.0,10950,10300,62930,1,-650,2015,Chevrolet
544995,3.7,77196.0,16850,19200,81400,8,2350,2015,Ford
547623,4.1,27107.0,8975,9500,78090,3,525,2015,Ford
546813,4.4,7863.0,12250,11400,81400,2,-850,2015,Ford
388255,4.9,29104.0,23300,26500,65610,2,3200,2015,Ford
224919,4.9,17523.0,16050,16100,89090,2,50,2015,Ford
25236,4.1,30513.0,14500,17000,77030,2,2500,2015,Ford
281952,2.4,206096.0,825,2200,59100,7,1375,2015,Chevrolet
437705,4.3,30258.0,20500,22400,74430,2,1900,2015,Nissan
14622,4.2,20102.0,10300,11100,77030,2,800,2015,Nissan
522218,2.8,79183.0,7400,6900,71660,3,-500,2015,Ford
275063,4.9,49098.0,26300,26600,59100,4,300,2015,Ford
404125,3.4,38327.0,16000,16000,61450,2,0,2015,Chevrolet
483644,4.1,34691.0,11950,11100,73130,3,-850,2015,Nissan
387870,4.6,39508.0,15500,14700,65610,3,-800,2015,Ford
536026,2.6,132818.0,2525,1800,82150,12,-725,2015,Chevrolet
396926,3.9,32849.0,20800,21000,65610,3,200,2015,Ford
380580,4.3,32895.0,11300,11800,64520,3,500,2015,Ford
530108,1.9,144122.0,750,425,82150,14,-325,2014,Chevrolet
460034,3.4,50154.0,9425,10100,61490,2,675,2015,Chevrolet
102246,2.7,31110.0,15800,14800,68360,3,-1000,2015,Nissan
12602,2.7,92669.0,6150,6500,77030,8,350,2015,Nissan
133544,2.6,169871.0,1725,2300,73100,12,575,2015,Ford
295061,2.2,55895.0,17650,6500,59100,5,-11150,2015,Chevrolet
497205,2.4,64254.0,25600,26900,73130,4,1300,2015,Ford
450624,1.4,223102.0,1675,900,61490,14,-775,2015,Chevrolet
547191,1.9,86379.0,1475,300,78090,12,-1175,2015,Chevrolet
502876,1.9,35866.0,14550,10600,80610,2,-3950,2015,Ford
392933,4.3,25873.0,21700,20900,65610,1,-800,2015,Ford
147562,4.8,8779.0,55400,53000,73100,1,-2400,2015,Chevrolet
105149,1.9,99295.0,3875,3700,68360,10,-175,2015,Ford
91963,3.5,60853.0,11650,11700,68360,2,50,2015,Chevrolet
181035,3.7,47663.0,12900,13200,83200,2,300,2015,Ford
19465,1.9,205255.0,1600,1950,77030,10,350,2015,Chevrolet
53584,4.2,40766.0,30800,30200,77030,1,-600,2015,Ford
288960,3.3,200930.0,1950,3800,59100,8,1850,2015,Nissan
129220,4.2,25978.0,26000,26100,73100,3,100,2015,Ford
142588,4.4,26826.0,18050,16500,73100,3,-1550,2015,Nissan
478503,4.0,22553.0,22600,19400,73130,2,-3200,2015,Nissan
285378,4.3,7243.0,12650,13000,59100,1,350,2015,Nissan
528342,2.8,35625.0,13150,10900,70210,2,-2250,2015,Ford
117177,1.9,127662.0,14250,12700,68360,9,-1550,2015,Chevrolet
481800,3.3,44394.0,11400,13800,73130,3,2400,2015,Nissan
239064,3.8,25131.0,12100,12300,59100,1,200,2015,Ford
394216,4.8,11822.0,31100,34500,65610,2,3400,2015,Nissan
545440,3.9,29983.0,10800,11800,81400,2,1000,2015,Ford
510872,3.8,34209.0,16350,17500,71660,1,1150,2015,Ford
284554,4.5,21910.0,13300,13800,59100,3,500,2015,Nissan
486430,4.6,15877.0,10900,11900,73130,1,1000,2015,Nissan
488152,1.9,29798.0,12400,9200,73130,3,-3200,2015,Nissan
120403,1.9,131361.0,5500,3500,73100,7,-2000,2014,Nissan
28323,2.8,142281.0,1650,1300,77030,14,-350,2015,Ford
467270,3.7,41259.0,8975,7800,61490,4,-1175,2015,Chevrolet
194142,4.7,52366.0,14550,15000,67090,3,450,2015,Chevrolet
20936,3.7,83081.0,8975,9000,77030,7,25,2015,Ford
152378,5.0,16916.0,10950,10600,73100,1,-350,2015,Chevrolet
22559,2.6,143392.0,2050,2600,77030,12,550,2015,Nissan
355165,2.0,182003.0,925,300,62960,12,-625,2015,Ford
351723,3.0,16447.0,12700,12500,62960,1,-200,2015,Chevrolet
499942,4.1,38922.0,14350,14400,80610,1,50,2015,Ford
283172,2.8,67055.0,10550,10400,59100,3,-150,2015,Ford
136416,4.2,31949.0,18550,17500,73100,4,-1050,2015,Chevrolet
548993,3.4,166349.0,10850,9000,48460,8,-1850,2015,Chevrolet
107413,4.1,62713.0,9325,9700,68360,5,375,2015,Ford
431758,4.4,73759.0,29700,31500,61450,4,1800,2015,Chevrolet
446651,3.0,22840.0,17700,15100,56120,1,-2600,2015,Nissan
308975,4.5,28948.0,21400,22100,59100,3,700,2015,Ford
75659,,67750.0,9650,10500,68360,2,850,2014,Ford
518233,3.9,29210.0,15950,16600,71660,2,650,2015,Ford
345498,2.7,132582.0,6325,6000,82750,8,-325,2015,Nissan
228168,1.9,72842.0,2650,2400,89090,13,-250,2015,Ford
327145,4.0,39614.0,16400,17400,82750,4,1000,2015,Nissan
407075,1.9,109576.0,6150,5100,61450,9,-1050,2015,Nissan
138996,4.7,35308.0,16050,15000,73100,3,-1050,2015,Ford
118653,4.6,28937.0,19450,21900,68360,3,2450,2015,Nissan
425803,1.9,66169.0,12050,6500,61450,3,-5550,2015,Nissan
48784,3.2,148453.0,1300,1800,77030,15,500,2015,Chevrolet
208818,3.1,39629.0,12900,12600,57290,2,-300,2015,Nissan
82820,3.9,29049.0,12100,12500,68360,3,400,2015,Ford
429805,2.3,4794.0,11300,7300,61450,0,-4000,2015,Nissan
182460,4.3,34160.0,14600,14100,63250,3,-500,2014,Ford
214648,3.7,69678.0,14350,16300,57290,7,1950,2015,Chevrolet
337957,4.7,36673.0,18550,18600,82750,3,50,2015,Ford
289159,3.5,23376.0,14050,13800,59100,1,-250,2015,Ford
319834,2.9,66716.0,7575,8000,73200,8,425,2015,Chevrolet
157264,2.5,53119.0,16100,14500,73100,2,-1600,2015,Chevrolet
486640,3.9,27894.0,14550,15200,73130,3,650,2015,Nissan
533018,3.5,53827.0,19900,19000,82150,5,-900,2015,Chevrolet
312087,3.6,56876.0,10800,11300,59100,2,500,2015,Nissan
112946,4.6,32742.0,16600,15000,68360,1,-1600,2015,Ford
276230,2.3,36272.0,17300,15200,59100,3,-2100,2015,Nissan
22876,4.5,35002.0,15100,15100,77030,2,0,2015,Ford
206421,3.5,51557.0,12650,13400,57290,4,750,2015,Nissan
57693,2.4,60024.0,14300,11000,77030,5,-3300,2015,Chevrolet
454772,3.1,76414.0,8125,8500,61490,4,375,2015,Ford
440693,1.0,136487.0,1600,500,74430,13,-1100,2015,Chevrolet
309751,2.6,23902.0,19650,16600,59100,2,-3050,2015,Nissan
275973,5.0,8456.0,12400,14400,59100,2,2000,2015,Nissan
280635,1.9,134569.0,4625,5700,59100,10,1075,2015,Ford
341132,4.7,18827.0,23500,25000,82750,1,1500,2015,Ford
75921,3.5,98827.0,4475,5000,68360,7,525,2014,Chevrolet
518450,3.6,35819.0,10850,11400,71660,1,550,2015,Ford
49018,3.9,34655.0,10250,10800,77030,1,550,2015,Ford
478466,3.9,54698.0,10100,9300,73130,2,-800,2015,Ford
491413,2.6,20926.0,12300,10800,73130,2,-1500,2015,Nissan
469269,3.5,40908.0,16400,17400,61490,3,1000,2015,Nissan
11407,3.5,59502.0,8975,8500,77030,3,-475,2015,Chevrolet
386178,4.2,34072.0,38900,37500,65610,4,-1400,2015,Ford
229445,3.7,64468.0,14700,14700,89090,2,0,2015,Ford
219644,4.4,46410.0,27700,29700,57290,3,2000,2015,Nissan
323832,2.9,41396.0,13000,9400,82750,4,-3600,2015,Nissan
427314,4.0,31353.0,13200,14100,61450,1,900,2015,Ford
458152,1.9,130826.0,8025,7700,61490,6,-325,2015,Nissan
306385,4.3,25235.0,9150,9200,59100,5,50,2015,Chevrolet
233651,2.9,109250.0,8450,8100,59100,6,-350,2015,Ford
430591,1.9,190185.0,4350,4900,61450,8,550,2015,Nissan
20140,4.3,11643.0,25500,27250,77030,2,1750,2015,Nissan
71711,4.9,1751.0,12200,12200,77030,0,0,2015,Nissan
346929,1.9,72223.0,6425,6100,82750,3,-325,2015,Nissan
81836,3.3,128999.0,5675,5900,68360,7,225,2015,Chevrolet
135957,2.7,109153.0,6800,7200,73100,9,400,2015,Nissan
311709,4.0,9063.0,51500,48600,59100,0,-2900,2015,Chevrolet
407507,2.8,130693.0,3550,4500,61450,9,950,2015,Chevrolet
160203,2.6,45991.0,11000,11600,73100,3,600,2015,Nissan
271159,3.1,169290.0,2750,2700,59100,10,-50,2015,Chevrolet
540408,3.5,40068.0,16550,17500,81400,2,950,2014,Ford
59745,3.4,43735.0,14450,13600,77030,2,-850,2015,Ford
525845,4.9,18153.0,16250,15300,70210,1,-950,2015,Ford
162191,3.5,16049.0,20800,19500,73100,2,-1300,2015,Ford
76684,4.4,32898.0,27300,27400,68360,0,100,2014,Ford
510839,4.0,34090.0,12000,12300,71660,1,300,2015,Ford
225418,4.1,61718.0,13700,14500,89090,2,800,2015,Nissan
481202,3.6,26251.0,19750,19900,73130,1,150,2015,Ford
301398,4.5,14895.0,18500,18400,59100,3,-100,2015,Nissan
247741,4.0,22807.0,13000,13100,59100,1,100,2015,Chevrolet
281525,3.6,43178.0,11650,12000,59100,3,350,2015,Nissan
132119,2.1,99971.0,10250,7900,73100,7,-2350,2015,Nissan
522776,4.3,33762.0,36500,36900,71660,0,400,2015,Ford
126140,3.7,62702.0,9325,9600,73100,3,275,2015,Chevrolet
218562,4.5,26137.0,19000,19000,57290,1,0,2015,Ford
470383,4.4,92249.0,9400,9200,61490,3,-200,2015,Chevrolet
61759,4.6,21793.0,26800,27200,77030,1,400,2015,Ford
423572,3.6,49955.0,21300,18500,61450,1,-2800,2015,Ford
537883,1.9,62092.0,9725,8200,55590,2,-1525,2014,Ford
474515,4.4,48762.0,11300,11100,62930,2,-200,2015,Nissan
531042,2.5,127178.0,7475,5800,82150,3,-1675,2015,Ford
312271,3.7,16772.0,16450,17300,59100,3,850,2015,Ford
83681,4.3,36383.0,26400,27700,68360,3,1300,2015,Ford
543863,4.2,23309.0,12350,12500,81400,1,150,2015,Ford
282214,3.4,57088.0,7125,7300,59100,4,175,2015,Chevrolet
201392,3.2,17.0,18500,16000,57290,0,-2500,2014,Nissan
519864,1.9,70641.0,1725,2000,71660,14,275,2015,Chevrolet
173065,3.5,141149.0,4250,4900,83200,4,650,2014,Chevrolet
416686,1.9,126040.0,4625,4600,61450,5,-25,2015,Chevrolet
165199,3.4,37270.0,9750,9800,73100,3,50,2015,Nissan
429253,2.8,42311.0,7575,7000,61450,3,-575,2015,Nissan
513702,4.7,24701.0,26100,26600,71660,2,500,2015,Ford
220773,3.1,57202.0,7350,8300,57290,3,950,2015,Chevrolet
497973,5.0,11144.0,19400,19500,73130,1,100,2015,Ford
63571,3.6,7948.0,12250,12900,77030,2,650,2015,Nissan
70543,2.5,22214.0,13900,12500,77030,2,-1400,2015,Nissan
94348,3.6,96991.0,7175,7600,68360,4,425,2015,Ford
383565,4.7,89184.0,10850,10200,65610,2,-650,2014,Ford
322614,4.7,3715.0,20500,20500,82750,1,0,2015,Ford
265772,4.2,63736.0,11950,12100,59100,2,150,2015,Ford
63605,4.2,7413.0,8750,8900,77030,3,150,2015,Nissan
315050,1.9,45630.0,8200,4200,59100,2,-4000,2015,Chevrolet
279825,2.3,109139.0,4650,4800,59100,8,150,2015,Chevrolet
169873,3.8,12183.0,19650,20000,73100,1,350,2015,Ford
338728,3.8,30313.0,14850,15000,82750,2,150,2015,Nissan
525029,4.8,12571.0,33200,33800,70210,0,600,2014,Ford
486790,3.7,26176.0,15100,15800,73130,2,700,2015,Ford
442069,2.0,181612.0,1075,225,74430,12,-850,2015,Chevrolet
477623,4.4,34449.0,18150,18400,73130,1,250,2015,Ford
366655,3.8,28452.0,12150,12000,64520,3,-150,2015,Ford
109727,4.1,67824.0,14600,13400,68360,5,-1200,2015,Nissan
497862,3.0,33073.0,16600,15900,73130,3,-700,2015,Nissan
507351,3.8,40121.0,18650,19000,80200,5,350,2015,Nissan
62381,4.2,37772.0,10350,10600,77030,3,250,2015,Ford
87048,3.4,100168.0,40000,32250,68360,3,-7750,2015,Ford
345807,3.6,52362.0,10350,10000,82750,1,-350,2015,Chevrolet
275989,1.9,25540.0,22300,15600,59100,1,-6700,2015,Chevrolet
236166,3.7,40076.0,12650,12400,59100,1,-250,2014,Chevrolet
402119,2.7,136272.0,4350,5500,61450,7,1150,2015,Chevrolet
484277,2.1,16502.0,13150,11600,73130,3,-1550,2015,Nissan
492368,3.6,77693.0,11900,9100,73130,5,-2800,2015,Nissan
459108,1.9,103095.0,15900,17500,61490,7,1600,2015,Chevrolet
110916,3.8,29654.0,9800,10800,68360,3,1000,2015,Ford
462072,1.9,111281.0,1325,2400,61490,14,1075,2015,Ford
158218,2.8,25057.0,18850,16800,73100,3,-2050,2015,Nissan
205125,4.9,30546.0,33300,33400,57290,2,100,2015,Ford
243085,4.2,15076.0,12550,12800,59100,1,250,2015,Ford
185956,3.8,46094.0,10850,10700,63250,2,-150,2015,Chevrolet
530396,3.7,160688.0,1700,1100,82150,9,-600,2015,Ford
396152,4.3,35248.0,8350,9000,65610,3,650,2015,Chevrolet
484853,4.3,12254.0,20400,20600,73130,1,200,2015,Ford
207754,1.6,115477.0,6350,7000,57290,8,650,2015,Chevrolet
421245,1.9,108983.0,7575,9600,61450,10,2025,2015,Ford
515674,4.2,38928.0,15650,15100,71660,3,-550,2015,Ford
150571,4.5,16237.0,21000,22800,73100,1,1800,2015,Ford
14885,2.8,87011.0,3775,5400,77030,5,1625,2015,Chevrolet
93374,3.8,60802.0,10150,11200,68360,3,1050,2015,Ford
192192,2.7,73456.0,5750,6000,67090,5,250,2014,Chevrolet
369535,4.2,15936.0,15050,14600,64520,2,-450,2015,Ford
125496,4.0,35898.0,17150,18200,73100,3,1050,2015,Nissan
63638,2.6,103110.0,12100,12750,77030,8,650,2015,Chevrolet
522478,4.8,71062.0,2000,4000,71660,12,2000,2015,Chevrolet
261777,2.8,101882.0,12300,11000,59100,7,-1300,2015,Chevrolet
54356,1.9,225183.0,4575,3800,77030,11,-775,2015,Ford
529886,3.9,64183.0,5950,5550,82150,3,-400,2014,Nissan
469258,3.8,83376.0,8150,8200,61490,3,50,2015,Ford
417066,3.4,285584.0,5425,5500,61450,9,75,2015,Ford
237377,3.8,40763.0,16250,15500,59100,1,-750,2015,Chevrolet
27425,4.8,1356.0,17800,18200,77030,1,400,2015,Ford
387251,4.0,33315.0,14600,15000,65610,3,400,2015,Ford
509488,4.5,16348.0,12600,13600,71660,1,1000,2015,Ford
251807,4.7,26261.0,29100,31000,59100,1,1900,2015,Chevrolet
4504,1.9,93226.0,3700,2600,77030,10,-1100,2014,Nissan
270904,3.6,38209.0,13200,11400,59100,2,-1800,2015,Nissan
409329,1.9,76322.0,4950,4200,61450,4,-750,2015,Chevrolet
86171,2.5,83467.0,5600,4500,68360,4,-1100,2015,Chevrolet
371495,2.3,34813.0,13200,11700,64520,3,-1500,2015,Ford
128983,3.9,13272.0,21200,20700,73100,1,-500,2015,Ford
486144,3.6,23902.0,21100,19500,73130,2,-1600,2015,Ford
97740,2.9,76478.0,9650,8900,68360,10,-750,2015,Chevrolet
151735,4.2,29610.0,13850,13800,73100,2,-50,2015,Chevrolet
495212,3.8,85374.0,4825,5800,73130,7,975,2015,Ford
509413,4.5,26596.0,17550,18500,71660,1,950,2015,Ford
233658,3.6,25882.0,18800,18900,59100,0,100,2014,Ford
90153,4.3,15313.0,10150,10400,68360,2,250,2015,Chevrolet
544088,4.3,34946.0,21800,23900,81400,2,2100,2015,Nissan
11353,3.5,36283.0,13200,13300,77030,1,100,2014,Nissan
432747,,31213.0,12150,7300,74430,0,-4850,2014,Ford
207015,4.8,14805.0,12250,13800,57290,2,1550,2015,Nissan
370262,3.4,60455.0,11650,10800,64520,2,-850,2015,Chevrolet
217087,4.1,49652.0,17200,20000,57290,3,2800,2015,Nissan
271873,3.2,48679.0,27600,26300,59100,2,-1300,2015,Chevrolet
113533,2.2,156138.0,12250,10600,68360,8,-1650,2015,Chevrolet
226934,4.1,34303.0,8925,8000,89090,3,-925,2015,Ford
49815,3.0,124145.0,6500,6300,77030,7,-200,2015,Nissan
336234,3.0,21265.0,9825,9900,82750,2,75,2015,Ford
102939,3.0,109849.0,7075,7000,68360,5,-75,2015,Ford
361522,3.5,104859.0,4850,4700,64520,5,-150,2014,Ford
168127,4.6,31073.0,9775,10700,73100,3,925,2015,Chevrolet
18837,3.9,29722.0,9850,10400,77030,3,550,2015,Ford
126467,3.0,23782.0,12150,11900,73100,1,-250,2015,Chevrolet
345636,4.0,12540.0,18950,19000,82750,2,50,2015,Nissan
548892,5.0,28043.0,35400,36000,48460,3,600,2015,Ford
216506,4.4,38897.0,17550,18400,57290,1,850,2015,Ford
318994,3.1,48454.0,13550,12900,73200,2,-650,2015,Chevrolet
225890,2.9,78092.0,8200,6500,89090,3,-1700,2015,Chevrolet
259218,3.7,57432.0,6550,7400,59100,8,850,2015,Chevrolet
183519,2.9,61711.0,12150,13100,63250,2,950,2014,Chevrolet
396660,4.9,8902.0,18450,20000,65610,0,1550,2015,Chevrolet
179760,2.2,86296.0,13350,11900,83200,5,-1450,2015,Ford
345688,2.5,22421.0,8825,6200,82750,3,-2625,2015,Ford
404020,2.1,41973.0,20400,16000,61450,4,-4400,2015,Ford
203370,4.2,101492.0,5800,6300,57290,5,500,2015,Ford
78756,4.5,22975.0,19350,19200,68360,1,-150,2015,Ford
80493,2.6,124339.0,32400,25500,68360,2,-6900,2015,Chevrolet
243094,3.7,16965.0,16350,15800,59100,1,-550,2015,Ford
193354,2.7,83208.0,13550,12300,67090,3,-1250,2015,Ford
459625,3.1,87298.0,6575,7500,61490,4,925,2015,Ford
221684,1.9,122195.0,10750,9400,57290,7,-1350,2015,Nissan
395497,3.5,90315.0,24000,24300,65610,4,300,2015,Ford
73311,,130497.0,11950,9000,68360,3,-2950,2014,Ford
436791,3.1,117484.0,1925,1500,74430,12,-425,2015,Chevrolet
72065,3.8,38289.0,9175,7750,77030,1,-1425,2015,Nissan
143126,3.5,28876.0,19150,18600,73100,3,-550,2015,Ford
313355,3.7,23780.0,9875,9800,59100,1,-75,2015,Nissan
284248,4.0,44362.0,12650,13900,59100,2,1250,2015,Nissan
116162,3.6,82674.0,15400,16250,68360,4,850,2015,Ford
448124,1.9,204604.0,900,1300,56120,13,400,2015,Nissan
525650,3.4,84629.0,10450,9200,70210,5,-1250,2015,Ford
504876,2.6,123811.0,15200,13800,80610,5,-1400,2015,Chevrolet
236248,4.6,11261.0,22900,22500,59100,1,-400,2014,Ford
526752,2.6,38659.0,15850,14300,70210,2,-1550,2015,Ford
527984,1.9,132514.0,4425,700,70210,8,-3725,2015,Ford
297573,3.4,10215.0,12600,13000,59100,2,400,2015,Nissan
441750,1.9,202581.0,2375,2000,74430,14,-375,2015,Ford
106594,3.7,44317.0,11000,11000,68360,3,0,2015,Nissan
210430,4.7,26496.0,16750,16800,57290,1,50,2015,Ford
83401,3.5,9690.0,10850,10900,68360,1,50,2015,Ford
381079,4.8,4886.0,12150,12700,64520,1,550,2015,Chevrolet
113669,4.1,65239.0,12550,13400,68360,2,850,2015,Ford
116853,3.1,43716.0,13000,13200,68360,3,200,2015,Nissan
276735,3.2,98832.0,13700,13900,59100,8,200,2015,Chevrolet
259191,2.4,57292.0,5375,4800,59100,7,-575,2015,Ford
216613,4.4,24551.0,45100,45100,57290,2,0,2015,Ford
78465,4.0,17853.0,15300,15200,68360,2,-100,2015,Ford
156451,4.0,20954.0,13300,13500,73100,1,200,2015,Chevrolet
210346,4.9,10765.0,27500,23800,57290,1,-3700,2015,Ford
319556,4.2,34238.0,15900,16000,73200,1,100,2015,Chevrolet
430625,2.7,123798.0,3250,3200,61450,9,-50,2015,Chevrolet
297665,3.7,25756.0,12250,12200,59100,3,-50,2015,Nissan
335430,4.3,35552.0,13400,13000,82750,2,-400,2015,Nissan
427274,1.9,165664.0,7075,8500,61450,10,1425,2015,Ford
491791,3.0,26041.0,13350,13100,73130,1,-250,2015,Chevrolet
340566,4.8,59094.0,14750,15501,82750,2,751,2015,Nissan
122654,4.1,49482.0,14850,14000,73100,3,-850,2015,Nissan
224698,2.4,150350.0,4775,3600,89090,9,-1175,2015,Nissan
76194,2.9,57112.0,10200,9000,68360,2,-1200,2014,Chevrolet
475285,,87348.0,5575,5800,73130,6,225,2014,Ford
45062,2.5,108464.0,11550,12100,77030,8,550,2015,Chevrolet
378224,1.9,63256.0,13050,11200,64520,7,-1850,2015,Ford
519296,3.9,68805.0,14350,14200,71660,2,-150,2015,Ford
246762,2.3,92995.0,5500,6600,59100,11,1100,2015,Nissan
520375,2.7,58686.0,9100,8100,71660,3,-1000,2015,Chevrolet
207540,4.7,21665.0,15700,17400,57290,1,1700,2015,Nissan
119312,3.4,53227.0,27600,29600,73100,3,2000,2014,Ford
336963,3.8,60100.0,22800,22300,82750,2,-500,2015,Ford
199731,3.2,53200.0,9200,9600,67090,2,400,2015,Chevrolet
110159,3.0,61548.0,20600,18500,68360,2,-2100,2015,Ford
509535,4.6,37212.0,18400,19100,71660,2,700,2015,Ford
134512,1.9,95444.0,2025,3400,73100,12,1375,2015,Nissan
201132,2.6,39327.0,16600,14600,57290,4,-2000,2015,Nissan
115223,2.0,80397.0,4850,5200,68360,7,350,2015,Nissan
241809,4.1,39013.0,10600,10500,59100,4,-100,2014,Chevrolet
437890,2.7,92253.0,2400,2800,74430,11,400,2015,Chevrolet
259827,3.8,40671.0,13800,13500,59100,1,-300,2015,Chevrolet
495126,3.4,44549.0,8250,8400,73130,2,150,2015,Chevrolet
252839,4.0,15699.0,19150,19100,59100,1,-50,2015,Chevrolet
200150,4.0,37175.0,10100,11500,67090,3,1400,2015,Chevrolet
518928,4.4,33942.0,28700,27800,71660,1,-900,2015,Ford
92378,4.3,37709.0,14100,15000,68360,3,900,2015,Ford
225937,2.8,58022.0,12300,10000,89090,4,-2300,2015,Nissan
125580,4.2,34254.0,24900,25900,73100,4,1000,2015,Ford
63685,2.7,114410.0,1075,1500,77030,13,425,2015,Chevrolet
60429,3.3,121254.0,2725,2500,77030,8,-225,2015,Ford
383663,4.0,22096.0,14800,14600,65610,1,-200,2015,Chevrolet
478985,4.0,5483.0,16850,16900,73130,2,50,2015,Ford
538469,4.0,81136.0,9050,9200,55590,3,150,2015,Nissan
378717,4.8,21282.0,9075,10000,64520,3,925,2015,Ford
447193,1.0,7251.0,16300,9600,56120,1,-6700,2015,Nissan
196973,2.6,91903.0,6675,6800,67090,5,125,2015,Chevrolet
500809,4.4,40746.0,8375,9500,80610,4,1125,2015,Ford
459327,3.6,71867.0,6700,8300,61490,8,1600,2015,Chevrolet
458274,1.9,103189.0,3850,2800,61490,8,-1050,2015,Chevrolet
403530,4.0,64656.0,9300,9800,61450,2,500,2015,Chevrolet
459482,2.6,147315.0,4200,5300,61490,13,1100,2015,Chevrolet
425356,3.8,53394.0,12700,12500,61450,2,-200,2015,Nissan
213798,2.5,33868.0,31800,27400,57290,1,-4400,2015,Ford
274647,2.0,251316.0,875,400,59100,15,-475,2015,Ford
512640,2.4,56051.0,10950,9100,71660,3,-1850,2015,Ford
142592,3.4,45249.0,16350,15000,73100,3,-1350,2015,Nissan
53911,3.8,66210.0,9875,9500,77030,3,-375,2015,Ford
265062,1.9,146825.0,2550,1700,59100,14,-850,2015,Ford
183439,3.9,36679.0,13000,12700,63250,1,-300,2014,Nissan
328038,4.5,17317.0,29800,28500,82750,1,-1300,2015,Chevrolet
502925,3.7,51125.0,9900,10800,80610,2,900,2015,Ford
455586,4.4,7073.0,12900,12900,61490,1,0,2015,Ford
417475,1.9,153445.0,1025,1600,61450,18,575,2015,Ford
325159,2.8,28228.0,9450,8300,82750,4,-1150,2015,Nissan
209038,2.1,126633.0,3750,1800,57290,12,-1950,2015,Ford
116757,3.5,59742.0,14500,14600,68360,3,100,2015,Ford
129495,2.7,41354.0,12950,11100,73100,3,-1850,2015,Nissan
84416,3.9,99558.0,7225,8100,68360,6,875,2015,Nissan
235706,,200582.0,700,450,59100,13,-250,2014,Chevrolet
346790,2.1,39472.0,19700,18000,82750,3,-1700,2015,Ford
100683,4.4,52891.0,11300,13000,68360,1,1700,2015,Chevrolet
53415,2.7,30788.0,14300,14200,77030,1,-100,2015,Chevrolet
170226,3.2,84397.0,8825,9600,73100,2,775,2015,Chevrolet
67461,3.8,109340.0,7225,9400,77030,9,2175,2015,Chevrolet
24792,4.0,101338.0,7150,6500,77030,3,-650,2015,Ford
314063,1.9,145394.0,625,400,59100,17,-225,2015,Nissan
411462,3.5,44132.0,11350,10900,61450,3,-450,2015,Nissan
1985,3.0,113585.0,30300,30000,77030,3,-300,2014,Chevrolet
366918,4.2,140111.0,22100,21700,64520,7,-400,2015,Chevrolet
535879,2.9,95169.0,10050,9500,82150,5,-550,2015,Ford
313430,3.5,58363.0,8975,8800,59100,2,-175,2015,Chevrolet
545446,4.7,8415.0,20000,19200,81400,1,-800,2015,Ford
94442,1.9,314712.0,975,2900,68360,6,1925,2015,Ford
548543,2.7,114111.0,5350,6000,48460,6,650,2015,Ford
536806,4.8,37055.0,13150,13300,73640,2,150,2015,Nissan
10446,4.3,105218.0,9725,10400,77030,2,675,2014,Nissan
289263,3.5,19855.0,10750,9500,59100,2,-1250,2015,Chevrolet
106487,3.1,104100.0,8475,9600,68360,7,1125,2015,Chevrolet
502779,1.9,69277.0,13900,12800,80610,6,-1100,2015,Ford
85658,2.5,17716.0,13300,13000,68360,2,-300,2015,Ford
28920,4.2,98471.0,9525,9750,77030,4,225,2015,Nissan
13117,3.5,38697.0,11850,10500,77030,3,-1350,2015,Nissan
216623,4.6,17837.0,11600,12500,57290,2,900,2015,Ford
120477,2.4,116149.0,4725,2200,73100,8,-2525,2014,Ford
228066,3.9,55718.0,10150,9700,89090,2,-450,2015,Chevrolet
289428,3.5,191869.0,2850,4600,59100,9,1750,2015,Ford
486910,4.0,14240.0,15300,15500,73130,1,200,2015,Chevrolet
195227,3.2,57980.0,13600,14100,67090,3,500,2015,Chevrolet
31444,2.8,36394.0,13250,13000,77030,2,-250,2015,Nissan
51979,3.9,84821.0,9550,9500,77030,4,-50,2015,Ford
356890,4.1,36049.0,15000,14800,62960,1,-200,2015,Chevrolet
382611,4.9,128519.0,12800,14700,65610,7,1900,2014,Chevrolet
161976,4.7,26107.0,12200,12500,73100,3,300,2015,Nissan
388971,2.8,119168.0,3725,2500,65610,9,-1225,2015,Ford
281158,3.9,38588.0,16700,16400,59100,4,-300,2015,Nissan
226858,2.0,19237.0,34400,29500,89090,1,-4900,2015,Ford
481229,4.6,21855.0,17550,17400,73130,1,-150,2015,Ford
350681,3.3,34278.0,14250,14800,62960,2,550,2015,Ford
123989,4.4,39123.0,13800,13700,73100,1,-100,2015,Chevrolet
477699,3.5,23900.0,16900,15900,73130,1,-1000,2015,Ford
383270,2.9,7041.0,15250,13600,65610,1,-1650,2014,Ford
300828,2.7,118085.0,5650,5100,59100,11,-550,2015,Ford
293159,4.5,17020.0,12500,12300,59100,1,-200,2015,Chevrolet
243414,2.1,10684.0,12950,10500,59100,1,-2450,2015,Chevrolet
391270,2.1,71520.0,2925,2050,65610,8,-875,2015,Chevrolet
466709,3.7,74089.0,12650,12600,61490,2,-50,2015,Ford
435376,3.7,56740.0,9500,8100,74430,5,-1400,2015,Nissan
82848,3.7,33549.0,14450,15300,68360,3,850,2015,Ford
434859,2.6,130708.0,2925,2600,74430,11,-325,2015,Ford
173951,3.8,21254.0,13800,13900,83200,2,100,2014,Ford
86446,4.1,107276.0,9775,10900,68360,2,1125,2015,Ford
86767,3.5,83643.0,3750,6600,68360,9,2850,2015,Ford
395045,4.6,47664.0,20800,25000,65610,3,4200,2015,Ford
133602,4.5,8004.0,29700,29700,73100,1,0,2015,Ford
427320,3.1,40209.0,12600,12800,61450,1,200,2015,Ford
209737,4.2,18152.0,11450,11500,57290,1,50,2015,Chevrolet
344627,2.4,124173.0,2725,1900,82750,10,-825,2015,Chevrolet
41274,2.9,57727.0,12100,11500,77030,4,-600,2015,Ford
328678,3.9,22183.0,14000,14400,82750,4,400,2015,Nissan
315202,1.9,92090.0,6850,5100,59100,6,-1750,2015,Chevrolet
107033,1.9,107261.0,23100,17200,68360,7,-5900,2015,Ford
386561,4.6,52140.0,11300,12100,65610,3,800,2015,Ford
57538,1.9,12668.0,11850,3800,77030,1,-8050,2015,Nissan
234494,2.8,127617.0,3725,4200,59100,9,475,2015,Chevrolet
151149,3.4,141665.0,2675,2600,73100,12,-75,2015,Ford
485302,4.8,23000.0,13450,12400,73130,2,-1050,2015,Ford
407168,3.4,110149.0,5850,6400,61450,4,550,2015,Chevrolet
407509,1.9,108088.0,8675,8000,61450,9,-675,2015,Ford
110234,4.5,9803.0,12000,12600,68360,2,600,2015,Nissan
221648,3.5,37385.0,25600,24500,57290,3,-1100,2015,Ford
44751,2.4,52775.0,8850,7100,77030,3,-1750,2015,Ford
391968,2.9,68332.0,17200,16300,65610,7,-900,2015,Chevrolet
31369,4.8,8362.0,36700,39000,77030,2,2300,2015,Ford
236149,3.7,39997.0,10850,11300,59100,2,450,2015,Chevrolet
232813,2.0,158334.0,1950,1250,89090,10,-700,2015,Ford
446297,2.9,223475.0,6950,7200,56120,3,250,2015,Chevrolet
69211,2.7,60220.0,13100,13500,77030,2,400,2015,Nissan
112971,2.7,11230.0,18400,18000,68360,2,-400,2015,Nissan
407478,2.6,125545.0,3925,4400,61450,12,475,2015,Nissan
316843,4.3,16839.0,21400,21800,73200,1,400,2015,Chevrolet
360815,2.1,132231.0,2325,650,64520,10,-1675,2015,Chevrolet
86431,4.3,29902.0,16700,17600,68360,2,900,2015,Chevrolet
121677,,15350.0,20600,20800,73100,0,200,2014,Chevrolet
337610,2.7,49777.0,21100,16800,82750,3,-4300,2015,Chevrolet
434785,4.4,10770.0,8475,8900,74430,1,425,2015,Chevrolet
169883,4.8,14651.0,19500,19500,73100,1,0,2015,Ford
102145,4.3,12731.0,15050,15800,68360,2,750,2015,Nissan
340572,3.5,45217.0,13300,13600,82750,2,300,2015,Nissan
463805,1.9,249386.0,1200,500,61490,11,-700,2015,Ford
58003,2.8,159259.0,3100,1500,77030,9,-1600,2015,Nissan
118182,3.5,124922.0,15300,15000,68360,6,-300,2015,Chevrolet
468142,3.6,47816.0,14250,13500,61490,3,-750,2015,Ford
485088,3.5,43445.0,12700,12600,73130,2,-100,2015,Chevrolet
13470,3.6,70281.0,12700,12500,77030,2,-200,2015,Ford
169643,3.9,113457.0,6225,9700,73100,9,3475,2015,Ford
432584,3.9,16720.0,24100,24000,74430,0,-100,2014,Ford
427361,3.7,35161.0,19050,20100,61450,2,1050,2015,Ford
202331,4.7,43976.0,30800,28400,57290,0,-2400,2014,Ford
10596,3.7,46019.0,10100,10300,77030,3,200,2014,Nissan
112769,3.1,43153.0,24000,22300,68360,1,-1700,2015,Ford
513481,3.9,51394.0,10600,10200,71660,2,-400,2015,Ford
232615,1.9,206125.0,1100,250,89090,12,-850,2015,Ford
103223,5.0,41258.0,16350,17200,68360,2,850,2015,Chevrolet
214102,4.7,19841.0,25700,26400,57290,2,700,2015,Ford
8587,3.9,44836.0,18950,19900,77030,3,950,2015,Ford
198785,2.8,45251.0,13300,13100,67090,2,-200,2015,Nissan
374086,4.6,25166.0,11300,10500,64520,2,-800,2015,Ford
125216,3.8,23620.0,26700,26600,73100,1,-100,2015,Chevrolet
393779,2.3,122667.0,3050,1500,65610,12,-1550,2015,Nissan
11109,2.0,144845.0,1125,800,77030,14,-325,2015,Ford
323247,3.8,31093.0,16050,17600,82750,3,1550,2015,Nissan
159123,4.3,7055.0,8150,8000,73100,1,-150,2015,Chevrolet
156047,4.4,40685.0,13900,14200,73100,3,300,2015,Nissan
20453,4.1,62487.0,11100,11100,77030,3,0,2015,Ford
31192,3.7,181250.0,4850,5500,77030,10,650,2015,Ford
342003,4.0,65958.0,18800,16100,82750,2,-2700,2015,Ford
48189,1.9,84242.0,5450,5400,77030,6,-50,2015,Ford
144981,3.3,96316.0,18500,19500,73100,5,1000,2015,Chevrolet
115300,2.7,132949.0,15000,18400,68360,3,3400,2015,Ford
506763,1.9,128009.0,2200,2100,80200,8,-100,2015,Ford
231290,3.5,124624.0,4125,4000,89090,9,-125,2015,Ford
437747,4.0,126001.0,3500,3500,74430,5,0,2015,Chevrolet
387890,2.9,90098.0,6850,5800,65610,3,-1050,2015,Ford
147770,3.1,31350.0,16450,15700,73100,3,-750,2015,Ford
37933,4.0,41290.0,31000,31400,77030,1,400,2015,Ford
124640,2.3,89344.0,5300,6900,73100,9,1600,2015,Nissan
31987,2.5,149861.0,6025,5300,77030,6,-725,2015,Ford
461266,3.2,67031.0,8475,7400,61490,3,-1075,2015,Chevrolet
458417,2.3,123722.0,5050,6600,61490,9,1550,2015,Ford
522745,3.7,33717.0,18100,17300,71660,1,-800,2015,Ford
362968,3.5,86043.0,19650,19800,64520,4,150,2014,Chevrolet
291119,3.6,58884.0,16300,20600,59100,5,4300,2015,Nissan
116542,2.4,20024.0,13850,14000,68360,1,150,2015,Nissan
425558,4.0,98475.0,9350,8100,61450,5,-1250,2015,Nissan
291848,1.9,141997.0,2500,1700,59100,14,-800,2015,Nissan
435207,2.1,167832.0,4825,4100,74430,9,-725,2015,Chevrolet
319488,2.5,82011.0,20500,19400,73200,3,-1100,2015,Ford
6509,4.0,39010.0,16850,18000,77030,2,1150,2014,Chevrolet
124413,3.5,58267.0,15300,14300,73100,4,-1000,2015,Nissan
308980,4.4,24203.0,17700,18400,59100,3,700,2015,Ford
12761,4.3,65336.0,12500,13100,77030,1,600,2015,Ford
179531,2.3,53745.0,12050,11600,83200,2,-450,2015,Nissan
385694,4.7,139783.0,3450,6000,65610,12,2550,2015,Ford
193510,2.0,131191.0,6775,6000,67090,7,-775,2015,Chevrolet
288323,1.9,179780.0,4075,1900,59100,13,-2175,2015,Chevrolet
541753,3.1,12909.0,19150,18600,81400,3,-550,2015,Ford
490929,3.1,87748.0,8550,9500,73130,3,950,2015,Ford
340908,4.2,50548.0,17000,16800,82750,3,-200,2015,Nissan
91107,4.1,114711.0,10900,11000,68360,7,100,2015,Chevrolet
257771,3.5,39658.0,11650,11000,59100,3,-650,2015,Nissan
156494,3.5,56032.0,23800,22400,73100,2,-1400,2015,Ford
203740,3.8,26177.0,24600,22800,57290,3,-1800,2015,Ford
499157,4.0,26475.0,12250,12000,80610,1,-250,2015,Ford
20324,2.9,51062.0,10050,11200,77030,2,1150,2015,Nissan
110781,4.3,26489.0,15750,15800,68360,2,50,2015,Ford
156250,3.2,19528.0,22000,21200,73100,0,-800,2015,Ford
187412,3.6,57484.0,12000,12100,63250,2,100,2015,Chevrolet
549125,3.7,68362.0,15450,14000,48460,3,-1450,2015,Ford
726,3.4,41790.0,9400,9300,77030,1,-100,2014,Nissan
101121,4.1,32275.0,10350,11100,68360,1,750,2015,Ford
344369,4.6,24249.0,9225,10400,82750,2,1175,2015,Ford
431105,4.4,12743.0,8425,8700,61450,2,275,2015,Nissan
170719,1.9,44425.0,13650,12200,73100,3,-1450,2015,Nissan
64546,2.7,99446.0,16400,17500,77030,5,1100,2015,Chevrolet
322497,1.9,113987.0,3875,2800,82750,9,-1075,2015,Nissan
548585,2.0,246081.0,1600,1300,48460,8,-300,2015,Nissan
170209,3.5,30421.0,8675,8900,73100,2,225,2015,Chevrolet
321433,2.9,94705.0,7575,9900,82750,7,2325,2015,Ford
143298,4.7,14645.0,33200,33600,73100,0,400,2015,Ford
543629,4.1,2371.0,17050,23000,81400,1,5950,2015,Nissan
367995,1.9,164652.0,3125,4000,64520,13,875,2015,Chevrolet
327721,4.8,81586.0,11950,11500,82750,5,-450,2015,Ford
20109,4.8,3379.0,15450,16500,77030,2,1050,2015,Nissan
94787,3.6,21221.0,17050,17400,68360,1,350,2015,Ford
321493,3.8,108934.0,4875,4100,82750,10,-775,2015,Ford
93071,5.0,7407.0,12900,13000,68360,1,100,2015,Chevrolet
81602,4.3,65497.0,22500,23500,68360,4,1000,2015,Ford
487486,2.4,58530.0,7550,7100,73130,3,-450,2015,Nissan
184239,4.2,49096.0,11300,13900,63250,4,2600,2015,Ford
370550,4.1,77016.0,6575,9300,64520,6,2725,2015,Chevrolet
366797,4.3,27345.0,9625,9000,64520,2,-625,2015,Ford
511204,3.7,37559.0,38600,38200,71660,1,-400,2015,Chevrolet
515401,3.0,103581.0,3775,4000,71660,9,225,2015,Ford
88055,2.1,21631.0,8900,5500,68360,3,-3400,2015,Ford
166694,3.6,72955.0,27000,27000,73100,4,0,2015,Ford
196549,3.7,55678.0,19300,20500,67090,4,1200,2015,Ford
53741,5.0,18689.0,23100,24000,77030,2,900,2015,Ford
487861,4.6,20498.0,15400,15300,73130,1,-100,2015,Ford
71746,3.7,81416.0,4800,5600,77030,8,800,2015,Chevrolet
384178,1.9,39581.0,12500,10300,65610,3,-2200,2015,Ford
81419,4.3,49244.0,11600,10500,68360,3,-1100,2015,Ford
98562,4.4,38555.0,11600,12200,68360,1,600,2015,Ford
108023,3.4,122839.0,26800,20200,68360,2,-6600,2015,Ford
113253,2.2,59537.0,8200,8900,68360,3,700,2015,Chevrolet
232287,4.4,54535.0,21600,21000,89090,2,-600,2015,Ford
421830,3.4,124673.0,4050,2800,61450,10,-1250,2015,Chevrolet
327360,3.6,84535.0,15450,14800,82750,3,-650,2015,Ford
184135,2.3,117535.0,5175,6100,63250,10,925,2015,Nissan
184173,3.8,13401.0,26800,26800,63250,1,0,2015,Chevrolet
500063,3.9,36028.0,26600,26700,80610,2,100,2015,Ford
464784,2.8,139085.0,2500,4600,61490,9,2100,2015,Nissan
5098,3.8,76091.0,1900,2800,77030,14,900,2014,Ford
106822,4.0,50564.0,9600,9900,68360,2,300,2015,Chevrolet
188918,3.1,8914.0,17350,15000,63250,1,-2350,2015,Ford
244125,4.3,116599.0,5725,6300,59100,8,575,2015,Ford
373898,4.6,57769.0,23200,25000,64520,2,1800,2015,Ford
300882,4.0,8068.0,22000,21800,59100,0,-200,2015,Chevrolet
435806,2.1,112802.0,6725,6100,74430,9,-625,2015,Ford
183793,2.7,42365.0,12550,13400,63250,2,850,2014,Chevrolet
428552,2.6,84559.0,5350,5000,61450,4,-350,2015,Chevrolet
184780,3.8,53166.0,15450,15700,63250,1,250,2015,Ford
327392,2.5,37605.0,9475,8400,82750,3,-1075,2015,Ford
524,3.8,38444.0,12850,13500,77030,1,650,2014,Nissan
343010,2.2,191426.0,500,300,82750,13,-200,2015,Ford
287421,4.7,37533.0,15150,18500,59100,3,3350,2015,Ford
222302,2.0,65389.0,12550,11000,89090,1,-1550,2014,Nissan
507307,3.5,124827.0,18150,19200,80200,10,1050,2015,Chevrolet
185814,2.7,153468.0,1700,1600,63250,7,-100,2015,Chevrolet
184125,1.5,101287.0,8550,9000,63250,9,450,2015,Ford
121151,3.7,10690.0,12400,13900,73100,1,1500,2014,Ford
142754,3.4,101800.0,26600,25900,73100,6,-700,2015,Ford
405856,1.3,73829.0,11850,4000,61450,2,-7850,2015,Ford
199884,3.5,42640.0,7625,8500,67090,1,875,2015,Ford
143807,4.1,28942.0,12600,11800,73100,3,-800,2015,Nissan
281795,4.2,30253.0,10800,11200,59100,3,400,2015,Ford
522440,2.5,110062.0,13750,15800,71660,6,2050,2015,Ford
379246,2.1,76532.0,5050,3000,64520,4,-2050,2015,Chevrolet
116854,3.9,48495.0,12750,13800,68360,3,1050,2015,Nissan
340409,1.9,130573.0,2975,2500,82750,11,-475,2015,Nissan
142716,3.8,70328.0,26600,28750,73100,5,2150,2015,Chevrolet
260529,1.9,129693.0,5200,4600,59100,8,-600,2015,Nissan
479397,2.7,44104.0,13200,14400,73130,4,1200,2015,Nissan
487433,4.1,22197.0,15450,15400,73130,1,-50,2015,Nissan
526870,4.2,36968.0,15200,13700,70210,4,-1500,2015,Nissan
235938,1.9,122632.0,600,750,59100,16,150,2014,Ford
496356,3.3,30589.0,11300,11000,73130,1,-300,2015,Nissan
158917,3.6,49952.0,11100,11800,73100,2,700,2015,Chevrolet
529042,3.9,26495.0,26400,26500,70210,2,100,2015,Ford
330468,4.6,28368.0,12300,12000,82750,3,-300,2015,Nissan
525990,3.8,32558.0,12000,12000,70210,3,0,2015,Chevrolet
387195,3.8,53330.0,7425,7500,65610,2,75,2015,Chevrolet
497206,4.1,21401.0,24100,25800,73130,4,1700,2015,Ford
77523,1.9,64877.0,13100,10600,68360,5,-2500,2014,Nissan
218428,2.9,148547.0,3200,1100,57290,9,-2100,2015,Ford
32606,4.3,23047.0,9475,9600,77030,1,125,2015,Nissan
138798,4.4,7329.0,12750,14200,73100,2,1450,2015,Nissan
188492,3.8,42567.0,12700,12900,63250,2,200,2015,Chevrolet
165399,3.4,33106.0,16750,15900,73100,1,-850,2015,Ford
297862,1.9,171733.0,5750,5000,59100,7,-750,2015,Chevrolet
100569,3.7,139190.0,7475,7200,68360,10,-275,2015,Chevrolet
137864,3.6,69670.0,8550,7300,73100,3,-1250,2015,Chevrolet
54379,1.0,184822.0,3050,2850,77030,11,-200,2015,Nissan
61992,3.7,35421.0,11650,11500,77030,3,-150,2015,Nissan
435866,2.1,23756.0,26400,22600,74430,2,-3800,2015,Ford
246332,4.9,240.0,18100,19000,59100,2,900,2015,Ford
545989,4.3,68326.0,10600,10600,81400,3,0,2015,Ford
387494,2.8,112366.0,4275,3100,65610,8,-1175,2015,Chevrolet
198134,2.9,169614.0,5250,5500,67090,12,250,2015,Chevrolet
485216,2.7,16706.0,15700,12300,73130,2,-3400,2015,Ford
328730,4.0,118543.0,8025,6000,82750,8,-2025,2015,Ford
346403,4.3,99527.0,14500,12000,82750,8,-2500,2015,Ford
382365,3.4,134244.0,4950,4800,65610,5,-150,2014,Ford
431005,3.6,28144.0,22300,24400,61450,2,2100,2015,Ford
445662,4.9,15975.0,50200,49750,56120,0,-450,2015,Chevrolet
296248,1.9,98404.0,4725,4200,59100,5,-525,2015,Nissan
352537,2.3,77468.0,5125,4500,62960,8,-625,2015,Ford
118003,2.9,209632.0,325,800,68360,12,475,2015,Ford
156120,2.7,50246.0,13450,12700,73100,2,-750,2015,Ford
103263,3.2,99770.0,7500,8200,68360,3,700,2015,Ford
232772,3.5,126799.0,7650,8100,89090,8,450,2015,Ford
174165,4.3,33575.0,11800,10900,83200,0,-900,2014,Chevrolet
548942,4.3,34125.0,24800,25800,48460,3,1000,2015,Nissan
117976,2.7,166972.0,6325,7200,68360,10,875,2015,Chevrolet
279008,1.9,82133.0,2525,2100,59100,7,-425,2015,Chevrolet
527356,3.1,84224.0,6150,1800,70210,8,-4350,2015,Chevrolet
261611,3.8,65028.0,9525,10400,59100,4,875,2015,Nissan
383426,2.7,71586.0,8600,8300,65610,2,-300,2014,Chevrolet
500680,3.0,18936.0,15350,16100,80610,4,750,2015,Chevrolet
240552,4.0,16551.0,24000,23900,59100,1,-100,2015,Chevrolet
105826,1.9,28075.0,12950,12200,68360,3,-750,2015,Nissan
387720,2.5,28901.0,24800,22700,65610,2,-2100,2015,Chevrolet
380993,1.9,65741.0,9400,9800,64520,10,400,2015,Chevrolet
521635,4.9,15680.0,22900,23900,71660,0,1000,2015,Ford
212122,3.8,41819.0,12750,13700,57290,2,950,2015,Chevrolet
100670,4.9,11612.0,17800,17500,68360,1,-300,2015,Chevrolet
527582,4.8,8131.0,16300,17100,70210,1,800,2015,Ford
252750,4.0,18632.0,13300,13600,59100,1,300,2015,Chevrolet
3644,3.5,72222.0,18600,18900,77030,8,300,2014,Ford
361120,3.5,55995.0,10200,9400,64520,2,-800,2014,Nissan
478129,4.9,19115.0,26300,27900,73130,1,1600,2015,Ford
123881,2.0,46515.0,10500,9800,73100,2,-700,2015,Chevrolet
482082,1.9,9870.0,20600,20300,73130,2,-300,2015,Ford
498706,4.5,42338.0,17400,18300,80610,3,900,2014,Nissan
262898,3.2,59884.0,18600,18600,59100,2,0,2015,Nissan
408209,2.8,87237.0,9250,8000,61450,7,-1250,2015,Ford
545424,3.8,37230.0,18050,18000,81400,1,-50,2015,Ford
27058,3.2,112904.0,4050,3950,77030,9,-100,2015,Ford
491260,2.8,115168.0,6975,6200,73130,5,-775,2015,Ford
476522,4.2,36998.0,10700,10700,73130,1,0,2014,Ford
270960,3.0,60596.0,8900,8700,59100,3,-200,2015,Chevrolet
76212,4.3,30142.0,11800,13500,68360,2,1700,2014,Ford
93341,3.7,56993.0,10650,12500,68360,3,1850,2015,Chevrolet
19326,1.9,124075.0,3650,2900,77030,7,-750,2015,Chevrolet
345299,3.8,30980.0,11950,11500,82750,3,-450,2015,Nissan
346662,3.8,16405.0,26300,27300,82750,2,1000,2015,Ford
381442,3.9,96621.0,17500,16000,64520,5,-1500,2015,Ford
480105,3.2,72772.0,7200,7800,73130,8,600,2015,Nissan
50485,1.9,151260.0,2250,2200,77030,13,-50,2015,Chevrolet
298998,3.5,147566.0,1450,1500,59100,12,50,2015,Chevrolet
466666,3.4,61394.0,14450,14000,61490,3,-450,2015,Ford
485485,1.9,30162.0,25300,22500,73130,3,-2800,2015,Ford
275265,3.1,111141.0,2350,2100,59100,9,-250,2015,Ford
219268,3.9,33267.0,16450,15500,57290,1,-950,2015,Ford
439988,3.3,26997.0,23700,22100,74430,2,-1600,2015,Ford
342667,3.7,38482.0,14000,12800,82750,3,-1200,2015,Ford
252994,4.0,17946.0,23900,24100,59100,1,200,2015,Chevrolet
264165,4.0,21350.0,14700,14500,59100,1,-200,2015,Chevrolet
165425,4.7,29831.0,46000,48250,73100,2,2250,2015,Ford
453561,4.9,36687.0,9875,9900,61490,4,25,2015,Chevrolet
406929,4.7,16163.0,12300,11800,61450,1,-500,2015,Ford
282818,4.3,78915.0,34700,36000,59100,3,1300,2015,Ford
93231,2.9,134502.0,2250,2300,68360,14,50,2015,Nissan
296710,3.1,59434.0,9900,10400,59100,3,500,2015,Nissan
415155,1.9,107802.0,7025,5300,61450,7,-1725,2015,Chevrolet
522372,3.8,37573.0,9200,9800,71660,1,600,2015,Chevrolet
386954,4.9,14306.0,15750,16200,65610,2,450,2015,Ford
321616,1.9,114985.0,1375,1500,82750,14,125,2014,Nissan
150303,4.2,22420.0,15500,15400,73100,2,-100,2015,Nissan
159176,4.5,89013.0,9775,11700,73100,2,1925,2015,Ford
503080,2.7,39184.0,15150,12300,80610,3,-2850,2015,Nissan
168641,4.9,16785.0,14400,15000,73100,3,600,2015,Nissan
102683,3.7,43490.0,13750,14100,68360,1,350,2015,Ford
496337,3.9,35074.0,12950,13500,73130,1,550,2015,Ford
330896,4.6,70809.0,8450,10500,82750,7,2050,2015,Chevrolet
56827,2.9,59432.0,14450,13500,77030,1,-950,2015,Ford
23257,1.9,31061.0,9425,4400,77030,2,-5025,2015,Ford
147043,3.6,30989.0,12350,11500,73100,3,-850,2015,Nissan
355043,4.3,23125.0,13700,15200,62960,4,1500,2015,Nissan
426500,3.2,99751.0,13850,7500,61450,11,-6350,2015,Chevrolet
104541,2.7,18951.0,18950,15800,68360,2,-3150,2015,Nissan
475045,3.2,112922.0,5375,5500,73130,4,125,2014,Ford
118892,2.2,137387.0,7425,7500,68360,7,75,2015,Ford
476992,3.5,40579.0,16850,16000,73130,3,-850,2015,Nissan
546633,4.4,10500.0,9950,10600,81400,2,650,2015,Nissan
503484,4.4,9251.0,8600,8900,80610,3,300,2015,Nissan
107950,2.5,56549.0,14800,12100,68360,3,-2700,2015,Chevrolet
539260,2.3,32913.0,9475,8600,55590,2,-875,2015,Ford
78943,3.9,32340.0,11800,11800,68360,4,0,2015,Nissan
78534,3.5,66181.0,24800,24800,68360,2,0,2014,Chevrolet
125323,3.3,33996.0,11550,12500,73100,4,950,2015,Nissan
390299,1.9,137484.0,2800,1650,65610,10,-1150,2015,Chevrolet
381024,3.3,76040.0,13950,15400,64520,11,1450,2015,Chevrolet
416017,2.9,31631.0,12500,11900,61450,3,-600,2015,Ford
520692,3.9,39508.0,9100,9000,71660,1,-100,2015,Ford
465345,2.0,133944.0,2800,2500,61490,7,-300,2015,Chevrolet
440581,4.2,12612.0,11800,11000,74430,2,-800,2015,Ford
44489,2.4,61799.0,22600,20000,77030,2,-2600,2015,Ford
48190,3.4,86905.0,14900,15000,77030,6,100,2015,Ford
94261,4.1,28144.0,13300,14100,68360,3,800,2015,Ford
168130,2.0,55401.0,10050,9400,73100,3,-650,2015,Chevrolet
129203,2.1,58965.0,8925,7500,73100,3,-1425,2015,Chevrolet
295289,3.9,59757.0,13500,12600,59100,4,-900,2015,Ford
344176,4.4,49131.0,9475,9600,82750,2,125,2015,Chevrolet
268837,3.5,103346.0,17050,16600,59100,7,-450,2015,Chevrolet
20806,3.9,47928.0,18400,20500,77030,5,2100,2015,Nissan
549961,1.9,152596.0,2500,2300,48460,11,-200,2015,Nissan
137457,2.8,39917.0,15600,10500,73100,3,-5100,2015,Nissan
531171,3.5,66680.0,2500,3800,82150,12,1300,2015,Chevrolet
503719,3.5,50252.0,11650,11100,80610,2,-550,2015,Chevrolet
438883,4.1,18821.0,10650,10500,74430,3,-150,2015,Ford
217183,2.0,194143.0,625,350,57290,16,-275,2015,Ford
217066,2.9,43391.0,17400,20600,57290,1,3200,2015,Chevrolet
107951,4.2,45644.0,11800,11500,68360,3,-300,2015,Chevrolet
121516,4.2,5652.0,23700,22400,73100,2,-1300,2015,Nissan
547356,2.5,68090.0,3550,400,78090,9,-3150,2015,Ford
220290,4.1,31944.0,25600,21300,57290,4,-4300,2015,Ford
527830,4.5,36044.0,8825,7500,70210,2,-1325,2015,Ford
184346,1.9,106414.0,4300,4300,63250,10,0,2015,Chevrolet
225235,2.0,76363.0,9400,7000,89090,9,-2400,2015,Ford
177050,2.1,102595.0,5575,5800,83200,5,225,2015,Ford
75886,,146155.0,5525,4100,68360,6,-1425,2014,Ford
486342,1.9,190722.0,7575,7100,73130,8,-475,2015,Chevrolet
105862,3.5,40370.0,16550,17400,68360,3,850,2015,Nissan
376855,4.4,29309.0,17150,17200,64520,3,50,2015,Chevrolet
391921,3.4,38509.0,15000,14300,65610,2,-700,2015,Ford
272245,3.0,48803.0,8350,8000,59100,3,-350,2015,Ford
332399,4.1,20570.0,14600,13900,82750,2,-700,2015,Ford
514436,2.4,37307.0,10750,9200,71660,2,-1550,2015,Nissan
105630,4.8,8981.0,18850,19900,68360,1,1050,2015,Ford
206244,3.9,65247.0,8850,9000,57290,3,150,2015,Ford
319127,1.9,48716.0,7975,6400,73200,2,-1575,2015,Chevrolet
100949,3.2,97648.0,6150,6700,68360,8,550,2015,Ford
86608,3.6,40110.0,13100,13000,68360,2,-100,2015,Nissan
453852,4.2,56200.0,9100,9400,61490,3,300,2015,Nissan
175661,3.7,30227.0,21300,23500,83200,3,2200,2015,Ford
158226,4.3,32194.0,16800,16500,73100,3,-300,2015,Nissan
494825,2.0,45572.0,9900,9200,73130,2,-700,2015,Chevrolet
415124,4.1,109486.0,7425,7600,61450,4,175,2015,Nissan
317662,2.6,136393.0,4675,5000,73200,8,325,2015,Nissan
293545,4.2,25238.0,11700,10000,59100,1,-1700,2015,Ford
171778,3.1,66899.0,24700,22800,73100,4,-1900,2015,Ford
104081,3.6,51688.0,15950,16400,68360,3,450,2015,Nissan
300348,3.0,46322.0,9475,9500,59100,2,25,2015,Ford
169880,4.3,10738.0,19750,19800,73100,1,50,2015,Ford
279655,2.7,32909.0,12450,12400,59100,3,-50,2015,Nissan
50779,3.8,57646.0,12100,12600,77030,3,500,2015,Chevrolet
103955,4.1,90021.0,8275,9300,68360,3,1025,2015,Ford
485385,4.8,16893.0,17500,17200,73130,1,-300,2015,Ford
27948,2.9,45705.0,19300,21500,77030,3,2200,2015,Nissan
100090,4.1,142107.0,7975,8700,68360,7,725,2015,Chevrolet
389143,4.5,53743.0,8800,8900,65610,3,100,2015,Ford
365657,4.3,94868.0,6900,7300,64520,3,400,2015,Chevrolet
324572,3.8,5533.0,21900,21800,82750,1,-100,2015,Ford
126364,5.0,19865.0,13400,14000,73100,1,600,2015,Chevrolet
228094,3.8,4716.0,18400,15500,89090,2,-2900,2015,Nissan
176472,4.7,44353.0,24600,25000,83200,4,400,2015,Ford
273290,4.8,3430.0,26100,28400,59100,1,2300,2015,Ford
496822,2.9,46968.0,8550,8600,73130,2,50,2015,Nissan
517540,3.9,90034.0,9675,8900,71660,2,-775,2015,Chevrolet
178583,3.1,139897.0,5575,5700,83200,8,125,2015,Nissan
59622,4.6,20866.0,24400,24500,77030,1,100,2015,Nissan
9653,3.9,36723.0,18100,16200,77030,1,-1900,2015,Ford
104897,4.7,37025.0,29500,30600,68360,4,1100,2015,Ford
487434,3.9,9906.0,16400,14800,73130,1,-1600,2015,Nissan
327078,2.7,42409.0,15400,13100,82750,3,-2300,2015,Nissan
133856,3.0,13663.0,12700,12200,73100,1,-500,2015,Chevrolet
212764,3.8,43772.0,17550,17500,57290,2,-50,2015,Chevrolet
334983,2.7,29438.0,17850,19500,82750,3,1650,2015,Nissan
240216,3.0,23138.0,14800,15600,59100,1,800,2015,Chevrolet
484558,4.0,12925.0,13650,13700,73130,1,50,2015,Chevrolet
501574,4.1,55412.0,12350,12200,80610,2,-150,2015,Nissan
231772,2.7,56208.0,10650,10900,89090,2,250,2015,Chevrolet
376428,4.1,21318.0,15150,14900,64520,2,-250,2015,Ford
96773,4.5,12121.0,22300,21300,68360,1,-1000,2015,Ford
477990,2.5,40220.0,14450,13100,73130,1,-1350,2015,Ford
307398,2.4,65712.0,8600,8300,59100,4,-300,2015,Nissan
122554,2.9,31206.0,12650,13900,73100,2,1250,2014,Nissan
125242,4.6,49978.0,20900,22400,73100,4,1500,2015,Ford
188094,1.9,148224.0,3400,2800,63250,10,-600,2015,Nissan
386357,4.2,88439.0,16300,15900,65610,7,-400,2015,Ford
174275,2.7,123214.0,11700,9100,83200,7,-2600,2015,Ford
4626,2.0,999999.0,1425,700,77030,11,-725,2014,Chevrolet
507007,3.8,32285.0,16400,15500,80200,1,-900,2015,Ford
74213,3.6,45281.0,14750,16500,68360,0,1750,2014,Ford
415559,3.4,176764.0,9425,9500,61450,7,75,2015,Chevrolet
534278,3.8,87389.0,9475,10000,82150,13,525,2015,Ford
496673,4.8,42406.0,18900,19100,73130,1,200,2015,Ford
329543,3.6,158119.0,1825,1800,82750,13,-25,2015,Ford
469942,2.8,157758.0,2325,1900,61490,8,-425,2015,Ford
534491,2.1,85297.0,4525,4100,82150,5,-425,2015,Chevrolet
362232,2.0,98935.0,5850,4900,64520,6,-950,2014,Chevrolet
486784,4.3,19152.0,14800,15000,73130,2,200,2015,Ford
488033,2.8,12954.0,19600,16500,73130,2,-3100,2015,Ford
239972,4.6,26892.0,12950,13000,59100,2,50,2014,Nissan
80277,4.8,7679.0,20700,19800,68360,1,-900,2015,Ford
293035,4.2,40507.0,10200,18200,59100,3,8000,2015,Nissan
430166,4.1,30680.0,11800,11000,61450,3,-800,2015,Nissan
419844,3.3,33420.0,21400,19700,61450,2,-1700,2015,Ford
207777,1.9,119660.0,8125,7100,57290,10,-1025,2015,Ford
511787,4.2,9427.0,13450,13300,71660,3,-150,2015,Nissan
201352,2.1,139238.0,2825,4100,57290,11,1275,2014,Nissan
159841,2.7,63033.0,3975,3300,73100,12,-675,2015,Nissan
365099,4.0,110651.0,24300,24200,64520,7,-100,2015,Ford
299861,2.6,73130.0,12250,12300,59100,2,50,2015,Ford
224699,3.7,116590.0,5900,5500,89090,9,-400,2015,Nissan
437307,3.4,75476.0,9775,8300,74430,4,-1475,2015,Nissan
114906,4.2,51376.0,7525,9000,68360,2,1475,2015,Nissan
220654,4.0,50324.0,7900,8300,57290,2,400,2015,Ford
340323,2.8,12243.0,14550,13400,82750,1,-1150,2015,Ford
528853,3.6,21345.0,25600,24900,70210,1,-700,2015,Ford
502615,2.7,102852.0,10600,11300,80610,8,700,2015,Ford
117265,2.0,193348.0,4175,2700,68360,12,-1475,2015,Ford
185206,1.0,155211.0,4250,1300,63250,10,-2950,2015,Chevrolet
392693,4.9,21792.0,11600,12400,65610,2,800,2015,Ford
386079,4.9,26387.0,15350,14100,65610,2,-1250,2015,Ford
504475,4.6,61410.0,6475,6500,80610,2,25,2015,Chevrolet
89931,4.5,16937.0,24900,24900,68360,1,0,2015,Ford
253005,4.0,23372.0,18850,19400,59100,1,550,2015,Chevrolet
395612,4.3,48002.0,20300,20500,65610,8,200,2015,Ford
285352,4.4,13292.0,17000,15600,59100,1,-1400,2015,Nissan
329541,1.9,152525.0,2350,1400,82750,13,-950,2015,Ford
193093,2.1,24440.0,9275,8500,67090,3,-775,2015,Nissan
390459,4.7,24323.0,26900,28200,65610,2,1300,2015,Ford
501933,3.9,42827.0,33800,33800,80610,1,0,2015,Ford
185410,4.4,4425.0,13050,13200,63250,1,150,2015,Chevrolet
521574,4.9,31028.0,22200,23200,71660,1,1000,2015,Ford
329351,2.4,52467.0,7375,8100,82750,5,725,2015,Ford
206582,4.2,23928.0,20100,20000,57290,1,-100,2015,Ford
108550,4.4,20145.0,11450,13200,68360,1,1750,2015,Ford
31602,4.9,75348.0,35400,36750,77030,3,1350,2015,Ford
219617,4.4,47591.0,21000,22000,57290,2,1000,2015,Ford
340986,3.8,9448.0,11100,11500,82750,3,400,2015,Nissan
53587,5.0,1837.0,24000,25800,77030,1,1800,2015,Ford
317091,2.7,125894.0,3700,5200,73200,10,1500,2015,Nissan
108772,3.8,61980.0,11150,11200,68360,3,50,2015,Chevrolet
155868,3.8,37000.0,17350,16500,73100,3,-850,2015,Nissan
116462,3.9,17192.0,27900,27700,68360,1,-200,2015,Chevrolet
333141,3.7,57245.0,27400,27100,82750,2,-300,2015,Chevrolet
316092,,245987.0,9825,10500,73200,6,675,2014,Ford
6580,1.9,39165.0,11900,9800,77030,3,-2100,2015,Nissan
449696,3.6,58222.0,15100,14800,61490,2,-300,2014,Chevrolet
239934,3.8,24850.0,12850,12600,59100,3,-250,2015,Nissan
278717,3.0,62196.0,8725,8000,59100,3,-725,2015,Chevrolet
492159,3.6,33191.0,19100,18500,73130,1,-600,2015,Ford
306701,4.5,106160.0,20800,23000,59100,5,2200,2015,Ford
170221,5.0,9818.0,13750,15600,73100,2,1850,2015,Chevrolet
399048,4.9,23056.0,20000,20200,61450,0,200,2014,Chevrolet
4134,,155864.0,8150,8200,77030,9,50,2014,Ford
435000,2.2,64539.0,9075,6300,74430,5,-2775,2015,Ford
205769,2.1,38569.0,15850,12200,57290,3,-3650,2015,Ford
413916,4.8,17311.0,17150,17700,61450,1,550,2015,Ford
383301,4.3,23848.0,18600,19300,65610,2,700,2015,Ford
7180,,66407.0,6275,6800,77030,8,525,2014,Nissan
318832,3.7,18252.0,20800,22000,73200,1,1200,2015,Ford
332369,4.2,56104.0,13500,12500,82750,2,-1000,2015,Ford
104824,4.3,25020.0,21000,21100,68360,1,100,2015,Chevrolet
122609,4.1,33141.0,15850,14900,73100,2,-950,2014,Nissan
531954,1.9,199455.0,1625,1300,82150,14,-325,2015,Nissan
299105,2.9,43332.0,12100,12600,59100,1,500,2015,Ford
45647,2.6,35866.0,15950,17000,77030,4,1050,2015,Chevrolet
195733,1.9,74471.0,20300,10300,67090,2,-10000,2015,Chevrolet
342483,4.2,71954.0,10750,10500,82750,4,-250,2015,Chevrolet
262170,4.2,28393.0,27000,27000,59100,1,0,2015,Ford
88828,4.3,34699.0,9975,9700,68360,1,-275,2015,Ford
113407,4.3,50056.0,12250,13200,68360,3,950,2015,Nissan
8139,2.5,131524.0,3775,2800,77030,8,-975,2014,Ford
534544,4.2,81109.0,18850,18300,82150,2,-550,2015,Ford
516118,2.4,32947.0,8875,7700,71660,3,-1175,2015,Nissan
472679,1.0,153086.0,9800,6100,62930,6,-3700,2015,Ford
91744,4.3,37163.0,10300,10300,68360,1,0,2015,Ford
493151,4.6,21467.0,28100,20600,73130,1,-7500,2015,Nissan
128353,2.6,43845.0,19550,17700,73100,3,-1850,2015,Ford
245148,4.4,50745.0,8700,9700,59100,4,1000,2015,Chevrolet
539437,1.9,263055.0,1350,2800,55590,11,1450,2015,Chevrolet
82236,4.4,15171.0,22800,21500,68360,1,-1300,2015,Ford
102811,5.0,16992.0,17400,17400,68360,1,0,2015,Chevrolet
132438,4.0,18963.0,14750,15000,73100,1,250,2015,Chevrolet
297940,2.0,138037.0,2475,3200,59100,10,725,2015,Ford
546950,2.6,159560.0,1825,2200,81400,13,375,2015,Nissan
516933,3.9,91609.0,8475,9400,71660,13,925,2015,Ford
537733,,171662.0,4025,2700,55590,13,-1325,2014,Ford
524024,,115979.0,6775,7200,70210,5,425,2014,Ford
34729,1.0,17242.0,12500,9900,77030,1,-2600,2015,Ford
162019,3.4,52237.0,12100,11300,73100,3,-800,2015,Nissan
400305,4.1,26610.0,26400,28400,61450,2,2000,2015,Ford
432572,4.1,113967.0,9275,9000,74430,5,-275,2014,Chevrolet
483269,3.5,93032.0,9775,9600,73130,2,-175,2015,Ford
76849,4.3,22266.0,21000,22700,68360,1,1700,2014,Chevrolet
310333,3.7,39027.0,19750,17000,59100,3,-2750,2015,Nissan
229862,4.2,70557.0,12800,13000,89090,2,200,2015,Ford
157118,2.0,53593.0,11050,14700,73100,2,3650,2015,Nissan
165162,4.4,31395.0,14550,14700,73100,3,150,2015,Nissan
401407,3.1,106921.0,8900,9000,61450,2,100,2014,Chevrolet
228646,2.0,55626.0,8200,6100,89090,4,-2100,2015,Nissan
521369,3.4,42237.0,11200,11000,71660,3,-200,2015,Nissan
191652,2.5,125174.0,6625,4000,67090,5,-2625,2015,Ford
382577,4.8,11797.0,12950,13100,65610,1,150,2015,Ford
50234,1.0,32142.0,14150,12700,77030,1,-1450,2015,Nissan
56644,4.3,33792.0,19650,18500,77030,1,-1150,2015,Ford
376488,2.6,87383.0,7400,8400,64520,5,1000,2015,Ford
516199,3.3,40396.0,40900,40800,71660,1,-100,2015,Chevrolet
454299,3.1,145220.0,2700,2400,61490,7,-300,2015,Chevrolet
407982,3.2,54910.0,9225,8000,61450,3,-1225,2015,Chevrolet
461452,1.9,135265.0,1475,2500,61490,11,1025,2015,Ford
507002,1.0,163494.0,1525,900,80200,15,-625,2015,Chevrolet
47101,3.5,79015.0,6375,7200,77030,6,825,2015,Chevrolet
109839,1.9,121938.0,3150,1200,68360,8,-1950,2015,Chevrolet
116950,4.1,66345.0,13900,13400,68360,5,-500,2015,Chevrolet
79261,2.2,70465.0,16750,16000,68360,3,-750,2015,Chevrolet
231475,4.6,148403.0,11600,13200,89090,4,1600,2015,Ford
115856,3.7,40750.0,16050,16300,68360,2,250,2015,Chevrolet
523064,5.0,35597.0,24200,24300,71660,3,100,2015,Ford
132650,4.0,99940.0,13600,11000,73100,3,-2600,2015,Nissan
268664,3.4,49649.0,17300,16400,59100,4,-900,2015,Chevrolet
521062,3.2,25758.0,11200,10200,71660,1,-1000,2015,Ford
481495,2.9,149837.0,1325,1300,73130,9,-25,2015,Ford
175988,4.8,54691.0,21000,21350,83200,6,350,2015,Chevrolet
108068,1.9,87529.0,4525,2400,68360,5,-2125,2015,Chevrolet
378000,4.3,18980.0,15800,16000,64520,1,200,2015,Nissan
302013,4.8,17873.0,10650,11400,59100,1,750,2015,Nissan
209422,5.0,13818.0,15200,15000,57290,1,-200,2015,Ford
67010,3.8,38335.0,9075,9800,77030,1,725,2015,Ford
526944,3.9,37024.0,14900,14200,70210,2,-700,2015,Nissan
31278,4.9,37807.0,2625,4800,77030,11,2175,2015,Ford
88280,1.9,249624.0,8325,5400,68360,8,-2925,2015,Ford
114953,2.8,103775.0,15950,15400,68360,4,-550,2015,Ford
508740,4.4,89039.0,11300,11800,71660,2,500,2014,Ford
456613,3.8,71713.0,8625,9600,61490,7,975,2015,Nissan
525191,1.9,177991.0,4025,1600,70210,10,-2425,2015,Ford
316051,4.1,97223.0,8100,8900,73200,5,800,2014,Chevrolet
57531,3.7,19393.0,14350,13700,77030,1,-650,2015,Ford
137348,4.2,47142.0,10850,10900,73100,2,50,2015,Chevrolet
342837,3.6,18968.0,14250,14700,82750,3,450,2015,Nissan
114471,2.6,28964.0,21100,21100,68360,1,0,2015,Nissan
178395,3.9,81058.0,10250,11500,83200,4,1250,2015,Ford
294621,2.9,26543.0,12300,12600,59100,3,300,2015,Nissan
486449,2.7,14232.0,14450,14200,73130,2,-250,2015,Chevrolet
53712,3.4,54438.0,10450,11700,77030,2,1250,2015,Chevrolet
447421,1.0,13266.0,12000,5300,56120,0,-6700,2015,Chevrolet
249398,1.9,120092.0,1425,1900,59100,9,475,2015,Chevrolet
103242,4.7,6587.0,10800,10800,68360,2,0,2015,Ford
56385,2.3,56017.0,18350,17200,77030,2,-1150,2015,Ford
179189,2.0,216560.0,350,1100,83200,8,750,2015,Ford
357190,3.5,57038.0,13000,11500,62960,2,-1500,2015,Ford
321106,3.9,33300.0,12400,13600,82750,2,1200,2014,Nissan
388643,4.1,29232.0,13800,13900,65610,7,100,2015,Ford
397632,3.7,108312.0,5750,7800,61450,3,2050,2014,Chevrolet
45832,3.3,132704.0,1800,2100,77030,15,300,2015,Ford
254441,3.1,166323.0,2000,1500,59100,13,-500,2015,Ford
195348,2.0,122916.0,6650,7400,67090,5,750,2015,Ford
121904,3.8,42919.0,10450,11300,73100,2,850,2014,Ford
445196,4.5,34455.0,20800,19700,56120,2,-1100,2015,Ford
253394,4.4,21892.0,24000,21600,59100,2,-2400,2015,Ford
125677,2.4,188188.0,4000,3900,73100,9,-100,2015,Nissan
58905,2.4,64053.0,17350,17000,77030,5,-350,2015,Ford
396136,1.9,77607.0,2775,1350,65610,9,-1425,2015,Ford
15585,2.0,61506.0,2350,3100,77030,12,750,2015,Chevrolet
104640,2.5,87022.0,13000,12100,68360,4,-900,2015,Chevrolet
213590,5.0,34445.0,27100,29600,57290,3,2500,2015,Ford
42269,2.8,55110.0,8825,8600,77030,2,-225,2015,Chevrolet
36988,4.0,55362.0,5000,7100,77030,8,2100,2015,Ford
492015,4.6,7877.0,17250,18100,73130,2,850,2015,Ford
326152,3.6,24885.0,10750,10100,82750,1,-650,2015,Nissan
345612,4.5,18738.0,9250,9000,82750,2,-250,2015,Nissan
120611,,67140.0,5075,7900,73100,9,2825,2014,Ford
88487,3.7,34492.0,13850,14000,68360,2,150,2015,Nissan
181894,2.4,114905.0,15700,14200,83200,4,-1500,2015,Ford
200695,3.4,57384.0,19500,18800,67090,4,-700,2015,Ford
149846,4.1,25190.0,27900,27600,73100,1,-300,2015,Ford
457684,3.6,39186.0,10000,9800,61490,1,-200,2015,Ford
354401,2.7,44377.0,12700,12000,62960,2,-700,2015,Chevrolet
71110,2.3,164356.0,2950,2600,77030,10,-350,2015,Ford
475637,1.9,110462.0,4050,3700,73130,8,-350,2014,Ford
517310,4.4,41037.0,12800,12600,71660,2,-200,2015,Nissan
354926,2.0,326339.0,550,1400,62960,13,850,2015,Ford
252126,4.5,59699.0,32100,31500,59100,2,-600,2015,Chevrolet
81032,4.5,5797.0,11300,10400,68360,1,-900,2015,Ford
533059,2.5,119716.0,8625,5200,82150,11,-3425,2015,Nissan
220257,5.0,40972.0,27200,28800,57290,2,1600,2015,Chevrolet
401933,4.3,48068.0,10300,11500,61450,2,1200,2015,Ford
34861,3.0,23774.0,14400,11500,77030,1,-2900,2015,Nissan
366716,4.9,93485.0,8600,11000,64520,7,2400,2015,Ford
40208,1.9,115674.0,3600,3100,77030,7,-500,2015,Chevrolet
51031,1.9,123384.0,8200,8200,77030,5,0,2015,Ford
526167,4.4,35020.0,22000,22900,70210,4,900,2015,Ford
278022,2.5,140884.0,2200,2400,59100,12,200,2015,Nissan
33430,4.2,35546.0,12150,12300,77030,3,150,2015,Nissan
25198,4.3,10490.0,13100,12750,77030,1,-350,2015,Nissan
458916,5.0,6795.0,15000,15800,61490,2,800,2015,Chevrolet
110089,4.4,13934.0,19500,17400,68360,1,-2100,2015,Nissan
476938,3.3,48402.0,11500,11800,73130,2,300,2014,Nissan
94933,3.6,22768.0,26700,25000,68360,2,-1700,2015,Ford
298341,1.9,162867.0,5775,5800,59100,10,25,2015,Ford
18778,4.5,20345.0,14450,14750,77030,2,300,2015,Nissan
345019,2.1,38704.0,19000,16100,82750,3,-2900,2015,Ford
492607,3.9,25621.0,19150,18500,73130,2,-650,2015,Ford
351007,4.4,11346.0,17350,19000,62960,1,1650,2015,Ford
168756,4.2,54706.0,11950,12300,73100,3,350,2015,Nissan
205508,4.4,31093.0,26200,28000,57290,3,1800,2015,Ford
510905,4.8,33157.0,19100,19600,71660,1,500,2015,Ford
485778,3.0,22210.0,12300,11500,73130,1,-800,2015,Chevrolet
399622,2.8,136569.0,4925,5000,61450,9,75,2015,Nissan
403385,2.0,130605.0,3450,2800,61450,9,-650,2015,Ford
479725,4.3,28074.0,12350,13900,73130,3,1550,2015,Nissan
45820,3.6,87708.0,14850,14500,77030,11,-350,2015,Chevrolet
394176,2.6,159294.0,7600,6500,65610,7,-1100,2015,Ford
222123,,10168.0,21400,14300,89090,0,-7100,2014,Ford
492836,2.0,36280.0,11750,11200,73130,3,-550,2015,Nissan
146188,4.7,19273.0,11300,10800,73100,1,-500,2015,Chevrolet
89117,3.7,58397.0,37600,39100,68360,3,1500,2015,Ford
531859,2.0,183558.0,625,450,82150,19,-175,2015,Chevrolet
310880,5.0,4341.0,11400,11400,59100,0,0,2015,Nissan
538984,2.3,192664.0,2825,3100,55590,7,275,2015,Chevrolet
282221,3.6,70273.0,10750,10000,59100,4,-750,2015,Ford
488016,2.8,152973.0,5375,4600,73130,10,-775,2015,Ford
422287,2.8,51535.0,12600,11000,61450,2,-1600,2015,Chevrolet
502530,3.8,23283.0,9375,9000,80610,3,-375,2015,Chevrolet
538800,2.3,122214.0,2375,4700,55590,9,2325,2015,Chevrolet
219512,2.3,91881.0,2025,3500,57290,12,1475,2015,Chevrolet
406763,3.6,67659.0,14550,13700,61450,2,-850,2015,Ford
321188,4.6,8916.0,15200,16000,82750,1,800,2014,Nissan
181382,2.8,28567.0,14800,14700,83200,3,-100,2015,Nissan
533398,2.3,96962.0,5200,4400,82150,6,-800,2015,Nissan
204358,3.4,26058.0,22900,22300,57290,1,-600,2015,Ford
80295,3.8,166272.0,6475,7200,68360,11,725,2015,Ford
441103,2.6,156398.0,5400,6600,74430,13,1200,2015,Chevrolet
71255,4.4,22123.0,15650,14250,77030,1,-1400,2015,Nissan
225704,3.3,167416.0,7550,6600,89090,4,-950,2015,Chevrolet
213808,3.8,36333.0,27500,26800,57290,1,-700,2015,Ford
268029,2.7,148266.0,6650,5700,59100,9,-950,2015,Ford
504033,3.1,27371.0,12150,12100,80610,3,-50,2015,Nissan
282322,3.5,81316.0,3575,3800,59100,8,225,2015,Ford
541630,4.7,14949.0,10900,10800,81400,3,-100,2015,Nissan
120740,,90889.0,1925,800,73100,11,-1125,2014,Ford
499675,4.0,21850.0,14750,14300,80610,1,-450,2015,Chevrolet
81385,4.5,54326.0,20200,22500,68360,3,2300,2015,Ford
479038,4.8,19140.0,16400,16400,73130,2,0,2015,Ford
128713,4.4,100633.0,5625,5300,73100,8,-325,2015,Ford
327283,2.9,25191.0,11350,10000,82750,2,-1350,2015,Ford
516321,4.6,37070.0,14000,13700,71660,1,-300,2015,Nissan
72549,4.4,8264.0,18550,18250,77030,1,-300,2015,Chevrolet
505420,4.0,49232.0,10750,12400,80610,3,1650,2015,Nissan
494186,4.4,27693.0,21300,23000,73130,2,1700,2015,Ford
419836,4.0,45798.0,12550,13100,61450,2,550,2015,Chevrolet
545962,4.4,15467.0,9525,9100,81400,2,-425,2015,Nissan
454790,3.3,99828.0,6650,7100,61490,6,450,2015,Ford
139629,1.9,55466.0,10550,6100,73100,6,-4450,2015,Ford
155646,3.4,8392.0,20200,20000,73100,1,-200,2015,Ford
136836,4.2,45913.0,8825,9600,73100,5,775,2015,Chevrolet
82834,3.6,99461.0,17100,15300,68360,3,-1800,2015,Ford
319526,1.9,130063.0,2725,1350,73200,10,-1375,2015,Nissan
67631,2.6,90195.0,5225,2250,77030,5,-2975,2015,Chevrolet
209138,3.5,64398.0,14450,14400,57290,2,-50,2015,Nissan
296755,4.2,20808.0,17500,17000,59100,1,-500,2015,Chevrolet
492145,4.8,7041.0,16750,18300,73130,1,1550,2015,Ford
209305,5.0,16996.0,26400,28100,57290,1,1700,2015,Chevrolet
287602,1.9,158743.0,4025,3400,59100,10,-625,2015,Ford
12692,4.1,72647.0,10050,8750,77030,10,-1300,2014,Ford
24909,3.5,44821.0,12750,12600,77030,3,-150,2015,Ford
427776,4.3,29263.0,20300,19400,61450,1,-900,2015,Ford
121138,3.8,16002.0,29500,28600,73100,1,-900,2014,Ford
92296,3.7,53236.0,9250,9800,68360,3,550,2015,Chevrolet
443747,2.1,139644.0,3525,4100,74430,6,575,2015,Chevrolet
212806,5.0,30151.0,25800,28900,57290,2,3100,2015,Ford
479847,4.5,29320.0,16300,18200,73130,3,1900,2015,Nissan
533564,3.2,129771.0,3575,3100,82150,7,-475,2015,Chevrolet
175035,3.8,67682.0,7125,9100,83200,6,1975,2015,Ford
158237,4.4,34004.0,16650,17400,73100,3,750,2015,Nissan
388497,4.3,52304.0,21800,24000,65610,3,2200,2015,Ford
491993,3.5,11323.0,18250,17300,73130,1,-950,2015,Chevrolet
504704,2.7,44660.0,16100,16600,80610,4,500,2015,Nissan
271949,4.5,26015.0,16250,15100,59100,2,-1150,2015,Ford
297114,2.9,6766.0,20400,19800,59100,1,-600,2015,Ford
384570,3.0,60953.0,10300,10001,65610,3,-299,2015,Chevrolet
393308,3.1,39915.0,10750,9100,65610,7,-1650,2015,Ford
299415,2.1,25565.0,9000,8000,59100,2,-1000,2015,Nissan
35024,3.7,31668.0,11750,11700,77030,2,-50,2015,Chevrolet
16677,3.9,29907.0,25600,26100,77030,4,500,2015,Ford
201133,4.5,36223.0,16500,18000,57290,4,1500,2015,Nissan
484306,4.0,39019.0,11750,13300,73130,3,1550,2015,Nissan
430509,2.9,127306.0,4250,3400,61450,7,-850,2015,Nissan
316625,3.4,71411.0,9425,9100,73200,4,-325,2015,Ford
88057,3.3,41027.0,9500,10800,68360,3,1300,2015,Ford
549640,3.7,55391.0,7500,7600,48460,2,100,2015,Ford
291084,3.9,43230.0,10700,11400,59100,4,700,2015,Nissan
406937,4.8,19560.0,12200,11900,61450,1,-300,2015,Ford
530479,4.2,12489.0,19850,19300,82150,1,-550,2015,Ford
198308,1.9,56102.0,13500,10400,67090,3,-3100,2015,Chevrolet
432507,3.6,117092.0,7425,5700,74430,4,-1725,2014,Ford
219373,4.3,36265.0,24300,23000,57290,2,-1300,2015,Ford
146048,4.6,32750.0,9450,10000,73100,3,550,2015,Chevrolet
4047,3.3,21022.0,12500,11800,77030,0,-700,2014,Ford
85851,2.0,145630.0,1375,400,68360,10,-975,2015,Ford
501980,3.9,95983.0,9200,9700,80610,5,500,2015,Chevrolet
105966,4.4,11674.0,20200,18800,68360,1,-1400,2015,Nissan
356446,4.2,27214.0,41500,42750,62960,0,1250,2015,Chevrolet
272247,3.7,67392.0,8800,10000,59100,3,1200,2015,Ford
38062,4.3,42032.0,11050,11300,77030,2,250,2015,Ford
205599,3.9,15280.0,30000,28000,57290,1,-2000,2015,Ford
469992,3.6,158890.0,6000,7100,61490,11,1100,2015,Chevrolet
18330,3.8,42178.0,13300,13900,77030,3,600,2015,Ford
458312,2.9,204567.0,525,1700,61490,8,1175,2015,Ford
378915,2.8,132662.0,1300,1850,64520,9,550,2015,Chevrolet
448319,1.9,214371.0,5525,7500,56120,10,1975,2015,Chevrolet
207529,4.7,17598.0,15750,15800,57290,1,50,2015,Nissan
99618,4.5,98294.0,4225,6600,68360,8,2375,2015,Ford
387482,4.7,9640.0,15600,14700,65610,1,-900,2015,Chevrolet
276236,4.2,45046.0,16300,17800,59100,3,1500,2015,Nissan
18047,3.6,113216.0,6600,9200,77030,7,2600,2015,Chevrolet
315581,2.0,138360.0,725,350,59100,18,-375,2015,Chevrolet
281873,2.0,57731.0,11800,11200,59100,4,-600,2015,Chevrolet
385289,3.5,100067.0,5025,5100,65610,10,75,2015,Ford
350305,4.4,48830.0,13500,13000,62960,1,-500,2014,Chevrolet
224370,4.2,70507.0,9300,9000,89090,3,-300,2015,Chevrolet
121881,3.4,19968.0,15950,16400,73100,0,450,2014,Chevrolet
510885,4.6,27055.0,19850,19200,71660,1,-650,2015,Ford
35004,3.0,34483.0,24300,24750,77030,2,450,2015,Chevrolet
486583,4.0,32636.0,10900,11400,73130,3,500,2015,Chevrolet
211575,2.5,35362.0,15550,9700,57290,3,-5850,2015,Ford
92633,3.5,39655.0,19800,22700,68360,7,2900,2015,Chevrolet
121047,3.8,38439.0,12750,12300,73100,1,-450,2014,Chevrolet
98923,2.9,40873.0,11450,11100,68360,1,-350,2015,Chevrolet
123451,3.7,36116.0,13900,13000,73100,3,-900,2015,Nissan
469510,4.6,138878.0,3000,5500,61490,9,2500,2015,Ford
203915,4.6,50609.0,14300,15000,57290,3,700,2015,Ford
333387,4.3,71628.0,14350,15400,82750,5,1050,2015,Ford
199125,4.9,61461.0,13650,15000,67090,2,1350,2015,Ford
298867,2.1,120914.0,4625,4600,59100,8,-25,2015,Ford
10504,3.7,60953.0,8350,8900,77030,4,550,2015,Chevrolet
295472,4.2,13927.0,29500,31000,59100,1,1500,2015,Ford
203851,4.3,39215.0,16400,16200,57290,2,-200,2015,Ford
336308,4.2,44660.0,12750,13700,82750,3,950,2015,Ford
413434,4.7,13773.0,14650,16000,61450,2,1350,2015,Nissan
334807,3.7,56353.0,12350,12101,82750,2,-249,2015,Chevrolet
99189,1.9,270638.0,8950,6300,68360,14,-2650,2015,Ford
146982,3.4,18277.0,24500,21000,73100,2,-3500,2015,Nissan
538691,3.5,108219.0,5000,4300,55590,7,-700,2015,Chevrolet
478295,4.2,42463.0,13800,14000,73130,4,200,2015,Nissan
300850,4.0,9221.0,25400,24800,59100,0,-600,2015,Chevrolet
275264,4.6,64642.0,6900,8300,59100,9,1400,2015,Ford
303054,4.4,32093.0,11750,12000,59100,3,250,2015,Nissan
26110,2.8,111783.0,4400,4500,77030,8,100,2015,Chevrolet
500653,3.7,44580.0,12650,12600,80610,2,-50,2015,Nissan
76216,4.7,33871.0,26100,27100,68360,2,1000,2014,Ford
467638,4.1,118235.0,15700,16500,61490,7,800,2015,Ford
20536,2.8,36450.0,14350,13400,77030,3,-950,2015,Nissan
384668,4.1,120673.0,16650,16500,65610,5,-150,2015,Nissan
273009,2.3,176719.0,7175,3300,59100,11,-3875,2015,Ford
37851,1.9,118309.0,2500,2200,77030,12,-300,2015,Ford
256924,4.0,13666.0,15150,15400,59100,1,250,2015,Chevrolet
447100,1.9,157458.0,1175,1300,56120,16,125,2015,Ford
492732,2.8,35996.0,13200,12900,73130,1,-300,2015,Ford
375121,2.8,109321.0,5000,2150,64520,9,-2850,2015,Chevrolet
28963,3.5,98654.0,14700,14900,77030,6,200,2015,Chevrolet
487406,1.9,138001.0,3575,1700,73130,9,-1875,2015,Nissan
257946,3.5,48001.0,19050,19000,59100,4,-50,2015,Nissan
323064,4.3,23877.0,17500,16700,82750,3,-800,2015,Ford
393069,2.0,40348.0,27900,24400,65610,5,-3500,2015,Chevrolet
453403,3.4,55914.0,13250,12800,61490,2,-450,2015,Ford
412482,3.9,18916.0,12250,13800,61450,1,1550,2015,Nissan
281161,1.9,67499.0,9825,8000,59100,4,-1825,2015,Nissan
439377,3.1,90426.0,2850,4100,74430,10,1250,2015,Ford
516975,4.4,32924.0,15950,16300,71660,1,350,2015,Ford
466663,4.5,11400.0,52800,52200,61490,0,-600,2015,Chevrolet
339480,3.1,54608.0,14900,15700,82750,4,800,2015,Nissan
229157,4.9,34312.0,28300,27500,89090,2,-800,2015,Ford
265793,3.9,80557.0,12050,11400,59100,2,-650,2015,Ford
90876,1.9,30783.0,16900,14400,68360,4,-2500,2015,Nissan
157540,1.9,32596.0,12400,12000,73100,7,-400,2015,Ford
378411,4.1,32457.0,34300,33250,64520,2,-1050,2015,Ford
522495,3.8,78623.0,11800,14700,71660,2,2900,2015,Ford
536397,2.7,22234.0,9725,9200,73640,2,-525,2014,Nissan
483457,2.3,47850.0,13000,10800,73130,2,-2200,2015,Nissan
338090,2.3,34264.0,11150,9800,82750,2,-1350,2015,Ford
301980,5.0,5870.0,19700,21200,59100,1,1500,2015,Nissan
340963,4.3,10308.0,16200,16100,82750,3,-100,2015,Nissan
366815,4.8,8180.0,13850,14100,64520,2,250,2015,Ford
126183,3.2,29837.0,11750,10900,73100,3,-850,2015,Ford
330846,2.3,87712.0,7150,5900,82750,6,-1250,2015,Ford
275551,4.8,54664.0,11550,11800,59100,3,250,2015,Ford
471917,3.7,60102.0,13400,14200,62930,4,800,2015,Nissan
343871,3.7,20829.0,29900,30600,82750,2,700,2015,Ford
11285,4.9,42538.0,14050,15300,77030,1,1250,2014,Ford
194129,3.6,48289.0,14050,14600,67090,3,550,2015,Chevrolet
7364,,133363.0,5400,3400,77030,10,-2000,2014,Chevrolet
351042,3.7,17566.0,29600,30000,62960,1,400,2015,Chevrolet
91478,1.9,144832.0,1200,1500,68360,10,300,2015,Chevrolet
422085,1.9,139527.0,4575,3900,61450,6,-675,2015,Chevrolet
378276,3.5,48113.0,13200,14500,64520,1,1300,2015,Ford
454536,4.3,36537.0,11700,12300,61490,3,600,2015,Chevrolet
122984,3.2,30677.0,17200,16900,73100,4,-300,2015,Nissan
269879,3.0,19832.0,12350,11700,59100,1,-650,2015,Chevrolet
94251,4.0,55931.0,11100,12700,68360,3,1600,2015,Ford
196699,5.0,25474.0,23500,23900,67090,4,400,2015,Ford
239989,3.9,33945.0,12500,14600,59100,2,2100,2014,Nissan
421778,3.7,85792.0,10750,12500,61450,7,1750,2015,Ford
137446,3.8,34376.0,12000,11400,73100,3,-600,2015,Nissan
529114,4.8,30735.0,9550,10400,70210,1,850,2015,Ford
228091,3.6,58225.0,11850,11400,89090,2,-450,2015,Nissan
357317,3.7,52283.0,15650,14600,62960,3,-1050,2015,Nissan
368710,3.6,95367.0,9000,9500,64520,8,500,2015,Ford
341260,2.8,35267.0,16450,16100,82750,2,-350,2015,Ford
89524,1.9,168710.0,2575,2700,68360,7,125,2015,Chevrolet
415749,2.8,213513.0,3025,3100,61450,13,75,2015,Ford
212053,3.5,14001.0,21500,21800,57290,1,300,2015,Ford
147299,3.4,66099.0,12700,12900,73100,2,200,2015,Ford
281068,3.4,46195.0,16400,16600,59100,3,200,2015,Nissan
476910,3.1,23358.0,13100,12200,73130,2,-900,2014,Nissan
524317,,97789.0,6375,5500,70210,8,-875,2014,Ford
325287,4.7,2027.0,12850,13600,82750,2,750,2015,Nissan
394243,3.6,19260.0,29500,28000,65610,1,-1500,2015,Chevrolet
416824,3.2,172457.0,4900,5700,61450,10,800,2015,Chevrolet
170640,2.9,50557.0,13550,13300,73100,2,-250,2015,Nissan
482564,4.8,29847.0,23600,24400,73130,3,800,2015,Ford
46467,2.0,146188.0,4475,2000,77030,12,-2475,2015,Ford
422362,4.4,36759.0,11150,11000,61450,2,-150,2015,Nissan
403156,3.8,55816.0,11550,11500,61450,4,-50,2015,Chevrolet
454972,3.7,103874.0,9000,8700,61490,4,-300,2015,Chevrolet
76161,3.4,24245.0,11500,11000,68360,1,-500,2014,Ford
152654,3.6,31070.0,18000,19300,73100,3,1300,2015,Nissan
468587,3.9,37747.0,16750,17700,61490,3,950,2015,Nissan
109590,3.6,28659.0,10150,9600,68360,3,-550,2015,Nissan
400798,1.9,23580.0,12750,10200,61450,3,-2550,2015,Nissan
385895,4.3,85789.0,2450,3900,65610,10,1450,2015,Ford
357820,4.2,61593.0,10600,8600,62960,5,-2000,2015,Ford
352975,2.0,111812.0,8875,6700,62960,11,-2175,2015,Chevrolet
215708,4.4,59504.0,19950,20500,57290,6,550,2015,Ford
488358,4.2,86096.0,11750,12200,73130,2,450,2015,Ford
186681,1.0,39606.0,11550,7000,63250,1,-4550,2015,Chevrolet
413261,3.5,33202.0,26600,24500,61450,1,-2100,2015,Ford
33478,4.2,33529.0,12050,13000,77030,3,950,2015,Nissan
248173,1.9,151628.0,1425,1500,59100,11,75,2015,Nissan
363396,4.2,70703.0,14800,14200,64520,2,-600,2015,Chevrolet
382149,5.0,56858.0,8150,9100,65610,4,950,2015,Ford
411698,4.2,63847.0,20500,22300,61450,5,1800,2015,Chevrolet
75191,2.5,21001.0,10850,10600,68360,0,-250,2014,Nissan
256336,2.0,183623.0,1325,1600,59100,15,275,2015,Ford
254544,1.9,253107.0,1750,1000,59100,16,-750,2015,Chevrolet
70962,4.3,87487.0,9100,10200,77030,5,1100,2015,Ford
500878,3.5,51248.0,26600,26800,80610,2,200,2015,Ford
545992,3.6,48745.0,12650,14400,81400,3,1750,2015,Ford
86278,2.9,94023.0,4225,5600,68360,7,1375,2015,Ford
389159,4.3,50450.0,27500,27000,65610,4,-500,2015,Chevrolet
479168,4.9,15791.0,29700,29500,73130,2,-200,2015,Ford
3379,2.6,30539.0,4775,4300,77030,7,-475,2014,Chevrolet
22292,3.7,110496.0,8125,9300,77030,8,1175,2015,Ford
549703,2.9,155277.0,7500,7200,48460,5,-300,2015,Chevrolet
69339,2.0,232298.0,1375,1000,77030,12,-375,2015,Ford
187690,3.3,240132.0,4325,7200,63250,11,2875,2015,Ford
170165,3.8,53649.0,9575,10400,73100,2,825,2015,Chevrolet
358554,4.3,26371.0,11750,12000,62960,3,250,2015,Nissan
82854,4.3,14519.0,23600,24000,68360,1,400,2015,Chevrolet
328820,3.7,37165.0,19750,16400,82750,2,-3350,2015,Ford
319787,4.2,13283.0,31000,29700,73200,4,-1300,2015,Chevrolet
484889,4.8,29180.0,22600,22900,73130,1,300,2015,Ford
27573,3.7,13754.0,11850,13100,77030,2,1250,2015,Ford
509061,4.5,21531.0,20600,20900,71660,0,300,2014,Chevrolet
324457,2.0,118913.0,5025,6100,82750,8,1075,2015,Nissan
107138,3.7,9586.0,24600,18600,68360,1,-6000,2015,Nissan
321323,4.1,32890.0,11700,11200,82750,3,-500,2014,Nissan
90271,2.8,71153.0,14200,15500,68360,3,1300,2015,Nissan
116457,3.1,124572.0,1200,1500,68360,14,300,2015,Ford
497707,4.3,43059.0,13700,11200,73130,2,-2500,2015,Nissan
241128,4.3,3475.0,17200,16300,59100,1,-900,2014,Ford
389069,4.0,31558.0,10850,10500,65610,2,-350,2015,Ford
155787,2.0,40170.0,9625,6000,73100,3,-3625,2015,Ford
304940,4.4,17892.0,25000,25500,59100,0,500,2015,Ford
291308,3.5,73008.0,14400,15600,59100,8,1200,2015,Chevrolet
212763,3.4,46073.0,19050,18400,57290,2,-650,2015,Chevrolet
338988,3.9,56896.0,13550,13600,82750,2,50,2015,Ford
547279,1.9,135822.0,2800,2400,78090,11,-400,2015,Chevrolet
438829,2.5,98318.0,11400,9900,74430,2,-1500,2015,Ford
125243,3.7,78184.0,11600,11000,73100,4,-600,2015,Ford
72161,2.7,88630.0,7875,7400,77030,4,-475,2015,Nissan
426499,3.5,222815.0,225,1300,61450,11,1075,2015,Chevrolet
261571,3.9,23585.0,33100,31800,59100,1,-1300,2015,Chevrolet
506416,1.9,112119.0,5775,6000,80200,10,225,2015,Nissan
248582,4.6,16943.0,21200,22400,59100,2,1200,2015,Ford
506078,,203183.0,6750,4500,80200,10,-2250,2014,Chevrolet
13951,2.6,116399.0,4075,2700,77030,9,-1375,2015,Chevrolet
262480,2.9,37405.0,11150,11400,59100,2,250,2015,Chevrolet
385140,4.7,39592.0,12850,13200,65610,1,350,2015,Chevrolet
490627,4.6,20378.0,18350,18300,73130,2,-50,2015,Nissan
91791,4.5,19924.0,22900,22100,68360,0,-800,2015,Ford
492047,5.0,19141.0,26900,28900,73130,2,2000,2015,Ford
548566,2.3,48719.0,9850,7100,48460,1,-2750,2015,Ford
414318,4.8,23074.0,23800,24800,61450,1,1000,2015,Ford
35038,3.7,50865.0,12100,12200,77030,2,100,2015,Chevrolet
288872,2.0,199002.0,3025,3300,59100,7,275,2015,Ford
327446,4.2,67450.0,8625,7700,82750,4,-925,2015,Chevrolet
211576,4.2,28601.0,21900,22800,57290,3,900,2015,Ford
91256,2.9,93502.0,14250,14000,68360,8,-250,2015,Chevrolet
103447,2.6,51378.0,13000,13500,68360,4,500,2015,Nissan
354051,3.7,40537.0,14050,14250,62960,2,200,2015,Chevrolet
39368,1.9,25568.0,14350,11500,77030,2,-2850,2015,Nissan
177129,4.7,19925.0,27900,27000,83200,1,-900,2015,Ford
196249,1.9,215688.0,500,1850,67090,10,1350,2015,Chevrolet
90412,4.8,36941.0,20200,19700,68360,2,-500,2015,Nissan
173612,,141503.0,2125,2300,83200,12,175,2014,Ford
98799,4.4,16000.0,17750,17900,68360,1,150,2015,Ford
282553,3.6,39600.0,16250,16200,59100,1,-50,2015,Ford
55168,2.6,136247.0,7700,5700,77030,7,-2000,2015,Ford
548581,3.5,51844.0,10850,10000,48460,2,-850,2015,Chevrolet
527896,1.9,122141.0,4275,4200,70210,15,-75,2015,Chevrolet
475278,1.9,82595.0,5600,4300,73130,6,-1300,2014,Ford
507608,3.5,91519.0,8500,8500,80200,3,0,2015,Chevrolet
447198,1.0,50968.0,17900,10200,56120,2,-7700,2015,Ford
99504,4.2,46156.0,17900,18000,68360,4,100,2015,Ford
44166,4.4,60044.0,8425,7000,77030,3,-1425,2015,Nissan
319069,3.5,45008.0,10900,10300,73200,1,-600,2015,Chevrolet
37785,2.3,157299.0,9275,9100,77030,10,-175,2015,Chevrolet
311375,2.9,10844.0,19750,19500,59100,1,-250,2015,Ford
341307,4.4,23729.0,15600,15300,82750,2,-300,2015,Ford
154223,4.3,51854.0,42400,37900,73100,2,-4500,2015,Ford
116145,3.5,70234.0,16050,16400,68360,4,350,2015,Chevrolet
438454,1.9,88859.0,8575,3000,74430,12,-5575,2015,Chevrolet
69370,2.8,13247.0,15800,16000,77030,1,200,2015,Nissan
36674,1.9,50662.0,10550,9700,77030,3,-850,2015,Ford
4523,2.3,90590.0,2950,2000,77030,10,-950,2014,Chevrolet
253171,3.0,171404.0,3375,3800,59100,10,425,2015,Ford
369498,4.7,35191.0,13200,13800,64520,2,600,2015,Chevrolet
254049,4.2,17544.0,20700,20100,59100,1,-600,2015,Chevrolet
176853,1.9,96324.0,2425,2000,83200,10,-425,2015,Ford
10417,4.3,29580.0,12750,15250,77030,2,2500,2014,Nissan
97336,2.6,178236.0,7925,10200,68360,12,2275,2015,Ford
248330,1.9,106961.0,1050,450,59100,15,-600,2015,Ford
375176,3.1,87502.0,6775,6600,64520,8,-175,2015,Chevrolet
67047,3.7,48873.0,26600,27000,77030,2,400,2015,Chevrolet
223245,3.3,115199.0,3050,2500,89090,11,-550,2015,Ford
97244,2.8,123754.0,6675,4900,68360,8,-1775,2015,Nissan
489202,4.5,23669.0,18800,18200,73130,2,-600,2015,Ford
69330,1.9,96040.0,5025,2400,77030,11,-2625,2015,Ford
347637,3.4,81092.0,6675,7500,82750,5,825,2015,Ford
522793,3.7,64528.0,13600,14400,71660,3,800,2015,Ford
26013,3.9,31327.0,12250,12000,77030,3,-250,2015,Nissan
412301,4.8,31330.0,22200,22400,61450,1,200,2015,Ford
508877,2.6,106216.0,6925,7700,71660,8,775,2014,Chevrolet
409489,3.6,52939.0,16600,17500,61450,2,900,2015,Nissan
235743,2.0,166060.0,1050,600,59100,14,-450,2015,Ford
527788,3.3,40875.0,26300,25100,70210,2,-1200,2015,Ford
176827,2.6,105923.0,4550,5000,83200,8,450,2015,Chevrolet
509662,2.6,163427.0,16000,14400,71660,9,-1600,2015,Ford
249600,4.8,27027.0,16700,18400,59100,1,1700,2015,Ford
419240,4.2,41920.0,15000,13700,61450,2,-1300,2015,Ford
514349,2.3,95959.0,7525,7000,71660,4,-525,2015,Ford
548229,3.9,10142.0,9750,9000,78090,2,-750,2015,Nissan
366566,5.0,87344.0,10150,10900,64520,4,750,2015,Ford
68534,4.5,53739.0,15300,15901,77030,2,601,2015,Nissan
225798,2.0,175302.0,825,325,89090,17,-500,2015,Ford
133845,2.6,58835.0,15150,14300,73100,2,-850,2015,Nissan
13344,1.9,155296.0,1525,1100,77030,15,-425,2015,Ford
301314,4.7,18759.0,12550,13600,59100,3,1050,2015,Nissan
210334,5.0,17414.0,17300,18500,57290,0,1200,2015,Ford
65779,4.6,41884.0,10150,10600,77030,3,450,2015,Ford
24830,4.0,105910.0,15000,17100,77030,7,2100,2015,Chevrolet
491729,2.9,32600.0,17000,16300,73130,1,-700,2015,Ford
547217,4.2,21339.0,12250,11500,78090,3,-750,2015,Ford
237375,3.3,38248.0,11550,11900,59100,1,350,2015,Chevrolet
478802,1.9,141592.0,2675,1600,73130,8,-1075,2015,Chevrolet
318868,4.1,58895.0,11700,12300,73200,2,600,2015,Chevrolet
104723,4.1,36279.0,14000,14000,68360,1,0,2015,Nissan
380745,2.7,50950.0,7200,7400,64520,3,200,2015,Nissan
112502,2.0,76000.0,7925,5500,68360,4,-2425,2015,Chevrolet
213790,4.4,35588.0,18500,18700,57290,1,200,2015,Ford
222269,,35652.0,12750,8900,89090,1,-3850,2014,Chevrolet
110321,5.0,8965.0,21700,20200,68360,1,-1500,2015,Nissan
157687,3.5,33350.0,17200,15900,73100,1,-1300,2015,Ford
295913,4.7,25933.0,23100,23600,59100,1,500,2015,Ford
73729,,79204.0,10050,10300,68360,6,250,2014,Chevrolet
311154,1.9,124045.0,3975,2000,59100,11,-1975,2015,Nissan
175265,4.6,10037.0,20600,20200,83200,1,-400,2015,Ford
393564,1.9,114593.0,12050,8800,65610,8,-3250,2015,Chevrolet
324438,3.8,113090.0,15500,14600,82750,8,-900,2015,Chevrolet
28979,2.0,133701.0,7250,6400,77030,7,-850,2015,Ford
352115,3.4,162886.0,6325,4700,62960,10,-1625,2015,Chevrolet
88339,4.6,25222.0,34600,35900,68360,1,1300,2015,Ford
332800,1.9,27227.0,12450,10100,82750,3,-2350,2015,Nissan
504893,3.1,192902.0,2475,2000,80610,13,-475,2015,Ford
321515,2.8,126134.0,1925,2200,82750,11,275,2014,Ford
125985,4.1,22141.0,12250,13300,73100,3,1050,2015,Ford
421019,3.6,62730.0,9125,10100,61450,3,975,2015,Chevrolet
167139,4.9,13586.0,17700,18750,73100,13,1050,2015,Ford
237838,3.0,116229.0,11850,14700,59100,4,2850,2014,Chevrolet
7538,,141961.0,10850,12700,77030,12,1850,2014,Chevrolet
395046,4.3,38037.0,11250,11600,65610,3,350,2015,Ford
336762,3.0,46107.0,13100,15100,82750,5,2000,2015,Nissan
285191,1.9,97698.0,2075,2900,59100,13,825,2015,Ford
21480,4.0,26929.0,30900,30200,77030,1,-700,2015,Ford
443788,2.9,154824.0,16950,18300,74430,7,1350,2015,Ford
324048,3.9,15948.0,21500,22600,82750,1,1100,2015,Ford
151229,2.7,43417.0,13700,13800,73100,3,100,2015,Chevrolet
42261,2.7,43212.0,12450,12000,77030,2,-450,2015,Chevrolet
508572,2.6,26091.0,13950,13000,71660,2,-950,2015,Nissan
179308,3.2,189279.0,9000,10300,83200,8,1300,2015,Chevrolet
174603,3.6,130065.0,3825,4400,83200,10,575,2015,Ford
377095,3.7,63103.0,11800,11200,64520,2,-600,2015,Ford
507385,2.8,97438.0,19750,18500,80200,3,-1250,2015,Ford
236185,3.0,63535.0,9325,9600,59100,1,275,2014,Chevrolet
177741,2.6,147389.0,3375,2500,83200,9,-875,2015,Nissan
515146,4.5,38729.0,12500,12300,71660,2,-200,2015,Ford
166810,3.7,36406.0,22400,22000,73100,3,-400,2015,Chevrolet
37252,2.1,140816.0,5075,4200,77030,13,-875,2015,Ford
227627,1.9,52152.0,12850,9300,89090,3,-3550,2015,Ford
321362,4.6,11589.0,18650,20200,82750,3,1550,2014,Nissan
497076,2.9,30180.0,9775,9600,73130,3,-175,2015,Ford
9337,2.6,137850.0,5350,5700,77030,8,350,2014,Nissan
479450,2.4,115764.0,3125,3400,73130,8,275,2015,Chevrolet
94748,3.7,27294.0,19650,19500,68360,1,-150,2015,Ford
382578,3.5,22461.0,12350,10600,65610,0,-1750,2014,Ford
204656,4.3,31289.0,18700,18600,57290,2,-100,2015,Nissan
252507,3.9,32215.0,12100,14200,59100,3,2100,2015,Nissan
426407,3.8,176578.0,5350,5900,61450,11,550,2015,Chevrolet
270299,3.5,39444.0,16300,17800,59100,4,1500,2015,Nissan
307124,3.1,99689.0,4800,4600,59100,6,-200,2015,Ford
525414,1.9,97639.0,2400,1000,70210,9,-1400,2015,Ford
108237,3.6,56719.0,12300,12200,68360,2,-100,2015,Ford
9853,2.0,42844.0,12750,9500,77030,1,-3250,2014,Chevrolet
345218,3.7,70742.0,37800,35500,82750,3,-2300,2015,Ford
59988,3.7,116455.0,4250,4500,77030,5,250,2015,Nissan
88472,3.6,26682.0,14050,14800,68360,2,750,2015,Nissan
85215,2.8,32001.0,14850,13500,68360,1,-1350,2015,Chevrolet
54020,2.1,23404.0,10300,8700,77030,3,-1600,2015,Nissan
492133,4.8,6669.0,12850,14900,73130,1,2050,2015,Ford
377070,2.9,47882.0,9900,10000,64520,2,100,2015,Chevrolet
146843,2.0,104573.0,5700,4300,73100,11,-1400,2015,Ford
244530,3.9,19083.0,17600,16200,59100,1,-1400,2015,Ford
537156,3.5,98588.0,10450,10500,73640,10,50,2015,Ford
4036,1.0,9151.0,12950,5500,77030,1,-7450,2015,Ford
161408,3.7,44397.0,11050,11800,73100,5,750,2015,Nissan
498064,1.9,65362.0,11050,10800,73130,2,-250,2015,Ford
297210,3.4,85522.0,8050,9000,59100,5,950,2015,Ford
521465,5.0,2694.0,22200,21000,71660,0,-1200,2015,Chevrolet
538801,1.9,27471.0,5675,7400,55590,9,1725,2015,Chevrolet
457748,4.2,38168.0,17700,17800,61490,3,100,2015,Chevrolet
49077,4.5,14623.0,11650,12600,77030,2,950,2015,Ford
481507,1.9,138524.0,1975,750,73130,12,-1225,2015,Chevrolet
208131,4.7,35454.0,18650,18100,57290,1,-550,2015,Ford
468802,1.9,181907.0,2800,4900,61490,13,2100,2015,Ford
10509,3.5,91343.0,10350,11000,77030,4,650,2015,Chevrolet
152992,3.7,65622.0,14300,15800,73100,8,1500,2015,Ford
454254,3.7,63104.0,10150,10000,61490,3,-150,2015,Nissan
297939,3.5,136175.0,9200,10200,59100,10,1000,2015,Ford
460377,4.4,65696.0,12550,12000,61490,2,-550,2015,Ford
351095,4.3,43115.0,40700,41300,62960,1,600,2015,Chevrolet
88119,3.4,41193.0,11600,11400,68360,3,-200,2015,Nissan
19737,4.8,3050.0,17350,17500,77030,1,150,2015,Nissan
345656,3.4,56813.0,10800,10500,82750,2,-300,2015,Nissan
176289,2.7,81754.0,7200,7100,83200,4,-100,2015,Chevrolet
519399,1.0,192658.0,800,700,71660,20,-100,2015,Chevrolet
535709,2.5,52340.0,21900,19200,82150,2,-2700,2015,Ford
361018,4.9,16900.0,15950,14900,64520,1,-1050,2014,Ford
427649,4.3,32890.0,11700,12900,61450,3,1200,2015,Nissan
212019,4.9,12493.0,35200,37900,57290,1,2700,2015,Ford
346805,2.7,58188.0,13150,13200,82750,3,50,2015,Ford
44507,3.4,56908.0,13200,13200,77030,2,0,2015,Ford
379008,4.2,29524.0,9600,9900,64520,1,300,2015,Nissan
345370,3.6,25188.0,13800,13300,82750,3,-500,2015,Nissan
230694,3.6,34155.0,11500,11200,89090,3,-300,2015,Ford
338928,2.9,16844.0,19350,18600,82750,2,-750,2015,Ford
359988,4.4,59624.0,15300,15800,62960,2,500,2015,Chevrolet
538739,3.8,61007.0,22500,22101,55590,2,-399,2015,Nissan
111239,4.9,15638.0,30000,29000,68360,0,-1000,2015,Ford
23467,1.9,164030.0,3350,2700,77030,12,-650,2015,Chevrolet
190241,2.7,66824.0,8250,8700,63250,2,450,2015,Chevrolet
315296,2.7,124133.0,5100,4500,59100,11,-600,2015,Ford
532904,3.4,61531.0,12550,12500,82150,2,-50,2015,Chevrolet
215843,3.8,96229.0,9575,10600,57290,5,1025,2015,Chevrolet
303082,3.7,34066.0,11600,13800,59100,3,2200,2015,Nissan
372554,1.9,181805.0,675,500,64520,15,-175,2015,Ford
54213,3.6,70205.0,14700,18600,77030,8,3900,2015,Chevrolet
302547,3.8,61278.0,24000,26100,59100,4,2100,2015,Chevrolet
354087,4.2,12262.0,21900,20250,62960,1,-1650,2015,Chevrolet
223067,4.2,44071.0,27300,28600,89090,4,1300,2015,Ford
110917,3.5,80644.0,10150,10200,68360,4,50,2015,Chevrolet
23253,4.4,18996.0,27500,25700,77030,2,-1800,2015,Ford
137655,4.5,7184.0,23100,23400,73100,1,300,2015,Ford
316251,,178634.0,4725,4700,73200,10,-25,2014,Ford
154063,3.5,22014.0,17050,17500,73100,1,450,2015,Ford
345834,3.4,52724.0,15550,15000,82750,2,-550,2015,Chevrolet
20284,5.0,8624.0,29800,30750,77030,1,950,2015,Chevrolet
146286,1.9,67212.0,14550,13500,73100,5,-1050,2015,Ford
135843,3.4,58129.0,20400,24800,73100,6,4400,2015,Ford
474040,2.7,139282.0,5325,4800,62930,10,-525,2015,Chevrolet
96123,4.7,47978.0,37900,38000,68360,1,100,2015,Chevrolet
439312,4.4,71878.0,17600,16600,74430,4,-1000,2015,Chevrolet
267692,3.6,78447.0,7550,7900,59100,4,350,2015,Chevrolet
290543,3.7,27431.0,13850,12800,59100,4,-1050,2015,Nissan
352599,4.4,3061.0,12100,12200,62960,0,100,2015,Nissan
215585,2.5,128672.0,12300,15600,57290,7,3300,2015,Chevrolet
549563,2.5,138768.0,5050,6800,48460,12,1750,2015,Ford
359321,3.6,23072.0,13700,13400,62960,1,-300,2015,Ford
295654,4.9,23160.0,25300,25600,59100,1,300,2015,Ford
392594,2.0,113817.0,3925,3100,65610,9,-825,2015,Chevrolet
328153,4.5,16649.0,12000,14600,82750,2,2600,2015,Nissan
475781,,163347.0,3675,3800,73130,9,125,2014,Ford
530737,2.5,170198.0,1475,900,82150,15,-575,2015,Nissan
242751,4.6,8259.0,21600,22200,59100,4,600,2015,Nissan
161637,1.9,161458.0,4900,2450,73100,14,-2450,2015,Nissan
304408,2.0,180013.0,1225,300,59100,12,-925,2015,Ford
71154,1.9,126102.0,1875,1500,77030,13,-375,2015,Nissan
150287,3.0,54972.0,8925,8300,73100,2,-625,2015,Nissan
526569,2.5,11575.0,14600,11400,70210,3,-3200,2015,Ford
527225,2.9,18678.0,12200,11400,70210,1,-800,2015,Ford
110301,2.9,117948.0,9150,7800,68360,10,-1350,2015,Ford
289505,4.6,20927.0,21600,21100,59100,1,-500,2015,Ford
449695,2.8,69871.0,13400,12800,61490,2,-600,2014,Chevrolet
150473,4.0,31566.0,17050,17800,73100,4,750,2015,Nissan
236163,3.0,57977.0,9750,9700,59100,1,-50,2014,Chevrolet
471370,4.2,59967.0,10900,11200,62930,3,300,2015,Ford
510719,4.7,10880.0,20700,20600,71660,1,-100,2015,Ford
416411,2.7,7869.0,18050,17700,61450,1,-350,2015,Ford
291890,4.1,63869.0,30400,33000,59100,2,2600,2015,Chevrolet
157274,1.9,53529.0,9350,7700,73100,2,-1650,2015,Chevrolet
543166,4.9,33965.0,14800,15700,81400,2,900,2015,Chevrolet
8276,1.9,130545.0,4700,5500,77030,11,800,2014,Ford
72097,2.0,50338.0,14550,12100,77030,2,-2450,2015,Nissan
28353,4.4,34057.0,15050,14750,77030,1,-300,2015,Ford
332872,2.6,13369.0,19200,17800,82750,3,-1400,2015,Nissan
531298,2.7,49770.0,7900,6300,82150,4,-1600,2015,Nissan
488782,3.7,37138.0,12800,12300,73130,3,-500,2015,Ford
396921,2.7,55788.0,14850,13500,65610,3,-1350,2015,Ford
113103,3.5,52257.0,10800,10800,68360,2,0,2015,Chevrolet
372640,4.5,44075.0,15250,15400,64520,2,150,2015,Ford
426337,3.4,111546.0,24100,27000,61450,6,2900,2015,Ford
241588,1.9,91853.0,8250,6200,59100,3,-2050,2014,Nissan
71175,2.4,65727.0,12350,9250,77030,1,-3100,2015,Ford
502179,4.4,37040.0,17500,17400,80610,3,-100,2015,Ford
248572,4.3,16028.0,15100,14200,59100,2,-900,2015,Ford
523015,3.7,37311.0,11550,11500,71660,3,-50,2015,Nissan
11096,2.6,195404.0,1575,1400,77030,13,-175,2015,Nissan
492909,3.9,39114.0,14250,14400,73130,3,150,2015,Nissan
107041,3.6,24531.0,9175,10300,68360,2,1125,2015,Ford
452463,3.0,141383.0,3325,3900,61490,10,575,2015,Nissan
258576,4.3,31219.0,12150,11400,59100,3,-750,2015,Nissan
414476,2.0,7513.0,15950,12000,61450,0,-3950,2015,Nissan
425228,4.9,21061.0,21500,21800,61450,1,300,2015,Ford
113935,2.7,9262.0,11150,9000,68360,3,-2150,2015,Nissan
319533,3.2,43112.0,11100,11200,73200,1,100,2015,Chevrolet
68279,3.8,52324.0,7100,9300,77030,4,2200,2015,Nissan
487442,2.5,10128.0,11200,26700,73130,1,15500,2015,Nissan
316598,3.1,94024.0,20900,21400,73200,3,500,2015,Chevrolet
383631,4.9,122124.0,5075,6600,65610,6,1525,2015,Chevrolet
193040,3.9,54284.0,8325,9100,67090,3,775,2015,Chevrolet
137931,1.9,66855.0,10200,9200,73100,3,-1000,2015,Ford
205038,4.6,15642.0,21200,21600,57290,1,400,2015,Ford
414464,2.6,28962.0,16850,15600,61450,1,-1250,2015,Ford
356930,3.0,117091.0,1325,2000,62960,11,675,2015,Ford
470373,2.5,180557.0,1000,1250,61490,14,250,2015,Nissan
9368,3.8,113646.0,6050,6700,77030,9,650,2014,Chevrolet
323090,4.1,9181.0,13000,14200,82750,3,1200,2015,Ford
84404,1.5,113671.0,8475,4500,68360,6,-3975,2015,Chevrolet
385374,4.4,84160.0,12000,12300,65610,2,300,2015,Ford
445481,1.9,186106.0,4675,7000,56120,10,2325,2015,Ford
529264,4.1,3233.0,12600,11800,70210,1,-800,2015,Ford
233453,2.2,81549.0,8450,10000,59100,4,1550,2014,Ford
295592,2.7,88676.0,7550,6400,59100,4,-1150,2015,Chevrolet
444545,,113290.0,9100,7200,56120,9,-1900,2014,Ford
534284,2.2,149306.0,2400,4300,82150,14,1900,2015,Ford
227093,3.4,99748.0,15450,14700,89090,7,-750,2015,Chevrolet
525848,3.8,13800.0,21400,19800,70210,1,-1600,2015,Ford
79129,1.9,305033.0,900,1650,68360,14,750,2015,Ford
191919,4.3,105249.0,7475,6900,67090,2,-575,2014,Ford
32377,1.9,186283.0,2475,1950,77030,11,-525,2015,Nissan
294297,4.8,27264.0,21100,21000,59100,2,-100,2015,Nissan
405817,4.5,16871.0,17750,16300,61450,1,-1450,2015,Ford
471440,2.2,121058.0,6100,6300,62930,7,200,2015,Chevrolet
323634,1.0,21346.0,14600,9000,82750,1,-5600,2015,Nissan
96603,1.9,99601.0,8600,7100,68360,2,-1500,2015,Chevrolet
340667,3.5,17537.0,27900,26700,82750,3,-1200,2015,Ford
442537,1.9,101990.0,4450,2400,74430,6,-2050,2015,Chevrolet
202651,3.8,40260.0,6025,9100,57290,3,3075,2014,Chevrolet
382185,4.9,36683.0,16250,17900,65610,3,1650,2014,Nissan
97739,2.7,132341.0,7375,8500,68360,10,1125,2015,Chevrolet
65084,3.7,33553.0,7300,7000,77030,3,-300,2015,Nissan
364079,4.0,39014.0,13150,10500,64520,4,-2650,2015,Nissan
515611,3.9,59598.0,22500,23800,71660,5,1300,2015,Chevrolet
502215,3.7,47438.0,12450,12600,80610,2,150,2015,Nissan
425769,4.6,22597.0,16050,16900,61450,2,850,2015,Ford
472831,3.6,194933.0,3300,5000,62930,10,1700,2015,Chevrolet
27263,2.7,135472.0,2175,2300,77030,12,125,2015,Ford
436225,3.1,198217.0,700,300,74430,15,-400,2015,Ford
34350,2.0,143129.0,4525,3500,77030,10,-1025,2015,Ford
210299,4.3,34025.0,18750,18800,57290,1,50,2015,Ford
372610,4.5,24539.0,25400,26100,64520,2,700,2015,Ford
419968,4.8,20868.0,14250,14900,61450,3,650,2015,Ford
405027,2.7,105468.0,14700,14100,61450,7,-600,2015,Chevrolet
448712,1.9,93966.0,12400,11000,61490,5,-1400,2015,Ford
299818,3.3,54404.0,11650,12800,59100,2,1150,2015,Chevrolet
393366,4.3,41458.0,17800,18600,65610,1,800,2015,Ford
315243,2.6,151795.0,3125,2600,59100,8,-525,2015,Chevrolet
520526,2.8,36677.0,12750,11700,71660,3,-1050,2015,Ford
219034,3.1,36743.0,22900,21600,57290,3,-1300,2015,Nissan
388541,3.5,80227.0,18600,18400,65610,7,-200,2015,Ford
33180,4.4,49660.0,14550,17000,77030,3,2450,2015,Ford
135680,3.4,57936.0,14350,13300,73100,3,-1050,2015,Ford
301860,1.9,123964.0,1225,700,59100,14,-525,2015,Nissan
523818,3.8,36667.0,11050,12000,71660,3,950,2015,Ford
52190,2.4,103926.0,12000,14000,77030,8,2000,2015,Chevrolet
108710,4.8,10723.0,11450,13000,68360,0,1550,2015,Ford
405280,2.1,178305.0,5900,5200,61450,10,-700,2015,Nissan
59430,3.4,41679.0,12800,13000,77030,3,200,2015,Nissan
187353,1.0,137997.0,6175,4000,63250,11,-2175,2015,Chevrolet
326533,2.9,122344.0,8375,6900,82750,11,-1475,2015,Ford
483343,3.6,34981.0,11950,13000,73130,3,1050,2015,Nissan
295305,4.3,25371.0,25200,27900,59100,1,2700,2015,Ford
316304,1.9,149333.0,1425,500,73200,12,-925,2014,Chevrolet
464265,3.5,83963.0,11000,11700,61490,5,700,2015,Chevrolet
175029,3.7,139692.0,9575,9800,83200,5,225,2015,Ford
401044,2.8,163448.0,9525,8200,61450,10,-1325,2014,Chevrolet
33222,4.3,49872.0,23600,25300,77030,3,1700,2015,Ford
379167,2.6,51383.0,11700,11100,64520,2,-600,2015,Chevrolet
120233,2.7,92881.0,13850,12600,73100,6,-1250,2014,Nissan
156555,3.4,178290.0,3225,2000,73100,8,-1225,2015,Ford
516717,4.1,55507.0,8100,8501,71660,3,401,2015,Ford
327642,2.2,154217.0,8450,7600,82750,3,-850,2015,Chevrolet
199144,2.4,46930.0,16250,16300,67090,2,50,2015,Nissan
538142,3.9,56316.0,8075,8800,55590,2,725,2015,Ford
518214,3.9,31043.0,14650,14600,71660,1,-50,2015,Ford
513163,3.8,46330.0,10850,10500,71660,2,-350,2015,Ford
543065,2.7,135905.0,6975,6000,81400,10,-975,2015,Chevrolet
124743,3.5,23478.0,9375,9300,73100,1,-75,2015,Nissan
389166,4.0,16710.0,13550,13500,65610,1,-50,2015,Chevrolet
113790,1.9,189826.0,1125,2400,68360,7,1275,2015,Chevrolet
518558,4.5,29622.0,15950,16500,71660,2,550,2015,Ford
418486,3.7,26926.0,25700,25000,61450,1,-700,2015,Ford
95187,3.7,43167.0,12950,13200,68360,2,250,2015,Nissan
296931,2.1,56038.0,10500,10300,59100,3,-200,2015,Nissan
217412,3.9,40556.0,19750,19900,57290,1,150,2015,Ford
513223,4.3,54695.0,17600,21200,71660,3,3600,2015,Nissan
155051,4.6,67331.0,13200,13000,73100,2,-200,2015,Ford
282215,2.1,75304.0,4625,3600,59100,4,-1025,2015,Chevrolet
291309,2.0,29562.0,20400,18000,59100,1,-2400,2015,Chevrolet
117469,3.9,87990.0,9025,8800,68360,2,-225,2015,Ford
218565,4.7,28586.0,19350,19800,57290,1,450,2015,Ford
470767,4.1,70759.0,14050,14700,62930,2,650,2014,Chevrolet
390317,2.9,129700.0,5750,3500,65610,11,-2250,2015,Chevrolet
398743,2.0,158357.0,1375,1400,61450,14,25,2014,Nissan
512323,1.9,100227.0,4150,4000,71660,4,-150,2015,Nissan
141597,4.3,35273.0,22900,23300,73100,4,400,2015,Chevrolet
161603,5.0,6678.0,11150,12900,73100,1,1750,2015,Chevrolet
262893,3.6,25052.0,19900,18200,59100,2,-1700,2015,Nissan
492202,4.8,13217.0,23300,24000,73130,2,700,2015,Ford
152706,3.7,12705.0,16000,16200,73100,3,200,2015,Nissan
534837,2.5,109007.0,4450,3900,82150,8,-550,2015,Ford
73574,2.3,188175.0,9250,8300,68360,6,-950,2015,Chevrolet
124138,3.0,85824.0,8550,9600,73100,7,1050,2015,Nissan
51735,1.0,34560.0,14050,11000,77030,1,-3050,2015,Nissan
73456,,108106.0,17300,15200,68360,4,-2100,2014,Chevrolet
397814,4.0,151240.0,4600,4900,61450,5,300,2015,Ford
238364,2.0,123180.0,6600,4100,59100,8,-2500,2014,Ford
442758,3.9,48133.0,8050,7700,74430,2,-350,2015,Chevrolet
306480,3.8,20542.0,16700,18700,59100,1,2000,2015,Ford
110457,2.6,173203.0,10150,5500,68360,4,-4650,2015,Ford
193807,3.8,68999.0,17150,16600,67090,4,-550,2015,Chevrolet
186080,1.9,139105.0,575,400,63250,16,-175,2015,Chevrolet
457128,3.5,52508.0,22400,20500,61490,2,-1900,2015,Ford
383751,3.7,92768.0,15850,16600,65610,8,750,2015,Ford
216835,1.9,61583.0,6850,5700,57290,4,-1150,2015,Nissan
187310,3.6,54577.0,22600,21300,63250,4,-1300,2015,Ford
191871,4.6,24493.0,11600,12500,67090,1,900,2014,Chevrolet
305010,4.3,52179.0,12550,12700,59100,2,150,2015,Nissan
129488,4.1,46412.0,15400,15600,73100,3,200,2015,Nissan
155621,2.8,24839.0,18850,12600,73100,3,-6250,2015,Nissan
143944,3.6,77996.0,6175,5900,73100,7,-275,2015,Chevrolet
476851,,42816.0,10750,10500,73130,2,-250,2014,Nissan
322542,1.9,143598.0,2875,400,82750,10,-2475,2015,Nissan
406082,3.9,73292.0,17400,19400,61450,9,2000,2015,Ford
491759,3.5,34395.0,13250,13100,73130,1,-150,2015,Nissan
455169,2.7,128792.0,10000,9500,61490,4,-500,2015,Ford
319487,3.8,71732.0,9075,9500,73200,3,425,2015,Chevrolet
480184,4.9,22707.0,33800,33400,73130,0,-400,2015,Ford
76691,1.9,2.0,2550,850,68360,13,-1700,2015,Chevrolet
382037,4.3,105595.0,11300,12500,64520,4,1200,2015,Ford
121754,,35660.0,26800,25400,73100,2,-1400,2014,Chevrolet
326929,3.9,82158.0,12550,10700,82750,3,-1850,2015,Chevrolet
421333,4.9,19259.0,22300,21800,61450,0,-500,2015,Ford
492829,1.9,32123.0,12000,9600,73130,3,-2400,2015,Nissan
146653,3.5,26351.0,18900,17800,73100,3,-1100,2015,Ford
240232,3.0,14448.0,15000,14800,59100,1,-200,2015,Chevrolet
364839,4.0,77292.0,7850,8700,64520,7,850,2015,Ford
165864,3.5,83186.0,6950,5400,73100,6,-1550,2015,Nissan
446506,3.9,71250.0,9325,9500,56120,3,175,2015,Ford
460370,4.1,80286.0,17150,16300,61490,2,-850,2015,Ford
512092,3.8,80081.0,9875,9400,71660,2,-475,2015,Ford
233149,2.4,52857.0,8625,7100,59100,4,-1525,2015,Chevrolet
482732,4.5,42013.0,16050,16300,73130,4,250,2015,Nissan
173831,4.7,28383.0,27300,30800,83200,1,3500,2014,Ford
42091,4.1,64367.0,13900,13400,77030,1,-500,2015,Ford
102621,2.5,64730.0,8950,7901,68360,3,-1049,2015,Ford
125086,3.4,32496.0,12450,11600,73100,3,-850,2015,Nissan
414019,3.9,24137.0,21000,21600,61450,2,600,2015,Chevrolet
220286,3.5,119544.0,22800,22300,57290,4,-500,2015,Chevrolet
171147,4.2,29983.0,17150,16600,73100,3,-550,2015,Nissan
296032,2.4,44829.0,19650,19400,59100,2,-250,2015,Nissan
509464,5.0,29.0,29000,30300,71660,1,1300,2015,Ford
435970,4.6,28874.0,20900,24250,74430,2,3350,2015,Chevrolet
500407,2.8,103246.0,10800,10200,80610,10,-600,2015,Chevrolet
57161,5.0,9.0,18800,20750,77030,1,1950,2015,Nissan
489487,4.2,132000.0,19700,16100,73130,2,-3600,2015,Ford
536801,2.0,128511.0,1550,1150,73640,14,-400,2015,Ford
187753,1.9,113106.0,3275,1900,63250,11,-1375,2015,Chevrolet
112577,3.8,128995.0,12850,12800,68360,6,-50,2015,Chevrolet
78179,1.9,71350.0,9050,7800,68360,4,-1250,2015,Nissan
94504,4.8,38160.0,39400,39000,68360,1,-400,2015,Chevrolet
137583,2.9,47617.0,15600,14400,73100,4,-1200,2015,Nissan
496875,1.9,54657.0,15550,13400,73130,3,-2150,2015,Nissan
166765,4.2,6986.0,11850,12500,73100,1,650,2015,Chevrolet
313426,2.1,60119.0,10250,9100,59100,2,-1150,2015,Chevrolet
494219,4.3,19929.0,11000,11800,73130,2,800,2015,Ford
177043,2.9,78276.0,6850,7100,83200,5,250,2015,Chevrolet
341958,2.8,187156.0,1700,1200,82750,9,-500,2015,Nissan
279252,4.3,21494.0,43500,43700,59100,0,200,2015,Chevrolet
501437,3.6,55659.0,19450,20400,80610,5,950,2015,Chevrolet
490485,3.7,90605.0,15750,15100,73130,7,-650,2015,Chevrolet
28675,1.9,150797.0,6700,3300,77030,10,-3400,2015,Chevrolet
284693,4.8,27277.0,10300,10000,59100,3,-300,2015,Nissan
521651,2.8,56246.0,9250,10000,71660,3,750,2015,Chevrolet
88471,4.1,66883.0,11800,11700,68360,2,-100,2015,Nissan
304140,4.9,3725.0,18850,19600,59100,1,750,2015,Nissan
520464,1.9,79829.0,8025,7500,71660,5,-525,2015,Chevrolet
495485,4.2,37968.0,21400,23900,73130,2,2500,2015,Ford
301694,2.5,155798.0,3800,1600,59100,7,-2200,2015,Ford
457012,3.9,62798.0,8650,8500,61490,3,-150,2015,Nissan
337308,4.0,50659.0,11800,11900,82750,3,100,2015,Ford
9404,1.9,141582.0,6225,3400,77030,9,-2825,2014,Nissan
526792,4.1,55055.0,27100,27400,70210,4,300,2015,Ford
229989,2.9,202073.0,625,500,89090,16,-125,2015,Ford
172383,4.1,44257.0,31200,31000,73100,2,-200,2015,Ford
427525,3.6,18477.0,16900,18600,61450,1,1700,2015,Ford
549086,4.0,29958.0,13700,13900,48460,2,200,2015,Nissan
156975,3.6,55849.0,8950,9500,73100,2,550,2015,Chevrolet
36474,4.4,5131.0,18550,18700,77030,1,150,2015,Ford
474963,3.1,36062.0,13900,14800,73130,4,900,2015,Nissan
482093,3.4,57868.0,12200,12500,73130,2,300,2015,Nissan
393091,3.3,51200.0,11050,10900,65610,2,-150,2015,Chevrolet
93256,4.3,31321.0,19150,20000,68360,1,850,2015,Ford
395706,2.8,55548.0,19450,18600,65610,6,-850,2015,Chevrolet
336787,2.0,79322.0,6325,4500,82750,7,-1825,2015,Ford
516141,3.5,45816.0,20400,18000,71660,4,-2400,2015,Ford
185869,1.9,131975.0,3775,2600,63250,10,-1175,2015,Chevrolet
414310,4.1,19590.0,29500,27700,61450,1,-1800,2015,Ford
509544,4.7,11611.0,19250,18900,71660,2,-350,2015,Ford
179877,3.2,28787.0,18950,18600,83200,1,-350,2015,Nissan
534666,2.9,48544.0,11850,11300,82150,2,-550,2015,Chevrolet
168806,4.8,38589.0,14050,15600,73100,3,1550,2015,Nissan
27352,3.3,245213.0,7200,4500,77030,14,-2700,2015,Chevrolet
248580,4.5,26415.0,18000,18300,59100,2,300,2015,Ford
158979,3.3,17539.0,11500,9900,73100,2,-1600,2015,Nissan
408304,1.9,91799.0,3475,3300,61450,10,-175,2015,Chevrolet
531011,3.3,61379.0,12150,11500,82150,2,-650,2015,Nissan
527416,2.4,134756.0,3550,3000,70210,10,-550,2015,Ford
211445,4.6,32884.0,31200,32300,57290,1,1100,2015,Ford
127680,4.7,8134.0,15850,16100,73100,6,250,2015,Chevrolet
545599,2.0,21042.0,9300,7500,81400,2,-1800,2015,Nissan
489259,3.7,40144.0,15000,15300,73130,3,300,2015,Ford
508150,4.8,9902.0,21600,21900,71660,0,300,2014,Ford
328152,2.5,7021.0,15050,12400,82750,2,-2650,2015,Nissan
222765,2.0,98228.0,3075,1200,89090,10,-1875,2014,Ford
102033,3.4,32618.0,43800,44600,68360,3,800,2015,Ford
284317,4.5,11710.0,12700,14400,59100,2,1700,2015,Nissan
169953,4.9,33371.0,10950,12300,73100,1,1350,2015,Ford
218080,4.4,32025.0,17700,18000,57290,1,300,2015,Nissan
537199,4.0,47257.0,9925,10200,73640,3,275,2015,Ford
164369,4.2,26117.0,10600,10600,73100,2,0,2015,Ford
188358,1.9,153772.0,2875,2700,63250,5,-175,2015,Chevrolet
536399,2.0,59792.0,9000,6000,73640,3,-3000,2014,Chevrolet
538991,1.9,197965.0,1750,2500,55590,15,750,2015,Ford
118550,3.9,45913.0,8575,9800,68360,8,1225,2015,Chevrolet
506346,2.8,86695.0,8650,8900,80200,4,250,2015,Nissan
231996,1.9,175315.0,5250,3100,89090,11,-2150,2015,Ford
534260,2.6,78749.0,3500,4200,82150,10,700,2015,Ford
256672,4.4,29738.0,23800,24300,59100,3,500,2015,Chevrolet
512264,2.7,118935.0,5825,5800,71660,6,-25,2015,Chevrolet
232663,4.2,63063.0,10400,10900,89090,2,500,2015,Nissan
95576,4.7,34347.0,20400,21200,68360,1,800,2015,Ford
491697,3.5,42930.0,15900,16800,73130,2,900,2015,Chevrolet
195484,1.0,110518.0,1450,300,67090,13,-1150,2015,Ford
403482,3.8,41508.0,18600,15300,61450,1,-3300,2015,Ford
193849,1.9,74434.0,5875,5000,67090,8,-875,2015,Chevrolet
370150,2.4,128644.0,1300,550,64520,14,-750,2015,Ford
278173,2.4,30207.0,13400,12200,59100,2,-1200,2015,Nissan
278253,4.4,8813.0,25200,37000,59100,2,11800,2015,Ford
101391,1.9,12448.0,22300,22000,68360,1,-300,2015,Chevrolet
453615,3.2,75600.0,3900,3200,61490,6,-700,2015,Chevrolet
338257,2.7,113589.0,9100,7900,82750,8,-1200,2015,Ford
66610,3.6,22671.0,8975,8300,77030,2,-675,2015,Nissan
30132,2.8,81629.0,6150,5600,77030,5,-550,2015,Nissan
482963,4.3,22577.0,14600,32800,73130,2,18200,2015,Ford
85445,3.9,116226.0,5900,4000,68360,10,-1900,2015,Ford
140004,4.4,7433.0,14750,14800,73100,2,50,2015,Chevrolet
169955,3.9,30187.0,18600,17500,73100,1,-1100,2015,Ford
175369,3.7,42725.0,10800,11300,83200,2,500,2015,Chevrolet
468628,3.5,52006.0,17100,17300,61490,1,200,2015,Chevrolet
230616,4.3,193516.0,3175,4400,89090,9,1225,2015,Nissan
219334,3.6,79812.0,16500,14500,57290,2,-2000,2015,Ford
93926,3.9,49216.0,9900,7800,68360,3,-2100,2015,Ford
521751,3.5,25185.0,20800,21500,71660,1,700,2015,Ford
283796,4.6,6801.0,20800,20600,59100,1,-200,2015,Ford
466542,2.6,98555.0,21000,23000,61490,6,2000,2015,Chevrolet
108450,4.2,28673.0,25400,23500,68360,1,-1900,2015,Ford
180499,4.0,33433.0,31100,32200,83200,1,1100,2015,Ford
168206,2.5,28871.0,16550,12600,73100,3,-3950,2015,Ford
81753,3.4,49465.0,7425,7400,68360,5,-25,2015,Nissan
189716,3.4,52189.0,11600,11800,63250,2,200,2015,Chevrolet
110332,4.8,6489.0,34500,37200,68360,0,2700,2015,Ford
518678,2.5,81156.0,7500,8500,71660,8,1000,2015,Ford
484985,3.2,26290.0,15050,13300,73130,1,-1750,2015,Ford
505357,4.9,35923.0,25800,29000,80610,3,3200,2015,Ford
337192,3.6,77136.0,9025,10300,82750,8,1275,2015,Nissan
412923,3.2,83060.0,5600,5700,61450,5,100,2015,Chevrolet
460229,4.0,72964.0,16150,17700,61490,4,1550,2015,Ford
223282,1.9,198875.0,2550,1400,89090,12,-1150,2015,Ford
77236,3.8,31844.0,37100,35900,68360,3,-1200,2014,Ford
189069,4.3,27118.0,16800,16000,63250,1,-800,2015,Nissan
230192,3.5,80266.0,9150,7100,89090,3,-2050,2015,Chevrolet
88302,2.8,137566.0,4850,3600,68360,9,-1250,2015,Nissan
406725,4.1,19550.0,12600,11700,61450,1,-900,2015,Ford
115577,4.6,48715.0,10800,11400,68360,3,600,2015,Nissan
184454,4.1,30424.0,27400,27000,63250,1,-400,2015,Chevrolet
340847,4.2,35231.0,11650,13700,82750,3,2050,2015,Nissan
448829,2.1,99028.0,16950,15100,61490,6,-1850,2014,Chevrolet
49723,2.9,144384.0,2175,2900,77030,6,725,2015,Chevrolet
518544,4.8,27172.0,20400,20800,71660,2,400,2015,Ford
480301,4.6,26770.0,18000,19000,73130,2,1000,2015,Ford
94876,4.4,43310.0,12650,13800,68360,2,1150,2015,Chevrolet
446027,3.1,58715.0,11900,11800,56120,2,-100,2015,Nissan
95766,2.3,57258.0,13800,13300,68360,2,-500,2015,Nissan
278519,2.3,127179.0,2150,2100,59100,9,-50,2015,Chevrolet
340866,4.1,44250.0,16150,16100,82750,3,-50,2015,Nissan
533031,3.8,128428.0,5800,5100,82150,9,-700,2015,Ford
208413,4.0,37573.0,24900,24800,57290,2,-100,2015,Ford
252737,4.0,13645.0,13600,13800,59100,1,200,2015,Chevrolet
330742,3.8,40529.0,12350,12400,82750,4,50,2015,Nissan
422026,3.6,65071.0,9725,10400,61450,4,675,2015,Ford
329877,1.0,17101.0,22000,13000,82750,1,-9000,2015,Chevrolet
465990,4.8,22639.0,24500,25000,61490,1,500,2015,Chevrolet
2721,2.9,109785.0,5125,5000,77030,4,-125,2014,Nissan
383815,5.0,34077.0,20700,20100,65610,2,-600,2015,Ford
164961,3.5,6344.0,14000,13800,73100,2,-200,2015,Nissan
244674,2.0,41018.0,10950,8500,59100,2,-2450,2015,Chevrolet
202190,2.0,94238.0,14250,2900,57290,7,-11350,2015,Chevrolet
526208,3.8,13267.0,22800,21300,70210,2,-1500,2015,Ford
223043,5.0,9821.0,10600,11000,89090,2,400,2015,Ford
77128,4.3,49403.0,11500,12000,68360,2,500,2014,Nissan
184265,2.2,99625.0,13350,12900,63250,5,-450,2015,Nissan
265296,4.7,35348.0,14650,14600,59100,1,-50,2015,Ford
290582,4.0,21861.0,12500,12500,59100,1,0,2015,Chevrolet
387595,2.4,59085.0,5050,2900,65610,5,-2150,2015,Chevrolet
25129,2.2,74359.0,7675,8500,77030,11,825,2015,Nissan
527378,4.7,21557.0,22400,23400,70210,1,1000,2015,Ford
494185,4.8,17784.0,24300,26000,73130,2,1700,2015,Ford
201470,4.9,1041.0,20600,21800,57290,1,1200,2014,Chevrolet
74991,,198155.0,2525,1850,68360,13,-675,2014,Ford
79312,2.2,28033.0,12650,10000,68360,3,-2650,2015,Nissan
200879,4.3,67355.0,27900,26000,67090,3,-1900,2015,Ford
281163,3.6,29258.0,17200,17800,59100,4,600,2015,Nissan
227429,3.6,18249.0,17500,16000,89090,1,-1500,2015,Ford
207556,4.4,19725.0,28800,24200,57290,1,-4600,2015,Nissan
104980,2.7,261955.0,4125,6200,68360,6,2075,2015,Chevrolet
252573,4.0,21475.0,12150,12600,59100,1,450,2015,Chevrolet
183723,1.0,163619.0,1500,1500,63250,12,0,2014,Ford
175243,3.3,125333.0,5075,5450,83200,9,375,2015,Ford
216707,3.9,19549.0,18600,17600,57290,3,-1000,2015,Nissan
186202,4.0,38497.0,29700,31800,63250,1,2100,2015,Ford
179873,3.4,88973.0,17500,16250,83200,5,-1250,2015,Ford
326566,3.6,31093.0,16500,13900,82750,1,-2600,2015,Ford
334190,3.2,82449.0,12450,11600,82750,4,-850,2015,Nissan
55074,2.3,94202.0,7075,6000,77030,5,-1075,2015,Chevrolet
209140,3.8,52770.0,15600,16900,57290,2,1300,2015,Nissan
128000,3.5,97844.0,6150,8800,73100,7,2650,2015,Chevrolet
236277,3.9,44557.0,10250,10800,59100,1,550,2014,Ford
106807,4.4,33081.0,26400,25700,68360,1,-700,2015,Ford
122632,3.2,34237.0,15600,15600,73100,2,0,2014,Nissan
282840,1.9,59492.0,7675,7500,59100,3,-175,2015,Nissan
499076,2.8,60972.0,9225,8600,80610,1,-625,2014,Chevrolet
427231,2.0,177635.0,5925,4700,61450,7,-1225,2015,Ford
281196,4.3,87142.0,6450,6100,59100,5,-350,2015,Ford
481349,4.8,23146.0,18300,18800,73130,2,500,2015,Ford
500789,3.2,41402.0,10400,10800,80610,3,400,2015,Ford
55697,2.0,16615.0,22700,21500,77030,1,-1200,2015,Chevrolet
17233,2.9,151291.0,3725,6100,77030,14,2375,2015,Ford
348355,,126180.0,4400,4100,62960,12,-300,2014,Ford
404133,3.2,40030.0,22900,22200,61450,2,-700,2015,Ford
24894,3.7,35367.0,7500,7500,77030,3,0,2015,Chevrolet
528933,4.3,27821.0,23900,25800,70210,2,1900,2015,Ford
377852,2.9,41488.0,8375,7900,64520,2,-475,2015,Chevrolet
449341,1.9,104760.0,4150,3500,61490,11,-650,2014,Chevrolet
340578,3.7,3847.0,12300,11800,82750,2,-500,2015,Nissan
510500,3.7,42218.0,15400,14600,71660,3,-800,2015,Nissan
44320,4.0,16549.0,24200,25000,77030,1,800,2015,Ford
187027,2.9,87285.0,9275,9000,63250,13,-275,2015,Ford
93361,3.7,99741.0,32200,33900,68360,3,1700,2015,Ford
111606,2.3,81291.0,15500,14000,68360,4,-1500,2015,Nissan
195289,2.4,61411.0,10500,9600,67090,3,-900,2015,Nissan
39453,4.1,46430.0,15000,15500,77030,2,500,2015,Ford
211675,2.8,38488.0,12800,12300,57290,1,-500,2015,Chevrolet
507457,3.1,52378.0,9150,8800,80200,2,-350,2015,Chevrolet
456525,3.3,82731.0,15900,15600,61490,3,-300,2015,Ford
160200,2.9,38545.0,11450,11100,73100,3,-350,2015,Nissan
484527,4.0,16803.0,13450,13400,73130,1,-50,2015,Chevrolet
209883,3.5,42842.0,16600,16200,57290,4,-400,2015,Nissan
476976,3.5,45317.0,16350,16700,73130,3,350,2015,Nissan
142585,4.2,41714.0,16700,16400,73100,3,-300,2015,Nissan
518685,2.9,117125.0,6325,8300,71660,9,1975,2015,Ford
353513,2.0,148602.0,1100,1200,62960,13,100,2015,Ford
468798,2.6,234345.0,2675,1700,61490,13,-975,2015,Chevrolet
200156,3.9,59235.0,16900,15100,67090,3,-1800,2015,Ford
392958,2.0,88099.0,11550,7300,65610,8,-4250,2015,Ford
274452,2.4,103935.0,5525,3500,59100,8,-2025,2015,Ford
469582,2.7,317514.0,825,2700,61490,11,1875,2015,Chevrolet
204536,4.2,27663.0,14650,15100,57290,2,450,2015,Ford
389385,3.6,40098.0,27800,26600,65610,2,-1200,2015,Ford
130543,3.9,21696.0,19450,19400,73100,1,-50,2015,Ford
1240,3.4,41949.0,10900,10900,77030,2,0,2014,Ford
507507,1.9,40517.0,8225,7100,80200,5,-1125,2015,Ford
349762,3.6,62291.0,11400,12600,62960,1,1200,2014,Ford
512183,4.1,45255.0,10350,10200,71660,2,-150,2015,Nissan
151670,4.4,19373.0,15450,14800,73100,1,-650,2015,Ford
268489,3.6,63400.0,21000,19200,59100,3,-1800,2015,Chevrolet
95911,4.5,20481.0,14750,15500,68360,1,750,2015,Chevrolet
108789,3.5,42272.0,11250,10300,68360,3,-950,2015,Nissan
495118,2.4,50570.0,16250,16800,73130,2,550,2015,Chevrolet
386004,4.1,29636.0,8775,9300,65610,4,525,2015,Ford
156611,3.7,71093.0,6425,6500,73100,5,75,2015,Ford
481324,4.8,21721.0,17200,18400,73130,2,1200,2015,Ford
419647,3.1,44395.0,16500,16700,61450,3,200,2015,Ford
289813,2.4,107815.0,2325,2300,59100,8,-25,2015,Chevrolet
500663,3.7,46290.0,18500,18500,80610,2,0,2015,Nissan
62536,2.9,90418.0,9675,9800,77030,5,125,2015,Ford
286877,5.0,5573.0,31600,33000,59100,1,1400,2015,Ford
415613,2.5,109652.0,12400,12700,61450,8,300,2015,Ford
510763,4.8,10277.0,14950,16700,71660,1,1750,2015,Ford
86068,2.9,22472.0,21600,20500,68360,2,-1100,2015,Chevrolet
510884,2.9,21765.0,20200,17500,71660,1,-2700,2015,Ford
230201,4.7,13735.0,16450,16100,89090,3,-350,2015,Ford
80734,2.5,60697.0,7950,7200,68360,4,-750,2015,Chevrolet
544269,2.4,155131.0,9325,8400,81400,10,-925,2015,Nissan
190594,2.3,120915.0,7450,6300,63250,8,-1150,2015,Ford
211923,1.9,157200.0,2725,2700,57290,9,-25,2015,Chevrolet
497834,4.2,41269.0,11200,13200,73130,3,2000,2015,Nissan
124225,1.9,138968.0,1800,1400,73100,15,-400,2015,Chevrolet
150736,4.9,35152.0,18800,18600,73100,3,-200,2015,Ford
89590,1.9,121086.0,4025,4000,68360,7,-25,2015,Nissan
105913,4.4,6595.0,16200,16000,68360,0,-200,2015,Chevrolet
323109,4.2,21105.0,12250,13400,82750,3,1150,2015,Ford
345643,3.2,22463.0,12150,11500,82750,2,-650,2015,Nissan
90923,2.8,114680.0,5875,7000,68360,5,1125,2015,Chevrolet
428906,1.0,89604.0,9250,5200,61450,2,-4050,2015,Ford
477788,3.5,32985.0,11050,11000,73130,3,-50,2015,Ford
201646,3.7,33631.0,16500,18000,57290,1,1500,2014,Nissan
377822,1.9,127246.0,2400,1700,64520,12,-700,2015,Ford
175614,2.8,25776.0,25900,24200,83200,2,-1700,2015,Ford
343310,3.0,1329.0,29000,29200,82750,0,200,2015,Ford
184577,2.8,94728.0,1550,2600,63250,11,1050,2015,Ford
129504,1.9,55371.0,10850,8500,73100,3,-2350,2015,Nissan
205020,4.7,12419.0,27000,25900,57290,1,-1100,2015,Ford
402385,5.0,61011.0,14800,15600,61450,3,800,2015,Ford
259886,4.6,40120.0,11600,14200,59100,3,2600,2015,Nissan
111029,3.6,94185.0,3700,4300,68360,9,600,2015,Nissan
416312,2.9,71234.0,6475,7400,61450,9,925,2015,Chevrolet
147400,3.4,38130.0,19850,19500,73100,2,-350,2015,Chevrolet
496663,3.8,37068.0,11300,11400,73130,3,100,2015,Nissan
223807,4.3,47667.0,13550,14200,89090,3,650,2015,Ford
417726,5.0,64023.0,33000,33000,61450,3,0,2015,Chevrolet
366209,3.7,30737.0,12200,14500,64520,3,2300,2015,Nissan
249686,4.7,28419.0,10600,11200,59100,1,600,2015,Ford
68035,2.6,135894.0,4425,6000,77030,8,1575,2015,Nissan
99040,3.1,92046.0,8175,9000,68360,4,825,2015,Nissan
540565,2.2,1.0,7175,650,81400,15,-6525,2015,Ford
303055,2.3,36902.0,12700,10400,59100,3,-2300,2015,Nissan
362264,4.4,104112.0,3950,5000,64520,6,1050,2014,Nissan
498556,1.9,50028.0,9975,9100,80610,2,-875,2014,Chevrolet
184650,2.8,59804.0,14750,14300,63250,3,-450,2015,Nissan
37709,1.9,84393.0,2950,2700,77030,8,-250,2015,Ford
421231,4.8,49683.0,20600,22800,61450,3,2200,2015,Ford
401560,4.7,35483.0,16500,17900,61450,2,1400,2015,Ford
207148,4.3,78286.0,19700,22500,57290,4,2800,2015,Ford
286433,3.7,52908.0,20800,22600,59100,2,1800,2015,Nissan
366731,3.6,88533.0,6675,8000,64520,9,1325,2015,Ford
353587,2.0,43882.0,11600,6900,62960,3,-4700,2015,Nissan
389689,5.0,49480.0,28100,30000,65610,3,1900,2015,Chevrolet
231269,1.9,93831.0,6400,4100,89090,4,-2300,2015,Chevrolet
510903,4.3,33101.0,18700,19300,71660,1,600,2015,Ford
344273,3.8,34895.0,36400,36300,82750,0,-100,2015,Ford
95031,4.5,42217.0,17350,17300,68360,1,-50,2015,Chevrolet
112449,3.6,30227.0,11850,11000,68360,3,-850,2015,Nissan
454635,2.6,97656.0,4775,5300,61490,9,525,2015,Chevrolet
165563,3.7,51514.0,9700,10300,73100,2,600,2015,Chevrolet
536152,3.5,69885.0,4025,4100,82150,9,75,2015,Nissan
215745,4.0,16332.0,15050,15300,57290,3,250,2015,Chevrolet
357309,3.5,61643.0,11250,10900,62960,2,-350,2015,Ford
336001,2.9,28104.0,12300,11400,82750,3,-900,2015,Ford
10427,3.3,47873.0,11550,11500,77030,2,-50,2014,Nissan
389449,4.6,62398.0,28300,26300,65610,3,-2000,2015,Ford
410416,1.9,87525.0,5900,4100,61450,3,-1800,2015,Nissan
173076,,47730.0,23300,19900,83200,4,-3400,2014,Ford
217145,2.7,84282.0,7350,8000,57290,6,650,2015,Ford
213984,4.8,18881.0,15900,17400,57290,1,1500,2015,Nissan
166767,4.6,2391.0,56100,57700,73100,1,1600,2015,Ford
214619,4.6,5241.0,19000,18800,57290,1,-200,2015,Chevrolet
487211,2.1,19486.0,13700,11900,73130,2,-1800,2015,Ford
397183,3.4,26432.0,13800,13500,65610,2,-300,2015,Ford
495797,2.1,54847.0,10950,10800,73130,2,-150,2015,Nissan
185528,1.9,143728.0,5675,4500,63250,11,-1175,2015,Chevrolet
374688,3.4,95667.0,14150,11000,64520,7,-3150,2015,Ford
202051,4.8,23720.0,15000,15600,57290,2,600,2014,Ford
235707,,197814.0,2425,500,59100,13,-1925,2014,Chevrolet
517089,4.3,77182.0,7325,8300,71660,11,975,2015,Chevrolet
360680,4.3,49370.0,17250,17100,64520,0,-150,2014,Ford
137063,2.0,207823.0,175,750,73100,10,575,2015,Ford
12203,2.7,57942.0,3900,3800,77030,12,-100,2014,Chevrolet
378760,2.1,29802.0,17350,17900,64520,3,550,2015,Nissan
338163,3.6,56403.0,11950,12900,82750,4,950,2015,Nissan
45492,4.1,19370.0,12950,13200,77030,1,250,2015,Nissan
18747,4.1,31440.0,14450,13400,77030,2,-1050,2015,Ford
481253,1.9,113559.0,1425,1100,73130,13,-325,2015,Chevrolet
528833,2.3,52018.0,13000,11500,70210,3,-1500,2015,Ford
159725,3.6,55084.0,11100,10700,73100,2,-400,2015,Nissan
501608,1.9,80143.0,5550,2900,80610,7,-2650,2015,Chevrolet
499198,4.2,10399.0,21800,20200,80610,1,-1600,2015,Ford
354676,3.4,56073.0,9850,10200,62960,2,350,2015,Chevrolet
506325,3.6,42510.0,10450,10300,80200,3,-150,2015,Chevrolet
458827,3.8,45727.0,9675,9500,61490,1,-175,2015,Ford
340954,4.3,24471.0,15150,16200,82750,3,1050,2015,Nissan
133608,4.7,41279.0,14050,13900,73100,1,-150,2015,Ford
386090,4.2,29310.0,11600,12200,65610,2,600,2015,Ford
93786,3.9,42510.0,27200,26500,68360,1,-700,2015,Ford
339501,3.9,78412.0,16250,17000,82750,2,750,2015,Ford
470576,1.9,111760.0,3100,900,62930,7,-2200,2014,Chevrolet
524966,2.7,14609.0,12750,11700,70210,1,-1050,2015,Ford
486151,4.4,18299.0,14700,16000,73130,2,1300,2015,Ford
363850,2.7,219083.0,2425,2100,64520,8,-325,2015,Nissan
41691,3.8,87707.0,2925,4100,77030,9,1175,2015,Ford
389259,2.7,135872.0,3100,3600,65610,10,500,2015,Chevrolet
204346,4.4,39643.0,16150,16100,57290,1,-50,2015,Ford
127422,1.9,30071.0,9425,6400,73100,2,-3025,2015,Ford
221995,2.2,79446.0,14950,15400,89090,4,450,2014,Chevrolet
85035,1.9,39607.0,11700,9600,68360,3,-2100,2015,Nissan
388862,3.9,45255.0,10150,10300,65610,3,150,2015,Chevrolet
431790,2.6,115831.0,6300,7100,61450,6,800,2015,Nissan
191290,,110596.0,5950,5000,67090,8,-950,2014,Ford
132009,4.2,63093.0,9175,8300,73100,4,-875,2015,Ford
117765,4.6,35492.0,21400,23100,68360,2,1700,2015,Ford
497557,4.0,13065.0,11650,11600,73130,0,-50,2015,Chevrolet
43286,2.8,58691.0,8475,9100,77030,3,625,2015,Nissan
528077,3.5,34201.0,16700,14600,70210,1,-2100,2015,Ford
146939,3.3,15599.0,14800,13800,73100,2,-1000,2015,Nissan
183628,,41510.0,12650,13100,63250,1,450,2014,Chevrolet
54350,2.8,108867.0,1725,2000,77030,11,275,2015,Chevrolet
394912,4.3,45771.0,31300,28500,65610,2,-2800,2015,Ford
105757,4.8,29706.0,15800,34300,68360,2,18500,2015,Ford
192254,1.0,259.0,2950,800,67090,11,-2150,2014,Chevrolet
230969,3.7,54640.0,8925,8900,89090,2,-25,2015,Ford
439829,2.4,155929.0,4450,4400,74430,9,-50,2015,Nissan
1697,2.9,41350.0,13000,14000,77030,2,1000,2014,Nissan
150859,3.7,76596.0,7525,9600,73100,7,2075,2015,Nissan
124049,2.7,47805.0,8775,8500,73100,4,-275,2015,Nissan
409672,2.0,23518.0,15650,10700,61450,1,-4950,2015,Nissan
504984,1.9,117660.0,2075,1900,80610,12,-175,2015,Chevrolet
417791,5.0,72656.0,22200,24400,61450,5,2200,2015,Chevrolet
292028,4.4,34642.0,12650,17600,59100,3,4950,2015,Nissan
361593,3.6,79794.0,13600,14800,64520,7,1200,2014,Ford
508950,1.9,20341.0,21400,13500,71660,1,-7900,2015,Ford
100163,2.7,110725.0,13250,13800,68360,8,550,2015,Chevrolet
527057,3.3,104252.0,8625,6800,70210,5,-1825,2015,Ford
399483,3.3,107620.0,11100,11800,61450,6,700,2014,Ford
313256,4.3,25864.0,26300,28600,59100,1,2300,2015,Ford
49734,3.4,128161.0,4250,3500,77030,6,-750,2015,Ford
492223,5.0,15391.0,43100,40400,73130,1,-2700,2015,Ford
344668,4.1,179618.0,850,3200,82750,6,2350,2015,Chevrolet
393567,4.9,10923.0,11100,11100,65610,1,0,2015,Chevrolet
100725,2.3,30742.0,9025,9400,68360,3,375,2015,Nissan
489972,4.0,5515.0,25900,27700,73130,0,1800,2015,Chevrolet
543832,1.9,173614.0,900,1100,81400,12,200,2015,Ford
343857,4.4,18951.0,23400,23000,82750,2,-400,2015,Ford
49733,2.7,148308.0,8325,7400,77030,6,-925,2015,Ford
299017,1.9,121555.0,825,700,59100,13,-125,2015,Chevrolet
216135,4.9,10522.0,12800,13800,57290,1,1000,2015,Ford
286715,4.0,21515.0,13500,14300,59100,1,800,2015,Chevrolet
231218,3.8,169654.0,1575,1400,89090,13,-175,2015,Ford
373360,4.2,36178.0,11750,11400,64520,1,-350,2015,Chevrolet
28649,2.3,63605.0,18150,18100,77030,5,-50,2015,Ford
90301,4.3,51634.0,10550,12100,68360,5,1550,2015,Nissan
277320,4.4,12741.0,19450,12600,59100,3,-6850,2015,Nissan
232819,2.4,123885.0,3350,3200,89090,10,-150,2015,Nissan
186599,1.9,134319.0,2475,2550,63250,15,75,2015,Ford
338145,3.8,90365.0,7550,7000,82750,4,-550,2015,Chevrolet
413957,4.2,38279.0,14450,14200,61450,1,-250,2015,Ford
282780,3.3,34558.0,27700,27500,59100,1,-200,2015,Ford
447614,3.7,111405.0,6450,7100,56120,3,650,2015,Chevrolet
391611,2.9,83949.0,8700,8200,65610,3,-500,2015,Chevrolet
124589,3.5,51177.0,4250,6100,73100,8,1850,2015,Chevrolet
142680,4.3,48618.0,18550,19400,73100,4,850,2015,Nissan
182849,2.0,108035.0,2600,1100,63250,8,-1500,2014,Chevrolet
186579,2.0,91270.0,1600,2200,63250,11,600,2015,Chevrolet
548996,2.0,93576.0,7225,7600,48460,8,375,2015,Ford
174138,3.7,32822.0,17100,17400,83200,1,300,2014,Ford
275914,3.8,41562.0,10350,10800,59100,2,450,2015,Ford
43921,3.5,65314.0,13500,12600,77030,2,-900,2015,Ford
450886,2.8,74653.0,5700,4500,61490,3,-1200,2014,Nissan
545617,5.0,13125.0,17300,17700,81400,2,400,2015,Nissan
505079,3.5,85534.0,7300,8200,80610,6,900,2015,Chevrolet
62756,2.6,237568.0,1550,1550,77030,14,0,2015,Chevrolet
119671,3.9,41331.0,15450,16400,73100,3,950,2014,Nissan
349107,,40070.0,26300,26750,62960,2,450,2014,Chevrolet
481777,4.8,27516.0,12400,14000,73130,3,1600,2015,Nissan
396466,3.4,33252.0,9950,9600,65610,7,-350,2015,Chevrolet
520776,4.6,15801.0,14500,15500,71660,2,1000,2015,Ford
170309,3.2,34551.0,30800,34000,73100,2,3200,2015,Ford
515389,1.9,94346.0,5150,4100,71660,9,-1050,2015,Chevrolet
89106,4.1,50503.0,21400,23900,68360,3,2500,2015,Ford
232756,3.9,103334.0,7500,6400,89090,7,-1100,2015,Ford
74108,4.6,16953.0,16700,17600,68360,0,900,2014,Ford
176123,4.6,3240.0,21400,21700,83200,1,300,2015,Ford
56026,2.8,132905.0,6800,7400,77030,10,600,2015,Nissan
463686,3.4,131790.0,7775,9900,61490,10,2125,2015,Chevrolet
10077,4.5,45305.0,12850,12500,77030,1,-350,2014,Nissan
85169,2.7,45476.0,18000,14600,68360,4,-3400,2015,Nissan
489814,4.0,13412.0,13600,13500,73130,1,-100,2015,Chevrolet
448927,,9971.0,12900,7000,61490,0,-5900,2014,Ford
147027,4.3,24705.0,14100,14800,73100,3,700,2015,Nissan
374886,4.3,58000.0,7425,8800,64520,9,1375,2015,Ford
458091,4.9,48949.0,13300,14400,61490,5,1100,2015,Nissan
203869,3.4,19948.0,12200,11300,57290,2,-900,2015,Ford
344412,2.0,109319.0,5700,6200,82750,7,500,2015,Nissan
40775,1.0,37970.0,12950,8900,77030,2,-4050,2015,Chevrolet
50968,2.9,45018.0,13600,11800,77030,4,-1800,2015,Ford
85030,2.9,28275.0,12350,12000,68360,3,-350,2015,Nissan
99936,4.3,81319.0,14500,15500,68360,4,1000,2015,Chevrolet
520772,3.8,33591.0,10550,9700,71660,2,-850,2015,Ford
113371,2.7,46531.0,10850,10200,68360,3,-650,2015,Nissan
396224,4.3,81514.0,21700,21900,65610,3,200,2015,Ford
339294,2.2,109169.0,4750,2500,82750,9,-2250,2015,Nissan
280803,2.0,175196.0,700,400,59100,14,-300,2015,Chevrolet
334440,2.9,177386.0,3500,3700,82750,11,200,2015,Chevrolet
527678,2.1,111963.0,4150,3000,70210,11,-1150,2015,Nissan
495032,3.7,41436.0,11100,10800,73130,1,-300,2015,Chevrolet
242960,1.9,99373.0,3300,3400,59100,9,100,2015,Chevrolet
157050,2.7,53236.0,7750,7200,73100,2,-550,2015,Ford
549129,3.9,61888.0,12150,11500,48460,3,-650,2015,Ford
531040,3.1,61267.0,10100,8800,82150,3,-1300,2015,Ford
81700,2.0,127592.0,11800,9000,68360,5,-2800,2015,Chevrolet
349739,4.4,60657.0,15700,15700,62960,1,0,2014,Chevrolet
361747,4.3,36584.0,10800,11100,64520,1,300,2014,Ford
18694,3.4,36273.0,20800,20400,77030,2,-400,2015,Ford
367520,2.0,67477.0,7575,5800,64520,8,-1775,2015,Ford
354396,4.0,62568.0,17100,17100,62960,2,0,2015,Chevrolet
493567,1.9,42362.0,5175,4400,73130,5,-775,2015,Chevrolet
37048,1.0,97947.0,4550,4000,77030,9,-550,2015,Chevrolet
21341,2.7,117830.0,4425,5500,77030,11,1075,2015,Ford
493383,3.0,17021.0,21500,21100,73130,0,-400,2015,Chevrolet
531968,1.9,1.0,4775,850,82150,8,-3925,2015,Ford
175983,3.9,51315.0,19750,19800,83200,5,50,2015,Ford
200494,4.7,59711.0,9025,9600,67090,1,575,2015,Ford
509514,4.5,34656.0,18100,18000,71660,1,-100,2015,Ford
469692,2.6,119522.0,750,600,61490,16,-150,2015,Ford
293715,1.9,142199.0,4050,3700,59100,6,-350,2015,Chevrolet
219880,3.3,40154.0,15850,15300,57290,1,-550,2015,Ford
22227,3.5,126805.0,9925,11600,77030,7,1675,2015,Ford
256480,3.8,64854.0,13550,12600,59100,3,-950,2015,Ford
548375,2.8,132586.0,13600,13300,48460,5,-300,2015,Ford
120700,,126731.0,3100,3000,73100,10,-100,2014,Nissan
450222,3.9,101170.0,7400,8100,61490,3,700,2014,Ford
485093,3.7,55371.0,27600,27500,73130,2,-100,2015,Chevrolet
493037,4.3,27613.0,20500,21500,73130,2,1000,2015,Nissan
327185,2.6,43847.0,11250,11700,82750,5,450,2015,Nissan
122562,4.1,10573.0,15100,16500,73100,2,1400,2014,Nissan
292719,3.5,46047.0,9475,9400,59100,2,-75,2015,Ford
138933,4.3,40329.0,10200,10000,73100,3,-200,2015,Chevrolet
395197,3.8,28240.0,19600,19600,65610,2,0,2015,Ford
58277,2.7,63892.0,14000,13400,77030,1,-600,2015,Ford
327034,4.4,70303.0,9925,9700,82750,3,-225,2015,Nissan
316013,3.9,24010.0,10500,9000,73200,3,-1500,2014,Ford
521695,3.7,36818.0,9650,10800,71660,3,1150,2015,Nissan
480425,3.6,8147.0,15100,13200,73130,2,-1900,2015,Nissan
188320,3.8,47700.0,16800,15300,63250,3,-1500,2015,Ford
270075,3.6,34306.0,11950,14200,59100,3,2250,2015,Nissan
447851,3.7,94386.0,6100,6500,56120,7,400,2015,Nissan
399321,2.1,150975.0,3300,2300,61450,8,-1000,2015,Chevrolet
538284,3.6,65787.0,12750,12500,55590,2,-250,2015,Ford
508052,4.3,24495.0,12450,12400,71660,0,-50,2014,Ford
497853,3.6,21334.0,14300,14800,73130,3,500,2015,Nissan
229152,5.0,16890.0,17400,16900,89090,2,-500,2015,Ford
239413,4.6,27547.0,21200,21100,59100,1,-100,2014,Ford
420034,2.8,24049.0,15100,15000,61450,3,-100,2015,Nissan
341700,2.8,131907.0,11600,11500,82750,9,-100,2015,Chevrolet
431832,2.7,202387.0,5275,7200,61450,11,1925,2015,Nissan
40779,1.0,28504.0,13450,12400,77030,2,-1050,2015,Chevrolet
478135,5.0,23199.0,35300,36500,73130,1,1200,2015,Ford
413517,4.9,24114.0,12250,12600,61450,3,350,2015,Ford
479704,3.9,40110.0,12900,13800,73130,3,900,2015,Nissan
470915,4.4,52364.0,15050,14500,62930,1,-550,2014,Ford
66220,4.4,28065.0,12000,12500,77030,3,500,2015,Nissan
414241,3.6,102173.0,9675,11500,61450,9,1825,2015,Chevrolet
62851,4.2,52126.0,12950,13100,77030,2,150,2015,Chevrolet
45545,2.6,55458.0,12100,12100,77030,2,0,2015,Chevrolet
107922,3.6,29779.0,20000,20000,68360,2,0,2015,Nissan
189322,2.7,126815.0,3400,4300,63250,7,900,2015,Ford
547748,4.0,21668.0,31100,27000,78090,2,-4100,2015,Chevrolet
540783,3.7,35670.0,9650,11100,81400,2,1450,2015,Chevrolet
334643,4.8,45705.0,21400,22300,82750,2,900,2015,Ford
125245,5.0,41090.0,34500,36700,73100,4,2200,2015,Ford
287329,3.9,24191.0,29700,29800,59100,1,100,2015,Ford
147580,2.9,113236.0,4000,3700,73100,9,-300,2015,Nissan
174352,2.5,29978.0,11400,9900,83200,2,-1500,2015,Ford
235363,,291932.0,4050,5200,59100,11,1150,2014,Ford
526598,2.5,101900.0,5900,4000,70210,8,-1900,2015,Ford
319999,1.9,118666.0,5300,5900,73200,12,600,2015,Chevrolet
2247,3.8,69242.0,21600,16500,77030,1,-5100,2015,Chevrolet
164981,4.0,18011.0,14650,15800,73100,2,1150,2015,Nissan
509264,4.9,194995.0,4550,5800,71660,9,1250,2014,Chevrolet
470305,4.1,81457.0,14050,15000,61490,5,950,2015,Chevrolet
112799,4.1,17588.0,25400,24600,68360,1,-800,2015,Nissan
299581,4.0,4544.0,25000,23800,59100,1,-1200,2015,Chevrolet
527699,3.5,76352.0,8175,7100,70210,5,-1075,2015,Chevrolet
346166,3.8,33839.0,11650,10900,82750,3,-750,2015,Nissan
495484,3.7,31616.0,10100,11000,73130,2,900,2015,Chevrolet
338856,4.2,39360.0,17950,16750,82750,2,-1200,2015,Chevrolet
19003,2.0,59279.0,10650,9500,77030,3,-1150,2015,Nissan
505081,3.6,65854.0,13050,14700,80610,6,1650,2015,Nissan
102985,3.7,144668.0,15050,15800,68360,7,750,2015,Chevrolet
246505,4.1,7927.0,14350,14600,59100,1,250,2015,Chevrolet
377272,3.4,94573.0,6550,5600,64520,8,-950,2015,Chevrolet
339992,3.8,99129.0,4550,4400,82750,9,-150,2015,Chevrolet
184108,1.0,102875.0,5825,1800,63250,8,-4025,2015,Chevrolet
399278,3.1,51702.0,10400,10800,61450,2,400,2014,Nissan
456531,3.4,72036.0,9450,9200,61490,3,-250,2015,Ford
515489,4.3,56633.0,13350,14800,71660,1,1450,2015,Ford
493385,4.0,21849.0,21100,21100,73130,0,0,2015,Chevrolet
392851,5.0,15277.0,28800,30700,65610,2,1900,2015,Ford
176311,4.1,73525.0,7100,9100,83200,5,2000,2015,Chevrolet
416935,2.9,33166.0,9925,9400,61450,2,-525,2015,Nissan
514311,3.2,28098.0,13850,13200,71660,2,-650,2015,Chevrolet
409978,3.6,128619.0,7350,7300,61450,10,-50,2015,Chevrolet
236175,3.0,40386.0,11050,9800,59100,1,-1250,2014,Chevrolet
133607,4.4,42368.0,14750,14300,73100,1,-450,2015,Ford
101755,4.1,86331.0,25800,26400,68360,3,600,2015,Ford
86635,3.5,38327.0,11600,11300,68360,1,-300,2015,Chevrolet
221560,1.0,33185.0,23500,13400,57290,0,-10100,2015,Nissan
377695,2.0,62836.0,8175,7100,64520,4,-1075,2015,Chevrolet
334563,4.1,81377.0,7975,8200,82750,4,225,2015,Ford
390131,4.5,24513.0,45500,44400,65610,3,-1100,2015,Ford
449736,,49439.0,10050,9100,61490,2,-950,2014,Ford
487839,4.9,18641.0,12550,12100,73130,1,-450,2015,Ford
452766,4.0,67309.0,7250,8100,61490,6,850,2015,Ford
387076,1.9,144042.0,4500,3000,65610,5,-1500,2015,Chevrolet
71598,3.9,36549.0,10650,10200,77030,3,-450,2015,Ford
301655,4.3,11047.0,9375,8600,59100,5,-775,2015,Nissan
109877,4.3,173298.0,6350,6100,68360,9,-250,2015,Ford
282389,1.9,236640.0,1075,1000,59100,10,-75,2015,Chevrolet
243092,4.3,25835.0,12400,11600,59100,1,-800,2015,Ford
349535,2.0,194984.0,4050,2650,62960,12,-1400,2015,Chevrolet
259820,4.0,54592.0,15600,16000,59100,3,400,2015,Chevrolet
506456,1.0,13816.0,10700,4900,80200,1,-5800,2015,Ford
72925,2.9,116014.0,4425,4500,77030,7,75,2015,Ford
296859,3.5,50450.0,9600,9500,59100,2,-100,2015,Chevrolet
227415,1.0,131107.0,1000,250,89090,19,-750,2015,Chevrolet
505795,1.9,154497.0,5400,4600,80610,12,-800,2015,Ford
125949,3.6,50522.0,17000,15400,73100,3,-1600,2015,Ford
526233,3.7,47051.0,16200,13800,70210,3,-2400,2015,Nissan
69986,3.7,68084.0,10600,10700,77030,4,100,2015,Ford
323101,3.6,22715.0,10600,9500,82750,3,-1100,2015,Ford
550035,3.5,116761.0,4725,6100,48460,8,1375,2015,Chevrolet
276887,4.3,37836.0,27800,28100,59100,1,300,2015,Ford
193848,1.9,85013.0,3175,2400,67090,8,-775,2015,Chevrolet
11894,3.5,108324.0,6675,7100,77030,6,425,2014,Nissan
77147,3.5,63856.0,8575,7600,68360,2,-975,2014,Nissan
488049,3.5,17397.0,15800,15500,73130,2,-300,2015,Ford
57441,4.1,60471.0,23900,25000,77030,2,1100,2015,Chevrolet
248952,4.8,80459.0,11200,12900,59100,4,1700,2015,Chevrolet
442637,2.2,90595.0,9575,9100,74430,3,-475,2015,Nissan
333859,3.9,99550.0,12650,12700,82750,9,50,2015,Ford
348194,,149287.0,1150,750,62960,9,-400,2014,Ford
78685,2.0,173519.0,2100,2400,68360,7,300,2014,Chevrolet
26656,4.3,60067.0,15500,17000,77030,4,1500,2015,Ford
547894,4.2,6616.0,25100,27000,78090,1,1900,2015,Ford
19752,4.2,10986.0,15400,14750,77030,1,-650,2015,Nissan
490040,4.0,11740.0,13650,13900,73130,1,250,2015,Chevrolet
180558,2.0,188185.0,1775,1500,83200,9,-275,2015,Nissan
387516,4.3,46212.0,12500,11400,65610,3,-1100,2015,Chevrolet
330270,2.2,38881.0,18250,14200,82750,3,-4050,2015,Ford
405110,2.9,131089.0,3200,2600,61450,8,-600,2015,Ford
53399,3.2,31840.0,19900,22800,77030,4,2900,2015,Ford
137326,2.9,122277.0,9300,9200,73100,10,-100,2015,Nissan
242011,3.4,21725.0,38700,39600,59100,0,900,2015,Ford
31598,3.5,66705.0,24700,26500,77030,3,1800,2015,Ford
8892,2.4,124665.0,17700,15750,77030,3,-1950,2014,Chevrolet
236564,3.4,54974.0,9450,10400,59100,2,950,2014,Chevrolet
278040,2.5,114666.0,5975,6800,59100,14,825,2015,Ford
515143,3.7,68145.0,10950,11400,71660,2,450,2015,Ford
426713,4.1,110965.0,18300,17400,61450,9,-900,2015,Chevrolet
283122,4.5,22143.0,23500,22800,59100,1,-700,2015,Chevrolet
401024,2.0,195463.0,1525,1000,61450,10,-525,2015,Chevrolet
224932,3.6,46623.0,12450,10700,89090,4,-1750,2015,Nissan
483778,4.1,56359.0,23100,23500,73130,2,400,2015,Ford
26750,4.2,34008.0,30600,30100,77030,1,-500,2015,Chevrolet
241098,3.0,42668.0,8775,4400,59100,1,-4375,2014,Chevrolet
490002,4.3,27973.0,17200,17000,73130,3,-200,2015,Ford
201386,4.9,8279.0,17800,23000,57290,0,5200,2014,Nissan
198916,2.5,133650.0,10150,9250,67090,7,-900,2015,Chevrolet
63116,1.0,34456.0,16650,6100,77030,2,-10550,2015,Ford
109994,3.5,35047.0,29600,29000,68360,1,-600,2015,Ford
203849,4.3,17449.0,16100,15300,57290,2,-800,2015,Ford
406932,4.9,24375.0,12050,12200,61450,1,150,2015,Ford
162055,4.4,44718.0,13600,15500,73100,3,1900,2015,Nissan
447281,2.7,12462.0,10600,4400,56120,0,-6200,2015,Nissan
244068,2.3,139591.0,4625,4400,59100,7,-225,2015,Chevrolet
95074,3.5,42107.0,14700,14700,68360,1,0,2015,Ford
125576,3.5,71384.0,21000,24000,73100,4,3000,2015,Ford
84531,4.3,27627.0,10300,11400,68360,2,1100,2015,Chevrolet
73627,,92777.0,21200,18500,68360,5,-2700,2014,Ford
321489,3.5,66408.0,3250,3000,82750,10,-250,2015,Chevrolet
395525,3.4,67546.0,21400,21300,65610,6,-100,2015,Ford
142185,4.9,8160.0,35700,35250,73100,4,-450,2015,Ford
504193,4.0,76363.0,12100,13000,80610,2,900,2015,Ford
248579,4.6,22489.0,21200,20800,59100,2,-400,2015,Ford
292604,4.0,29114.0,11750,11600,59100,1,-150,2015,Chevrolet
439939,4.3,67271.0,13400,12600,74430,6,-800,2015,Nissan
252597,3.0,11715.0,13700,13600,59100,1,-100,2015,Chevrolet
449610,4.4,94132.0,9850,9400,61490,1,-450,2014,Ford
535055,3.1,119260.0,10600,9700,82150,4,-900,2015,Ford
316457,4.2,14777.0,29200,28800,73200,1,-400,2014,Chevrolet
320185,3.3,86957.0,11200,11200,82750,6,0,2015,Ford
457806,4.6,108926.0,11050,10500,61490,3,-550,2015,Ford
549832,3.9,25438.0,25000,27100,48460,2,2100,2015,Ford
181852,3.6,49950.0,13950,14200,83200,3,250,2015,Ford
174177,3.7,32538.0,24600,24300,83200,3,-300,2014,Ford
436229,1.9,154140.0,725,400,74430,16,-325,2015,Nissan
228216,2.4,111484.0,3225,3650,89090,10,425,2015,Chevrolet
300903,4.5,12746.0,31300,29900,59100,2,-1400,2015,Ford
467385,2.8,134071.0,5000,6600,61490,9,1600,2015,Nissan
260907,4.4,23075.0,18100,19800,59100,1,1700,2015,Ford
336544,2.6,37772.0,12000,10600,82750,3,-1400,2015,Nissan
538508,3.8,53550.0,20100,18500,55590,2,-1600,2015,Ford
540148,4.6,20899.0,19500,19500,81400,1,0,2015,Ford
152148,4.3,7554.0,11950,12800,73100,3,850,2015,Chevrolet
450935,3.5,65390.0,13200,13000,61490,4,-200,2014,Nissan
251334,2.9,66402.0,9325,9000,59100,7,-325,2015,Nissan
96076,2.8,129117.0,13550,12200,68360,5,-1350,2015,Ford
538027,3.4,164619.0,3225,2300,55590,10,-925,2015,Nissan
294638,4.3,35268.0,15300,15200,59100,3,-100,2015,Nissan
513756,4.1,16422.0,14150,14900,71660,3,750,2015,Ford
448632,2.7,106844.0,7325,6300,61490,3,-1025,2014,Ford
515474,2.1,134606.0,1100,1550,71660,15,450,2015,Chevrolet
284667,4.6,41365.0,11900,12200,59100,3,300,2015,Nissan
129033,3.8,23881.0,21000,20400,73100,2,-600,2015,Ford
25613,4.4,7665.0,11500,10900,77030,1,-600,2015,Ford
477658,4.9,8104.0,41100,43300,73130,1,2200,2015,Ford
391411,4.8,78145.0,26100,25500,65610,5,-600,2015,Ford
76874,3.1,64803.0,13700,13700,68360,1,0,2014,Ford
296602,3.7,28722.0,10400,11200,59100,2,800,2015,Chevrolet
92287,2.9,103413.0,7325,8400,68360,3,1075,2015,Chevrolet
138890,2.0,52184.0,9975,10400,73100,3,425,2015,Chevrolet
176647,3.6,54564.0,12050,11100,83200,2,-950,2015,Nissan
152214,4.7,12946.0,11900,12400,73100,3,500,2015,Chevrolet
257808,3.6,48181.0,15950,19200,59100,3,3250,2015,Nissan
220292,3.0,73583.0,24500,27200,57290,4,2700,2015,Ford
161972,2.8,28689.0,12050,10700,73100,3,-1350,2015,Nissan
282810,3.2,63746.0,21500,23200,59100,2,1700,2015,Nissan
42859,2.5,118688.0,3400,4000,77030,9,600,2015,Nissan
248466,3.1,41357.0,17750,16600,59100,1,-1150,2015,Ford
454733,1.9,156645.0,4825,4500,61490,14,-325,2015,Ford
478452,4.3,23111.0,11750,12200,73130,2,450,2015,Ford
406467,3.5,96424.0,9625,7500,61450,5,-2125,2015,Nissan
45905,3.6,26163.0,13600,13600,77030,2,0,2015,Nissan
544354,4.3,21565.0,16000,17000,81400,3,1000,2015,Nissan
311573,5.0,15216.0,24900,24600,59100,0,-300,2015,Chevrolet
483360,1.9,82056.0,16900,18000,73130,5,1100,2015,Nissan
257511,4.0,30229.0,18900,17400,59100,2,-1500,2015,Chevrolet
77223,2.2,42018.0,24200,24600,68360,4,400,2015,Ford
401981,4.5,45803.0,8525,9200,61450,4,675,2015,Ford
27252,3.4,124040.0,6925,6800,77030,12,-125,2015,Chevrolet
509181,3.8,36642.0,16900,18200,71660,1,1300,2015,Chevrolet
312943,2.9,174754.0,4125,4300,59100,9,175,2015,Ford
289498,1.9,138225.0,1125,1500,59100,18,375,2015,Ford
249814,4.4,26077.0,19850,19900,59100,1,50,2015,Ford
254231,1.9,135175.0,11050,14200,59100,8,3150,2015,Chevrolet
445162,3.6,13861.0,23500,23600,56120,1,100,2015,Chevrolet
434498,4.3,93616.0,21700,19900,74430,3,-1800,2015,Chevrolet
480459,4.5,7053.0,12350,14900,73130,2,2550,2015,Nissan
185210,1.9,104796.0,1775,700,63250,12,-1075,2015,Ford
223351,2.2,115351.0,825,700,89090,15,-125,2015,Chevrolet
449965,4.9,48835.0,8350,9700,61490,5,1350,2015,Ford
153460,3.7,38074.0,6450,5000,73100,7,-1450,2015,Ford
427226,1.9,90120.0,3600,2600,61450,7,-1000,2015,Chevrolet
397786,3.4,67988.0,5550,6400,61450,4,850,2014,Chevrolet
476561,4.9,25867.0,14700,15000,73130,1,300,2014,Ford
277436,1.9,42228.0,4775,3900,59100,10,-875,2015,Chevrolet
527596,3.6,34306.0,23000,22600,70210,2,-400,2015,Ford
221064,3.5,32013.0,10750,10800,57290,1,50,2015,Ford
112272,1.9,85180.0,10900,8900,68360,3,-2000,2015,Ford
23926,2.0,144507.0,2825,2400,77030,10,-425,2015,Chevrolet
118913,2.5,75053.0,5175,6400,68360,12,1225,2015,Chevrolet
433272,,86760.0,3125,900,74430,11,-2225,2014,Ford
170172,4.1,53419.0,15150,15500,73100,2,350,2015,Chevrolet
26730,4.3,55668.0,9250,8200,77030,5,-1050,2015,Ford
470836,2.1,89655.0,7475,4400,62930,6,-3075,2014,Nissan
251151,4.6,41861.0,11500,12000,59100,3,500,2015,Nissan
431716,2.8,157304.0,500,600,61450,16,100,2015,Ford
51570,4.0,12654.0,17800,18900,77030,1,1100,2015,Ford
227593,1.0,21745.0,9525,5200,89090,2,-4325,2015,Nissan
498326,,40443.0,16200,17600,80610,4,1400,2014,Nissan
246176,4.4,17255.0,19300,16200,59100,1,-3100,2015,Nissan
279769,3.3,138024.0,3775,4200,59100,6,425,2015,Ford
418968,4.3,55854.0,26500,29000,61450,4,2500,2015,Nissan
97021,2.9,49407.0,8125,7000,68360,4,-1125,2015,Ford
466494,2.5,167404.0,9200,9500,61490,8,300,2015,Chevrolet
287074,4.4,60186.0,13850,14600,59100,2,750,2015,Nissan
490198,2.7,20678.0,28600,29000,73130,2,400,2015,Ford
83382,1.0,135872.0,2400,1000,68360,14,-1400,2015,Ford
353503,1.9,95791.0,2975,2800,62960,12,-175,2015,Nissan
466609,3.9,55741.0,11650,11600,61490,3,-50,2015,Ford
287331,3.9,15397.0,12650,13400,59100,1,750,2015,Ford
497465,4.7,10653.0,21700,20750,73130,1,-950,2015,Ford
328394,4.4,29850.0,24600,24800,82750,3,200,2015,Ford
6112,3.0,74982.0,11950,11000,77030,1,-950,2014,Ford
322815,4.4,48095.0,10400,10100,82750,2,-300,2015,Chevrolet
340928,3.5,31199.0,16300,16400,82750,3,100,2015,Nissan
455272,2.8,134001.0,5125,6300,61490,11,1175,2015,Chevrolet
139296,4.2,18024.0,11400,11600,73100,1,200,2015,Chevrolet
418287,2.3,110296.0,7025,6300,61450,4,-725,2015,Chevrolet
439638,2.5,26691.0,13300,12200,74430,1,-1100,2015,Chevrolet
527144,4.3,31222.0,13150,11800,70210,3,-1350,2015,Ford
468453,2.8,130362.0,3325,3900,61490,10,575,2015,Nissan
184050,1.9,120308.0,6350,5400,63250,7,-950,2015,Ford
381421,2.9,34625.0,10300,11500,64520,4,1200,2015,Chevrolet
405149,2.8,87010.0,8025,6600,61450,8,-1425,2015,Nissan
508025,2.8,113731.0,17300,19000,71660,6,1700,2014,Chevrolet
100678,3.7,55488.0,38200,41200,68360,3,3000,2015,Ford
375421,4.9,86875.0,20000,19800,64520,5,-200,2015,Ford
152444,4.4,11999.0,44700,46400,73100,0,1700,2015,Chevrolet
495248,4.1,23252.0,29400,30700,73130,2,1300,2015,Ford
251783,1.9,87174.0,1050,800,59100,16,-250,2015,Chevrolet
6174,3.7,36179.0,12650,14200,77030,1,1550,2014,Chevrolet
230831,3.3,48767.0,11200,11000,89090,2,-200,2015,Chevrolet
304048,1.9,187581.0,4925,3200,59100,13,-1725,2015,Ford
316503,3.7,62050.0,7125,8000,73200,2,875,2014,Ford
113408,2.4,48700.0,12300,11400,68360,3,-900,2015,Nissan
279262,2.7,26247.0,46400,47800,59100,1,1400,2015,Ford
459732,3.0,141730.0,3800,3600,61490,7,-200,2015,Chevrolet
69853,4.1,36048.0,11500,11750,77030,3,250,2015,Nissan
428851,2.8,171292.0,1325,1700,61450,12,375,2015,Chevrolet
99779,2.6,27927.0,14500,13100,68360,2,-1400,2015,Nissan
493236,2.6,94533.0,14850,15400,73130,2,550,2015,Ford
365009,4.1,78010.0,7275,7700,64520,4,425,2015,Chevrolet
297706,3.2,26255.0,17500,15000,59100,3,-2500,2015,Nissan
175445,4.6,22587.0,17500,16900,83200,1,-600,2015,Ford
486881,4.0,6916.0,51300,51250,73130,0,-50,2015,Chevrolet
213814,4.3,32454.0,10150,10100,57290,1,-50,2015,Ford
314728,4.9,13552.0,29200,27900,59100,1,-1300,2015,Chevrolet
187678,2.4,117975.0,8375,7500,63250,7,-875,2015,Nissan
