,condition,odometer,mmr,sellingprice,income,using_time,difference,selling_year,make
146074,4.8,16797.0,12100,13400,73100,3,1300,2015,Chevrolet
321616,1.9,114985.0,1375,1500,82750,14,125,2014,Nissan
258667,4.3,34293.0,11950,12200,59100,3,250,2015,Nissan
129522,2.9,28790.0,12400,13000,73100,3,600,2015,Nissan
404016,4.4,19351.0,18700,18700,61450,1,0,2015,Chevrolet
545554,4.4,23554.0,10900,12400,81400,2,1500,2015,Nissan
60636,4.1,39224.0,9350,10000,77030,1,650,2015,Nissan
14045,2.0,5141.0,23000,5000,77030,1,-18000,2015,Ford
467193,2.5,138502.0,5350,5400,61490,4,50,2015,Chevrolet
201788,4.7,39145.0,12100,14200,57290,2,2100,2014,Nissan
249747,4.8,21298.0,12450,12800,59100,1,350,2015,Ford
202351,2.9,201504.0,1600,1650,57290,12,50,2014,Ford
495049,3.0,27067.0,13300,13200,73130,1,-100,2015,Chevrolet
319047,3.2,38563.0,11900,11900,73200,2,0,2015,Chevrolet
362246,4.2,97726.0,5075,5350,64520,6,275,2014,Ford
77146,2.7,60197.0,14400,13800,68360,2,-600,2014,Nissan
361946,1.0,131809.0,1550,1250,64520,11,-300,2014,Ford
226527,2.6,130060.0,8275,4400,89090,9,-3875,2015,Ford
122715,3.9,44302.0,16600,23500,73100,6,6900,2014,Chevrolet
10247,4.4,43963.0,22900,24800,77030,3,1900,2015,Ford
470085,3.5,79733.0,10100,10200,61490,2,100,2015,Ford
1634,3.7,25317.0,13000,13000,77030,2,0,2014,Nissan
219142,2.3,45942.0,9350,8100,57290,3,-1250,2015,Nissan
113138,3.7,61027.0,11950,11300,68360,2,-650,2015,Ford
306363,4.4,53896.0,12500,13600,59100,4,1100,2015,Chevrolet
389871,1.9,150296.0,2175,2500,65610,11,325,2015,Chevrolet
86641,3.6,17159.0,13350,13200,68360,1,-150,2015,Chevrolet
332867,3.1,37296.0,14050,13500,82750,3,-550,2015,Nissan
386872,3.7,133130.0,1400,1400,65610,12,0,2015,Chevrolet
127380,4.5,38530.0,13250,12600,73100,2,-650,2015,Chevrolet
472808,4.7,50166.0,10500,10500,62930,2,0,2015,Chevrolet
484431,4.0,8276.0,13900,13800,73130,1,-100,2015,Chevrolet
509624,4.1,32918.0,26700,27200,71660,4,500,2015,Ford
389876,2.0,162844.0,900,900,65610,17,0,2015,Chevrolet
116386,2.5,88742.0,8475,9400,68360,8,925,2015,Nissan
531762,2.8,13755.0,19650,17500,82150,1,-2150,2015,Chevrolet
283923,4.6,142154.0,11200,10000,59100,2,-1200,2015,Ford
123848,3.5,10207.0,18450,18200,73100,1,-250,2015,Ford
476673,2.3,15263.0,23700,22000,73130,1,-1700,2014,Nissan
469295,2.2,111623.0,8375,7800,61490,4,-575,2015,Ford
377000,1.9,136242.0,1325,1400,64520,11,75,2015,Ford
108880,3.4,17075.0,20600,20300,68360,0,-300,2015,Ford
474019,3.6,87358.0,7675,7600,62930,4,-75,2015,Chevrolet
139552,4.4,19130.0,17900,17900,73100,4,0,2015,Nissan
346205,4.0,24366.0,17750,17600,82750,3,-150,2015,Nissan
343868,3.7,36568.0,27900,27400,82750,2,-500,2015,Ford
377978,5.0,12741.0,30400,30500,64520,1,100,2015,Chevrolet
278153,4.5,14995.0,27700,29400,59100,2,1700,2015,Ford
132492,3.0,9655.0,15300,15200,73100,1,-100,2015,Chevrolet
457563,3.6,56812.0,9375,9900,61490,4,525,2015,Ford
410413,2.5,53663.0,8925,6300,61450,3,-2625,2015,Nissan
8618,4.2,32608.0,8675,9100,77030,3,425,2015,Ford
480997,2.1,115681.0,2850,2300,73130,12,-550,2015,Ford
84431,4.4,41379.0,24400,25400,68360,7,1000,2015,Chevrolet
336592,3.4,60275.0,10550,10100,82750,3,-450,2015,Nissan
20440,4.5,65382.0,13050,13600,77030,3,550,2015,Ford
545954,4.4,18830.0,11150,12500,81400,2,1350,2015,Nissan
502068,2.4,112288.0,9300,9000,80610,7,-300,2015,Chevrolet
439247,1.9,121839.0,3200,5500,74430,17,2300,2015,Ford
349455,4.1,66625.0,11000,11400,62960,1,400,2014,Ford
226937,2.8,58196.0,8650,6300,89090,3,-2350,2015,Ford
82826,2.5,83965.0,15200,13100,68360,3,-2100,2015,Ford
462933,3.7,77157.0,15250,15300,61490,6,50,2015,Chevrolet
458762,1.9,201847.0,825,700,61490,14,-125,2015,Nissan
250441,2.6,141405.0,3575,2500,59100,8,-1075,2015,Chevrolet
168813,4.4,50085.0,15100,15400,73100,3,300,2015,Nissan
264783,4.0,17841.0,12450,12600,59100,1,150,2015,Chevrolet
181279,4.4,12331.0,21300,21250,83200,1,-50,2015,Chevrolet
249979,3.8,10309.0,12000,10800,59100,0,-1200,2015,Nissan
395282,4.0,21099.0,21300,20500,65610,0,-800,2015,Chevrolet
179725,4.2,159938.0,11650,13000,83200,8,1350,2015,Chevrolet
83856,2.9,91378.0,6200,7200,68360,6,1000,2015,Chevrolet
14678,2.0,30899.0,16000,15000,77030,3,-1000,2015,Chevrolet
149385,3.9,88536.0,6725,9600,73100,9,2875,2015,Nissan
276171,3.6,34224.0,13450,14000,59100,3,550,2015,Nissan
113415,3.5,28592.0,17000,16800,68360,3,-200,2015,Nissan
509490,4.3,11908.0,12650,12500,71660,1,-150,2015,Ford
242775,4.7,36879.0,13550,16200,59100,4,2650,2015,Nissan
201638,4.1,22018.0,27300,27000,57290,1,-300,2014,Nissan
373053,3.8,48747.0,8900,9300,64520,5,400,2015,Chevrolet
374888,3.5,117453.0,2400,2800,64520,9,400,2015,Ford
416921,4.7,4602.0,11450,10900,61450,1,-550,2015,Nissan
465182,2.7,83858.0,10600,9900,61490,3,-700,2015,Ford
391867,4.2,16593.0,20200,20500,65610,2,300,2015,Ford
137190,3.5,34172.0,9325,8300,73100,2,-1025,2015,Ford
179145,4.8,46310.0,17500,18100,83200,3,600,2015,Ford
83250,3.0,99247.0,3925,3500,68360,9,-425,2015,Ford
473431,3.5,160991.0,23500,22750,62930,5,-750,2015,Chevrolet
107000,3.5,31448.0,13200,13300,68360,1,100,2015,Ford
70907,4.5,98377.0,20700,19000,77030,4,-1700,2015,Chevrolet
519377,2.9,101883.0,6125,7500,71660,8,1375,2015,Ford
47609,4.4,23679.0,22500,23300,77030,2,800,2015,Ford
526502,2.9,82542.0,3775,2500,70210,11,-1275,2015,Ford
200900,4.3,19076.0,26800,23300,67090,5,-3500,2015,Ford
508318,3.9,40444.0,20600,20100,71660,1,-500,2014,Ford
198326,4.9,38980.0,20700,21100,67090,6,400,2015,Ford
200863,1.9,107211.0,525,300,67090,18,-225,2015,Ford
427334,2.9,26074.0,10150,8500,61450,1,-1650,2015,Nissan
448223,4.4,36218.0,20700,18000,56120,11,-2700,2015,Chevrolet
483098,4.7,29394.0,14650,15000,73130,3,350,2015,Ford
545575,3.9,23801.0,9025,9700,81400,2,675,2015,Nissan
550376,2.8,156431.0,8100,8200,54620,5,100,2015,Chevrolet
117021,3.5,42490.0,7575,7100,68360,6,-475,2015,Ford
136891,4.9,42928.0,13800,15200,73100,6,1400,2015,Nissan
70545,4.4,42849.0,11150,11250,77030,2,100,2015,Nissan
9826,1.0,36381.0,10750,6000,77030,1,-4750,2014,Chevrolet
297709,4.2,15752.0,8250,8500,59100,3,250,2015,Nissan
208990,4.8,37613.0,16450,18500,57290,5,2050,2015,Ford
513283,3.2,84018.0,18300,17000,71660,7,-1300,2015,Chevrolet
334589,2.7,102008.0,4675,4300,82750,9,-375,2015,Nissan
514573,3.1,64770.0,20900,18000,71660,4,-2900,2015,Chevrolet
201580,4.8,18672.0,14700,15700,57290,1,1000,2014,Nissan
144416,5.0,3068.0,16850,16600,73100,1,-250,2015,Ford
411711,2.1,141931.0,4350,3800,61450,5,-550,2015,Chevrolet
526379,4.3,22383.0,17650,17800,70210,2,150,2015,Ford
548897,4.8,134484.0,10300,9000,48460,9,-1300,2015,Chevrolet
425892,3.6,151038.0,2725,3700,61450,14,975,2015,Chevrolet
480186,4.2,37387.0,29000,29000,73130,1,0,2015,Ford
401702,4.0,89089.0,12050,15200,61450,5,3150,2015,Chevrolet
202124,3.2,36295.0,8475,10500,57290,4,2025,2014,Chevrolet
539197,2.0,82755.0,7400,5700,55590,7,-1700,2015,Ford
71401,3.6,52361.0,8950,8800,77030,2,-150,2015,Ford
346185,1.9,37030.0,11450,9300,82750,3,-2150,2015,Nissan
499917,3.6,41655.0,28300,27800,80610,1,-500,2015,Ford
409896,1.9,169777.0,12600,10200,61450,6,-2400,2015,Chevrolet
327366,2.8,39410.0,20400,19100,82750,3,-1300,2015,Ford
413356,4.5,58159.0,41900,40600,61450,2,-1300,2015,Ford
485420,4.6,25268.0,28500,30500,73130,2,2000,2015,Ford
210649,4.9,27195.0,20700,20800,57290,2,100,2015,Ford
546949,2.0,102064.0,6975,7500,81400,12,525,2015,Ford
156283,3.2,39327.0,16000,16900,73100,3,900,2015,Nissan
146217,3.5,44295.0,9975,9700,73100,4,-275,2015,Chevrolet
496020,4.0,27458.0,12950,14000,73130,1,1050,2015,Chevrolet
431870,5.0,1457.0,57600,54100,61450,2,-3500,2015,Ford
90782,2.6,40364.0,9900,8300,68360,4,-1600,2015,Chevrolet
366513,3.9,29588.0,15250,14500,64520,1,-750,2015,Ford
494354,3.5,24118.0,15400,14400,73130,2,-1000,2015,Nissan
384651,2.9,36601.0,17300,15700,65610,5,-1600,2015,Ford
506170,2.7,114487.0,8075,9900,80200,4,1825,2014,Ford
131044,2.2,46902.0,9275,6700,73100,4,-2575,2015,Chevrolet
270054,2.8,25395.0,14050,14200,59100,3,150,2015,Nissan
346389,2.0,172076.0,4125,3150,82750,7,-975,2015,Nissan
284270,4.9,12218.0,15500,15800,59100,2,300,2015,Nissan
141792,4.6,72889.0,18200,18800,73100,7,600,2015,Chevrolet
249870,4.9,14753.0,21000,21900,59100,1,900,2015,Ford
220311,3.4,92174.0,16150,17900,57290,6,1750,2015,Chevrolet
549144,4.0,104125.0,13950,12100,48460,5,-1850,2015,Ford
385244,2.5,150360.0,9425,6900,65610,7,-2525,2015,Ford
279656,4.4,77292.0,9425,10600,59100,3,1175,2015,Nissan
162320,4.7,21587.0,17550,18900,73100,3,1350,2015,Nissan
479019,4.6,23178.0,21100,22300,73130,2,1200,2015,Ford
132258,4.4,36625.0,23000,23900,73100,2,900,2015,Ford
208137,4.4,37217.0,15400,15300,57290,1,-100,2015,Ford
38204,4.4,30646.0,27500,26000,77030,1,-1500,2015,Chevrolet
371402,3.3,103889.0,6925,7600,64520,4,675,2015,Ford
389953,3.7,22949.0,22600,23300,65610,2,700,2015,Ford
334702,3.5,61084.0,9675,8500,82750,3,-1175,2015,Chevrolet
9146,3.2,111794.0,9025,9000,77030,6,-25,2014,Ford
10083,4.4,27039.0,14100,13750,77030,1,-350,2014,Nissan
103642,2.2,98217.0,3825,4600,68360,8,775,2015,Chevrolet
247517,3.9,46558.0,23900,24900,59100,3,1000,2015,Chevrolet
491190,3.0,11732.0,20100,20600,73130,1,500,2015,Chevrolet
314731,4.3,10042.0,11850,12100,59100,1,250,2015,Chevrolet
218954,4.8,5452.0,43900,43750,57290,3,-150,2015,Ford
487560,4.7,9055.0,13550,14500,73130,3,950,2015,Ford
445305,2.4,169348.0,850,1500,56120,12,650,2015,Ford
205669,4.9,13873.0,22100,23300,57290,1,1200,2015,Ford
225997,3.6,90807.0,8125,8600,89090,7,475,2015,Ford
338720,2.8,40720.0,12850,12800,82750,2,-50,2015,Nissan
32561,5.0,18501.0,28100,27500,77030,1,-600,2015,Ford
454153,3.3,112986.0,11800,11900,61490,2,100,2015,Ford
170608,3.2,48069.0,11400,11200,73100,2,-200,2015,Nissan
328715,2.3,44897.0,5750,4700,82750,6,-1050,2015,Nissan
395356,4.0,45578.0,10800,10900,65610,1,100,2015,Chevrolet
491325,4.9,33309.0,14000,14500,73130,3,500,2015,Ford
102273,3.7,34783.0,24100,26000,68360,4,1900,2015,Ford
92477,4.1,36412.0,18800,18000,68360,4,-800,2015,Ford
438504,4.4,17710.0,28300,27500,74430,1,-800,2015,Ford
180595,2.9,90440.0,7025,5700,83200,3,-1325,2015,Ford
66240,3.7,35972.0,14100,15250,77030,3,1150,2015,Nissan
157051,3.4,56771.0,8675,8400,73100,2,-275,2015,Ford
427209,2.8,115795.0,7675,7800,61450,6,125,2015,Chevrolet
105212,2.7,14363.0,17600,17300,68360,1,-300,2015,Ford
338318,4.2,121399.0,5225,5000,82750,11,-225,2015,Ford
421700,2.7,13802.0,29100,31200,61450,1,2100,2015,Chevrolet
488440,4.3,18957.0,13450,14600,73130,3,1150,2015,Nissan
196645,4.4,80395.0,21800,23000,67090,3,1200,2015,Chevrolet
201385,4.2,13.0,18250,18200,57290,0,-50,2014,Nissan
32240,3.8,68677.0,8650,10500,77030,9,1850,2015,Nissan
127652,4.2,27758.0,14750,14600,73100,1,-150,2015,Chevrolet
227147,3.1,83997.0,3925,4600,89090,8,675,2015,Chevrolet
10672,2.4,194750.0,4175,2700,77030,12,-1475,2014,Chevrolet
424620,2.0,1860.0,12400,10800,61450,1,-1600,2015,Chevrolet
112988,2.8,68780.0,16250,14700,68360,3,-1550,2015,Chevrolet
414071,4.0,20454.0,24400,22700,61450,1,-1700,2015,Chevrolet
501209,4.2,59802.0,19450,20300,80610,3,850,2015,Chevrolet
118813,4.6,5561.0,10800,11300,68360,1,500,2015,Ford
226320,4.4,39128.0,16350,14300,89090,1,-2050,2015,Ford
63806,4.9,6423.0,31800,30500,77030,0,-1300,2015,Nissan
526168,3.7,67410.0,12150,12000,70210,4,-150,2015,Ford
