,condition,odometer,mmr,sellingprice,income,using_time,difference,selling_year
475640,,145373.0,5475,5700,73130,8,225,2014
387991,4.1,80402.0,10600,11300,65610,5,700,2015
404863,4.8,40261.0,28900,31800,61450,4,2900,2015
350942,3.5,39847.0,14950,14100,62960,3,-850,2015
32565,3.7,35853.0,18050,18200,77030,1,150,2015
95319,3.4,10175.0,13500,12800,68360,3,-700,2015
7516,3.4,150887.0,2425,1900,77030,12,-525,2015
192209,3.6,68088.0,8825,9000,67090,4,175,2014
80901,2.0,98687.0,7850,5000,68360,7,-2850,2015
463295,4.6,54124.0,9750,9800,61490,5,50,2015
497376,4.0,29867.0,18600,19600,73130,1,1000,2015
18460,1.9,102667.0,23700,23100,77030,7,-600,2015
85031,4.1,34077.0,12050,14000,68360,3,1950,2015
164775,2.3,185307.0,11300,8300,73100,4,-3000,2015
465608,3.5,136194.0,2300,3000,61490,13,700,2015
329677,4.4,23703.0,25300,24700,82750,3,-600,2015
373988,4.9,6185.0,50200,50000,64520,0,-200,2015
536873,3.9,110023.0,11100,9700,73640,2,-1400,2015
17379,4.4,6107.0,17400,17000,77030,1,-400,2015
234894,,117796.0,4350,5300,59100,9,950,2014
213821,5.0,13320.0,29000,33500,57290,1,4500,2015
291752,3.5,15573.0,22800,22800,59100,3,0,2015
64407,1.9,255443.0,650,1600,77030,11,950,2015
336451,2.8,21328.0,19050,18400,82750,3,-650,2015
395058,5.0,39544.0,21600,20600,65610,5,-1000,2015
398612,,118755.0,3475,2400,61450,11,-1075,2014
481183,3.9,20521.0,19600,19400,73130,1,-200,2015
429285,4.2,20667.0,17950,17000,61450,0,-950,2015
253396,4.4,17910.0,23300,24300,59100,2,1000,2015
413665,4.4,67528.0,14800,17700,61450,5,2900,2015
213528,4.5,12362.0,46300,48000,57290,1,1700,2015
530755,3.4,115869.0,4075,3500,82150,7,-575,2015
475574,,113589.0,5175,4000,73130,8,-1175,2014
424409,4.7,33112.0,12850,13000,61450,1,150,2015
315224,3.1,87650.0,3725,4100,59100,7,375,2015
323595,1.9,170411.0,2925,1700,82750,12,-1225,2015
203384,3.9,146093.0,3550,3400,57290,9,-150,2015
319609,3.5,61775.0,26800,28200,73200,4,1400,2015
433926,2.7,52575.0,10800,8200,74430,2,-2600,2014
523835,2.5,99826.0,6625,10800,71660,9,4175,2015
223328,2.0,197019.0,1500,1200,89090,13,-300,2015
88010,4.7,10833.0,15100,16100,68360,1,1000,2015
183130,,102642.0,1075,800,63250,11,-275,2014
107755,2.7,51780.0,24000,25000,68360,3,1000,2015
343882,4.2,46441.0,8100,7700,82750,2,-400,2015
435781,1.8,75297.0,11300,9500,74430,8,-1800,2015
516988,4.9,3755.0,13300,12100,71660,1,-1200,2015
281194,2.5,144053.0,6125,2200,59100,5,-3925,2015
16620,4.4,20771.0,21500,21000,77030,4,-500,2015
137999,4.1,46612.0,10300,10400,73100,3,100,2015
436230,1.9,178763.0,1300,500,74430,16,-800,2015
32212,3.6,70757.0,6200,5400,77030,9,-800,2015
35982,2.7,35234.0,14200,14200,77030,1,0,2015
464262,2.8,104640.0,8675,8300,61490,4,-375,2015
537156,3.5,98588.0,10450,10500,73640,10,50,2015
365279,5.0,17994.0,44200,43700,64520,1,-500,2015
6436,1.0,24236.0,9950,6700,77030,1,-3250,2014
548626,3.6,104619.0,3425,5500,48460,8,2075,2015
532620,1.9,94334.0,1025,1200,82150,17,175,2015
539164,2.8,176466.0,3325,4250,55590,10,925,2015
501970,2.9,40216.0,11100,11500,80610,2,400,2015
311923,4.1,24629.0,29400,29800,59100,2,400,2015
319825,3.6,81069.0,14950,16100,73200,7,1150,2015
502831,4.5,33191.0,9775,10300,80610,3,525,2015
296098,4.8,32812.0,16800,17600,59100,3,800,2015
291388,3.9,23217.0,23400,25600,59100,3,2200,2015
126978,4.0,9915.0,19700,19700,73100,1,0,2015
392317,4.8,101302.0,4725,5900,65610,9,1175,2015
405152,2.4,128762.0,3900,3300,61450,8,-600,2015
318199,3.8,107778.0,5900,9200,73200,10,3300,2015
40880,2.9,42589.0,11000,11800,77030,2,800,2015
473947,3.7,31089.0,13400,13200,62930,1,-200,2015
314214,3.7,36052.0,21600,23000,59100,3,1400,2015
155873,3.8,33052.0,16950,16300,73100,1,-650,2015
270401,2.6,73228.0,7750,7200,59100,6,-550,2015
358693,4.2,25477.0,14600,14500,62960,1,-100,2015
359948,4.2,25623.0,43100,42800,62960,1,-300,2015
307918,2.7,97345.0,1975,1600,59100,12,-375,2015
499427,3.8,17593.0,15450,15500,80610,1,50,2015
370360,3.7,51134.0,36500,36000,64520,3,-500,2015
401304,5.0,20636.0,13650,14000,61450,1,350,2015
64490,3.5,38145.0,8200,9000,77030,2,800,2015
74769,,202138.0,8400,10500,68360,11,2100,2014
146881,4.7,51410.0,27800,24700,73100,2,-3100,2015
53819,4.4,36822.0,13750,14750,77030,2,1000,2015
78208,3.4,85184.0,13650,14900,68360,5,1250,2015
285026,1.9,92129.0,12200,7500,59100,7,-4700,2015
445023,4.2,130014.0,8575,8400,56120,4,-175,2015
220261,4.9,15637.0,38300,39100,57290,2,800,2015
229158,4.2,20561.0,8725,8900,89090,2,175,2015
1089,2.9,45664.0,17750,19500,77030,2,1750,2014
27247,3.5,97571.0,5325,5400,77030,12,75,2015
317821,3.9,34975.0,34600,34200,73200,1,-400,2015
95387,2.5,70207.0,8225,4700,68360,4,-3525,2015
79853,2.1,56227.0,10700,7700,68360,5,-3000,2015
486732,4.9,6231.0,18550,19200,73130,1,650,2015
85611,3.4,25039.0,11050,10500,68360,2,-550,2015
305517,4.7,15687.0,14100,14200,59100,1,100,2015
354545,4.1,36100.0,18750,20250,62960,4,1500,2015
389860,3.5,115283.0,11950,9000,65610,8,-2950,2015
301538,4.3,14065.0,12350,12800,59100,3,450,2015
66068,3.4,59569.0,30100,30000,77030,2,-100,2015
135879,3.7,94654.0,15100,15300,73100,7,200,2015
350805,1.0,36129.0,11200,6000,62960,4,-5200,2015
29300,4.1,36336.0,23000,24900,77030,2,1900,2015
474933,4.3,36689.0,16750,16200,73130,3,-550,2014
127598,3.6,63142.0,13750,13000,73100,3,-750,2015
38480,4.1,61940.0,13600,13500,77030,3,-100,2015
355322,3.9,8837.0,39600,39000,62960,0,-600,2015
67079,1.0,43548.0,12300,8800,77030,2,-3500,2015
429383,4.1,38288.0,12950,12600,61450,1,-350,2015
270559,2.0,97731.0,2050,2500,59100,11,450,2015
371964,3.8,22090.0,14700,14500,64520,2,-200,2015
346626,4.9,16559.0,21100,22400,82750,1,1300,2015
76697,3.5,162119.0,3900,3600,68360,12,-300,2014
169643,3.9,113457.0,6225,9700,73100,9,3475,2015
181908,3.6,86489.0,9350,9700,83200,5,350,2015
220914,5.0,40693.0,28700,31400,57290,3,2700,2015
104892,1.9,77245.0,10600,8800,68360,4,-1800,2015
255690,3.3,56524.0,16750,16600,59100,4,-150,2015
482768,1.9,46323.0,8275,6500,73130,6,-1775,2015
541416,5.0,14658.0,42900,41800,81400,1,-1100,2015
516477,3.6,17348.0,13950,13000,71660,1,-950,2015
143791,3.2,5209.0,28900,26000,73100,3,-2900,2015
300947,3.2,22087.0,13850,13900,59100,2,50,2015
147022,3.1,23532.0,14200,12200,73100,3,-2000,2015
184456,2.8,164528.0,4300,5000,63250,9,700,2015
541417,3.8,81699.0,6825,7000,81400,5,175,2015
163685,4.9,35961.0,40300,43400,73100,3,3100,2015
277771,3.3,156986.0,6175,6600,59100,4,425,2015
466285,4.6,36882.0,15200,13500,61490,1,-1700,2015
485728,3.4,27674.0,15400,15100,73130,2,-300,2015
6571,3.6,19669.0,44800,43500,77030,2,-1300,2014
480545,1.9,145415.0,3375,2900,73130,10,-475,2015
40664,4.2,17114.0,28300,25000,77030,1,-3300,2015
224027,2.4,93215.0,12450,12300,89090,7,-150,2015
298266,4.4,18515.0,19950,20300,59100,4,350,2015
295484,4.1,22564.0,11300,11200,59100,2,-100,2015
438872,2.3,135901.0,2125,2600,74430,15,475,2015
61894,3.8,27208.0,10600,9750,77030,2,-850,2015
263088,4.3,28432.0,35600,35400,59100,3,-200,2015
402039,4.1,69864.0,15250,15000,61450,4,-250,2015
167723,4.8,7543.0,24800,23400,73100,1,-1400,2015
47966,4.9,48697.0,14100,15900,77030,3,1800,2015
209358,2.5,98659.0,21100,20100,57290,7,-1000,2015
321567,3.4,63096.0,7675,7700,82750,3,25,2014
122100,1.9,38668.0,17650,14900,73100,2,-2750,2014
97086,2.8,51809.0,12400,8800,68360,5,-3600,2015
137666,4.3,19014.0,16450,14300,73100,1,-2150,2015
355008,5.0,5172.0,97000,88000,62960,1,-9000,2015
256039,3.9,30930.0,28400,26800,59100,4,-1600,2015
229088,2.0,226966.0,4625,1700,89090,10,-2925,2015
52284,4.1,74976.0,6575,9000,77030,9,2425,2015
70466,3.7,31789.0,12450,11000,77030,2,-1450,2015
229607,2.7,75464.0,8375,7300,89090,4,-1075,2015
18528,1.9,370139.0,550,2350,77030,15,1800,2015
421477,4.1,133013.0,12950,13400,61450,7,450,2015
171217,1.9,48084.0,11500,8600,73100,3,-2900,2015
268794,3.4,96589.0,16050,18600,59100,6,2550,2015
36013,4.0,42153.0,10400,9700,77030,2,-700,2015
540310,1.0,111329.0,4600,1100,81400,9,-3500,2015
235242,,101233.0,1750,2900,59100,10,1150,2014
70856,3.6,86152.0,7100,6500,77030,3,-600,2015
337524,2.5,48913.0,5675,5400,82750,7,-275,2015
509607,2.7,32181.0,16650,15500,71660,3,-1150,2015
86504,1.9,104697.0,24900,21600,68360,4,-3300,2015
316159,4.3,84208.0,8650,9900,73200,7,1250,2014
82848,3.7,33549.0,14450,15300,68360,3,850,2015
79837,4.6,61076.0,13250,12800,68360,4,-450,2015
483807,3.7,65844.0,11450,11300,73130,2,-150,2015
267864,3.7,69610.0,22300,20600,59100,6,-1700,2015
312643,4.2,71928.0,10800,10700,59100,4,-100,2015
251734,1.9,93962.0,9225,10600,59100,10,1375,2015
109155,2.7,43730.0,33200,32000,68360,3,-1200,2015
536118,2.1,103792.0,4175,4200,82150,10,25,2015
439462,1.9,128951.0,1725,3100,74430,10,1375,2015
331868,3.4,30308.0,40800,39250,82750,3,-1550,2015
498028,2.8,70316.0,12950,11800,73130,2,-1150,2015
154351,3.9,29204.0,13200,12500,73100,4,-700,2015
550127,3.6,68889.0,13700,15300,48460,3,1600,2015
124640,2.3,89344.0,5300,6900,73100,9,1600,2015
38039,4.0,60193.0,9500,13450,77030,2,3950,2015
418199,4.7,28830.0,13750,14400,61450,3,650,2015
494713,2.5,54875.0,9850,10000,73130,2,150,2015
61641,3.4,56555.0,30500,30000,77030,3,-500,2015
139781,1.9,135043.0,3250,2600,73100,11,-650,2015
208050,1.9,98646.0,10750,8000,57290,4,-2750,2015
310724,3.4,57391.0,29900,28000,59100,7,-1900,2015
257689,3.9,52254.0,19250,19001,59100,3,-249,2015
188490,4.3,78479.0,16150,15800,63250,2,-350,2015
100647,4.5,57114.0,32800,33250,68360,1,450,2015
246658,2.1,115714.0,4475,5100,59100,8,625,2015
355142,2.0,124330.0,1300,850,62960,10,-450,2015
377518,4.0,24888.0,15300,16400,64520,3,1100,2015
204266,2.7,68895.0,7875,6100,57290,8,-1775,2015
112931,1.9,163072.0,2950,3200,68360,11,250,2015
533055,3.2,88212.0,13550,11300,82150,7,-2250,2015
464438,2.9,161329.0,1875,3000,61490,14,1125,2015
542153,3.6,185851.0,2425,3000,81400,12,575,2015
220796,2.5,90958.0,11900,10800,57290,7,-1100,2015
147736,3.4,50474.0,22100,21700,73100,3,-400,2015
354522,4.6,15305.0,7975,8500,62960,3,525,2015
388490,2.9,47961.0,24600,22500,65610,2,-2100,2015
216454,4.2,22862.0,16150,15700,57290,1,-450,2015
35065,4.0,38170.0,10650,11100,77030,2,450,2015
355154,2.0,164395.0,1400,300,62960,11,-1100,2015
258489,4.2,33142.0,28500,29600,59100,3,1100,2015
378038,4.5,4158.0,17350,17100,64520,2,-250,2015
136214,2.6,21593.0,12650,11300,73100,3,-1350,2015
138480,2.6,43255.0,15850,15100,73100,3,-750,2015
194115,1.0,20317.0,21800,13800,67090,1,-8000,2015
1741,4.3,31315.0,19850,20750,77030,3,900,2014
280230,3.2,35869.0,16400,17100,59100,2,700,2015
360218,4.5,27122.0,42800,44250,62960,1,1450,2015
75680,3.3,18800.0,29300,26750,68360,2,-2550,2014
95189,3.9,24368.0,14250,15200,68360,2,950,2015
158835,2.8,47186.0,3175,4400,73100,13,1225,2015
201081,3.1,35542.0,19400,17600,57290,3,-1800,2014
341309,4.2,23369.0,14550,15100,82750,2,550,2015
476546,2.8,26945.0,11200,11400,73130,1,200,2014
539765,1.2,73290.0,3300,1600,81400,8,-1700,2014
367872,4.6,7278.0,35700,39000,64520,1,3300,2015
254482,1.9,187322.0,950,1000,59100,14,50,2015
18779,3.6,30901.0,13850,13750,77030,2,-100,2015
270881,4.0,13405.0,18700,19000,59100,1,300,2015
343095,3.6,21781.0,13100,12900,82750,2,-200,2015
218299,4.6,9049.0,14950,16600,57290,2,1650,2015
107664,2.1,14920.0,17400,14000,68360,1,-3400,2015
444408,4.2,106823.0,11200,10900,56120,7,-300,2015
405028,3.7,119598.0,15350,13100,61450,7,-2250,2015
453322,3.7,108891.0,4100,4700,61490,10,600,2015
343376,4.8,29328.0,11700,13000,82750,3,1300,2015
452217,2.5,101261.0,7525,7700,61490,9,175,2015
203011,3.7,38954.0,13250,13600,57290,3,350,2015
411958,1.0,117252.0,9725,5700,61450,8,-4025,2015
429550,3.7,166123.0,7675,8500,61450,7,825,2015
450398,4.8,130597.0,8025,7700,61490,8,-325,2015
516981,3.2,15037.0,21500,20500,71660,1,-1000,2015
396651,4.2,28533.0,29300,28450,65610,1,-850,2015
52586,4.7,22050.0,25700,28500,77030,2,2800,2015
197705,3.7,33478.0,13550,13700,67090,2,150,2015
424491,3.5,77729.0,24900,26000,61450,5,1100,2015
355513,2.1,114665.0,14400,12800,62960,8,-1600,2015
123760,3.3,43031.0,26600,27100,73100,4,500,2015
29373,4.0,43241.0,13000,13250,77030,2,250,2015
275042,4.1,28245.0,10800,11500,59100,3,700,2015
72163,3.8,102921.0,8125,8800,77030,4,675,2015
489488,2.8,59499.0,15350,14100,73130,2,-1250,2015
497871,3.9,31039.0,11350,12300,73130,3,950,2015
110474,2.9,67021.0,19000,7200,68360,5,-11800,2015
415237,4.5,13234.0,12650,13400,61450,1,750,2015
45717,3.0,123274.0,4825,6400,77030,9,1575,2015
193483,1.9,87844.0,6350,6700,67090,6,350,2015
466113,2.9,78616.0,1225,1900,61490,18,675,2015
376769,5.0,18492.0,23200,23900,64520,1,700,2015
406524,2.9,197747.0,625,1300,61450,8,675,2015
133658,3.0,21671.0,16250,16300,73100,1,50,2015
511299,4.7,59938.0,8725,9600,71660,7,875,2015
131608,3.5,44562.0,39700,40250,73100,3,550,2015
280103,3.5,83431.0,10850,11600,59100,4,750,2015
489538,2.6,72793.0,16500,15500,73130,8,-1000,2015
101516,2.3,60356.0,12950,11800,68360,6,-1150,2015
135035,3.9,63697.0,21600,17100,73100,2,-4500,2015
342527,2.0,149881.0,3950,3450,82750,8,-500,2015
401297,4.9,19339.0,13700,13300,61450,1,-400,2015
340794,3.1,79295.0,6700,6600,82750,3,-100,2015
86167,2.6,103070.0,4475,4200,68360,4,-275,2015
227007,1.9,121234.0,10000,4100,89090,4,-5900,2015
501663,4.7,17645.0,13700,12100,80610,3,-1600,2015
190819,2.9,79526.0,17300,17000,63250,2,-300,2015
235578,,201888.0,800,800,59100,12,0,2014
41517,3.8,64607.0,20500,21750,77030,7,1250,2015
377617,2.5,56175.0,9000,8500,64520,2,-500,2015
155125,4.3,21839.0,19400,19250,73100,2,-150,2015
222654,2.9,23140.0,16650,15400,89090,3,-1250,2015
4138,2.0,120961.0,4550,3600,77030,9,-950,2014
18001,3.4,52833.0,17300,16500,77030,5,-800,2015
466480,1.9,258990.0,650,800,61490,12,150,2015
426613,4.1,34588.0,41800,43800,61450,2,2000,2015
428595,2.9,78698.0,10950,10500,61450,8,-450,2015
96980,2.6,67885.0,7925,7300,68360,3,-625,2015
294296,4.2,16042.0,13850,14500,59100,2,650,2015
422962,4.6,37247.0,14200,14800,61450,1,600,2015
24858,4.2,42250.0,13000,13900,77030,2,900,2015
43316,4.0,87385.0,7850,8700,77030,8,850,2015
528084,2.5,54671.0,16250,14100,70210,4,-2150,2015
466729,3.9,31439.0,7950,8900,61490,3,950,2015
5371,4.2,13503.0,14600,13900,77030,0,-700,2014
486348,2.8,130395.0,4675,4400,73130,8,-275,2015
268539,4.2,32250.0,10600,11100,59100,3,500,2015
514210,3.1,110964.0,10950,11500,71660,9,550,2015
293899,4.5,64264.0,13000,13050,59100,2,50,2015
222740,1.0,149019.0,2750,1200,89090,9,-1550,2015
445117,2.0,122390.0,1100,250,56120,14,-850,2015
149075,2.3,1466.0,30500,28000,73100,0,-2500,2015
153315,2.0,122336.0,4925,2200,73100,9,-2725,2015
80715,3.3,51067.0,29200,30700,68360,3,1500,2015
368092,3.6,62411.0,9475,9700,64520,3,225,2015
236243,2.7,10652.0,9625,7700,59100,1,-1925,2014
67362,3.7,7047.0,22800,21750,77030,2,-1050,2015
494964,1.9,29169.0,9225,7000,73130,3,-2225,2015
127036,3.0,22443.0,16750,15800,73100,1,-950,2015
262618,4.0,40167.0,8500,9800,59100,4,1300,2015
460877,2.2,143954.0,1375,1700,61490,11,325,2015
118742,1.9,117839.0,10000,5600,68360,8,-4400,2015
134561,3.7,25670.0,9425,9200,73100,4,-225,2015
428759,3.7,68696.0,8275,8100,61450,4,-175,2015
546529,2.4,32275.0,29700,29500,81400,3,-200,2015
390401,4.1,54050.0,10400,10400,65610,2,0,2015
292777,3.4,57044.0,9250,9000,59100,2,-250,2015
502019,4.2,81607.0,10450,11900,80610,3,1450,2015
130217,4.1,16056.0,18350,17400,73100,3,-950,2015
304867,4.4,52652.0,15600,16100,59100,2,500,2015
310955,1.9,106352.0,4000,3300,59100,8,-700,2015
347850,2.0,17351.0,16350,13100,62960,0,-3250,2014
33164,3.9,25089.0,15550,5500,77030,3,-10050,2015
329872,2.2,35941.0,20600,18500,82750,3,-2100,2015
486727,2.6,132825.0,3325,2700,73130,12,-625,2015
281978,3.3,143172.0,12950,13100,59100,8,150,2015
313754,2.6,63703.0,8450,8400,59100,2,-50,2015
264189,1.9,62186.0,7025,4600,59100,5,-2425,2015
421468,2.9,109359.0,11150,11100,61450,6,-50,2015
326848,1.9,76677.0,16050,12800,82750,7,-3250,2015
517610,4.2,19398.0,14450,15000,71660,2,550,2015
359620,4.2,56570.0,14200,15000,62960,2,800,2015
190499,2.7,38417.0,14250,13800,63250,3,-450,2015
91945,3.6,37350.0,18500,18300,68360,2,-200,2015
65008,4.6,7335.0,28400,27500,77030,0,-900,2015
253148,3.0,126761.0,2200,2000,59100,9,-200,2015
66997,2.3,245513.0,1150,2200,77030,15,1050,2015
196439,4.6,12018.0,14200,13800,67090,1,-400,2015
141170,2.3,88729.0,9075,7700,73100,7,-1375,2015
411953,3.5,34098.0,13350,13800,61450,1,450,2015
270096,2.5,34498.0,11950,10000,59100,3,-1950,2015
243461,3.7,29389.0,12700,13700,59100,3,1000,2015
156533,3.9,69085.0,23000,22200,73100,2,-800,2015
26536,3.9,44645.0,19550,22500,77030,3,2950,2015
303818,2.0,171833.0,7675,6400,59100,6,-1275,2015
259346,3.4,14985.0,11100,9600,59100,1,-1500,2015
1519,4.2,31852.0,21600,21250,77030,2,-350,2014
445232,1.9,143876.0,6975,8000,56120,10,1025,2015
97445,3.7,34056.0,16250,17000,68360,2,750,2015
343932,2.7,35423.0,11000,10100,82750,3,-900,2015
217311,3.9,60043.0,10650,11400,57290,3,750,2015
248256,3.4,175029.0,1925,1400,59100,13,-525,2015
61807,4.2,24506.0,33600,36500,77030,2,2900,2015
171201,3.9,31682.0,8600,9600,73100,3,1000,2015
460212,3.9,45736.0,21700,21700,61490,3,0,2015
111733,2.3,137395.0,5675,3600,68360,10,-2075,2015
301497,5.0,35686.0,12750,13400,59100,3,650,2015
13641,2.6,63207.0,8300,8100,77030,3,-200,2015
217738,4.4,35153.0,23600,13100,57290,2,-10500,2015
54700,2.6,104579.0,6225,6400,77030,6,175,2015
297046,4.0,165517.0,4000,5200,59100,9,1200,2015
184352,4.1,106226.0,7125,8900,63250,10,1775,2015
541512,5.0,12330.0,23300,21500,81400,2,-1800,2015
208388,4.2,17521.0,15800,14600,57290,1,-1200,2015
425016,2.2,120196.0,6975,7100,61450,8,125,2015
472589,4.8,42891.0,26100,27500,62930,2,1400,2015
176198,4.5,66139.0,5300,6700,83200,6,1400,2015
471061,2.8,112578.0,4800,4700,62930,6,-100,2015
330645,4.1,21507.0,17700,17200,82750,4,-500,2015
327663,2.9,47014.0,8475,7000,82750,3,-1475,2015
63571,3.6,7948.0,12250,12900,77030,2,650,2015
281529,3.3,56062.0,10850,12000,59100,3,1150,2015
137968,4.0,19248.0,13650,13900,73100,1,250,2015
141349,2.5,144091.0,1675,2600,73100,13,925,2015
16322,4.6,25039.0,18750,20500,77030,3,1750,2015
175655,4.7,37114.0,17100,18000,83200,3,900,2015
451128,3.6,92357.0,10400,11400,61490,5,1000,2015
227930,2.7,104042.0,17900,15700,89090,4,-2200,2015
342299,1.0,19805.0,16550,7500,82750,1,-9050,2015
294346,3.0,20279.0,14950,14800,59100,1,-150,2015
299166,4.3,20308.0,15000,15600,59100,1,600,2015
431884,4.1,82562.0,10800,12100,61450,3,1300,2015
404334,3.0,83159.0,16250,15300,61450,7,-950,2015
5550,4.9,7067.0,15750,16700,77030,0,950,2014
68122,2.7,78793.0,27700,26000,77030,4,-1700,2015
240530,1.9,94241.0,5150,4800,59100,7,-350,2014
362724,4.2,12891.0,18100,18200,64520,1,100,2014
372866,3.0,110533.0,4875,5000,64520,7,125,2015
431577,2.8,28423.0,28000,27000,61450,1,-1000,2015
496082,5.0,11732.0,23400,23900,73130,1,500,2015
232582,2.6,112685.0,7275,6500,89090,8,-775,2015
528263,4.4,77930.0,26100,23700,70210,4,-2400,2015
240876,1.9,89525.0,3250,1700,59100,12,-1550,2014
542537,5.0,52931.0,11450,14200,81400,4,2750,2015
7136,2.9,114532.0,13350,10500,77030,8,-2850,2014
381886,3.7,31489.0,26700,25400,64520,3,-1300,2015
238567,1.9,81340.0,5500,4700,59100,9,-800,2014
517898,1.9,79248.0,7450,4900,71660,5,-2550,2015
270752,4.9,28493.0,13950,14600,59100,2,650,2015
308379,4.0,22806.0,22900,22600,59100,1,-300,2015
242682,4.5,99494.0,17550,16700,59100,3,-850,2015
165249,4.0,33324.0,9650,10900,73100,1,1250,2015
285833,4.3,103539.0,6875,9700,59100,10,2825,2015
66114,4.2,45016.0,16800,15500,77030,2,-1300,2015
221461,4.6,16211.0,20100,20700,57290,1,600,2015
66542,2.0,55669.0,13650,9750,77030,2,-3900,2015
234953,1.9,84724.0,1925,2300,59100,9,375,2014
545694,4.0,26710.0,11000,12300,81400,1,1300,2015
112101,3.4,20433.0,31400,30100,68360,2,-1300,2015
458646,2.1,209331.0,2275,1500,61490,12,-775,2015
378805,2.6,22142.0,15450,14600,64520,3,-850,2015
99602,3.4,29775.0,12850,12400,68360,2,-450,2015
433025,1.9,131884.0,5350,4500,74430,9,-850,2014
3613,4.0,62886.0,7325,7100,77030,7,-225,2014
381925,3.5,6182.0,18450,17900,64520,1,-550,2015
426634,4.5,26251.0,16450,16500,61450,3,50,2015
314929,3.8,40449.0,28800,29000,59100,4,200,2015
531915,3.6,24427.0,22600,22300,82150,2,-300,2015
34540,2.7,149650.0,3925,2700,77030,12,-1225,2015
399593,2.9,153346.0,5175,5600,61450,8,425,2014
465294,2.9,127263.0,5225,4800,61490,6,-425,2015
4231,2.7,84469.0,6000,5600,77030,9,-400,2014
491982,3.7,20910.0,37400,37750,73130,0,350,2015
186663,1.9,65013.0,15300,15200,63250,3,-100,2015
443516,4.0,27233.0,17200,17500,74430,1,300,2015
494169,3.1,42883.0,9850,9800,73130,2,-50,2015
496859,3.7,99774.0,9050,8900,73130,3,-150,2015
528110,2.1,110292.0,8875,8000,70210,8,-875,2015
41995,2.6,101947.0,1200,2000,77030,14,800,2015
141553,4.9,4211.0,21100,20600,73100,3,-500,2015
497904,1.9,53904.0,11200,7300,73130,4,-3900,2015
539275,3.7,1.0,13300,600,55590,5,-12700,2015
149102,2.0,2432.0,11600,6800,73100,0,-4800,2015
369046,2.9,35846.0,16300,14900,64520,3,-1400,2015
148760,3.5,31804.0,15300,13100,73100,3,-2200,2015
83068,1.9,119357.0,8750,7600,68360,5,-1150,2015
531275,2.9,119319.0,3350,3650,82150,9,300,2015
7305,,200805.0,3500,2500,77030,10,-1000,2014
60066,2.4,70954.0,10500,9800,77030,2,-700,2015
308481,4.6,37925.0,20900,22600,59100,3,1700,2015
498000,1.9,47139.0,34900,33000,73130,2,-1900,2015
224928,4.7,19530.0,11600,11500,89090,2,-100,2015
111298,3.9,28389.0,24600,25700,68360,4,1100,2015
211801,4.6,13053.0,18400,18600,57290,4,200,2015
45379,4.2,137082.0,5725,8700,77030,14,2975,2015
448042,1.9,1.0,3750,1000,56120,11,-2750,2015
208265,1.9,57067.0,9200,7200,57290,4,-2000,2015
289628,4.5,129089.0,12350,17600,59100,4,5250,2015
175663,2.9,34526.0,13200,12000,83200,1,-1200,2015
18632,4.7,15218.0,13700,14900,77030,1,1200,2015
542031,4.3,84532.0,16550,20700,81400,8,4150,2015
371985,4.5,29585.0,30800,30750,64520,3,-50,2015
218056,4.3,12839.0,28800,27500,57290,2,-1300,2015
651,5.0,18015.0,24400,23700,77030,1,-700,2014
441678,3.7,21882.0,15300,14500,74430,1,-800,2015
78113,2.5,83433.0,5650,7000,68360,5,1350,2015
89818,2.5,109901.0,4800,2100,68360,10,-2700,2015
266522,3.4,70264.0,8150,9200,59100,5,1050,2015
84640,1.9,127852.0,2650,5400,68360,12,2750,2015
519577,4.7,21399.0,20300,20900,71660,1,600,2015
301539,4.1,21797.0,9825,10000,59100,3,175,2015
447952,2.0,193791.0,650,300,56120,14,-350,2015
59328,4.2,39934.0,30400,29750,77030,2,-650,2015
194569,4.1,23813.0,20700,20750,67090,3,50,2015
292047,3.6,29201.0,19750,11900,59100,3,-7850,2015
29785,1.9,60265.0,11800,9000,77030,3,-2800,2015
498962,3.2,112763.0,3225,2600,80610,10,-625,2014
135217,4.3,88273.0,11600,10600,73100,5,-1000,2015
533248,2.5,220412.0,1325,800,82150,15,-525,2015
63114,2.7,55452.0,8900,9000,77030,2,100,2015
234954,2.9,176240.0,2500,3500,59100,9,1000,2014
290244,4.2,29649.0,29100,28400,59100,2,-700,2015
105565,4.3,98850.0,4200,4300,68360,12,100,2015
163296,4.7,16002.0,94000,99000,73100,1,5000,2015
531745,2.4,189186.0,3575,3500,82150,11,-75,2015
413263,3.8,38089.0,21200,22900,61450,1,1700,2015
52455,2.8,111905.0,9825,13750,77030,12,3925,2015
470915,4.4,52364.0,15050,14500,62930,1,-550,2014
298334,3.1,214336.0,4675,5400,59100,9,725,2015
216286,4.5,12426.0,18550,21000,57290,2,2450,2015
343201,4.4,4375.0,48900,48500,82750,0,-400,2015
67568,1.9,83431.0,15350,14700,77030,4,-650,2015
494526,3.0,29875.0,18400,19100,73130,1,700,2015
108799,3.7,78056.0,7975,9100,68360,4,1125,2015
308597,4.6,13946.0,21100,20200,59100,0,-900,2015
255214,3.4,92177.0,5500,5600,59100,6,100,2015
181792,3.6,18202.0,11550,11000,83200,2,-550,2015
233818,,106616.0,19250,17400,59100,6,-1850,2014
168095,4.4,38532.0,20300,20700,73100,3,400,2015
306898,3.6,28785.0,15950,15800,59100,2,-150,2015
328251,4.3,37806.0,38400,37100,82750,4,-1300,2015
108189,2.6,145913.0,14500,18500,68360,4,4000,2015
234784,3.7,89773.0,4925,6300,59100,10,1375,2015
85717,3.6,83689.0,17050,15400,68360,2,-1650,2015
448245,4.8,30089.0,20900,21500,56120,2,600,2015
60935,4.2,22036.0,21600,23000,77030,3,1400,2015
25839,2.9,103187.0,1900,1950,77030,13,50,2015
397196,2.8,49669.0,9600,9600,65610,2,0,2015
443375,4.2,14060.0,17000,17400,74430,1,400,2015
287107,4.0,18535.0,23700,25200,59100,1,1500,2015
175466,4.5,19018.0,17950,19000,83200,2,1050,2015
466097,3.9,161567.0,1725,2000,61490,9,275,2015
199292,4.9,16413.0,19100,19400,67090,0,300,2015
162427,3.7,53220.0,9500,9200,73100,2,-300,2015
128552,4.6,38935.0,15200,16400,73100,4,1200,2015
481637,4.0,40185.0,28000,27500,73130,2,-500,2015
49198,3.2,60103.0,9925,10500,77030,4,575,2015
34298,2.4,124090.0,4075,4000,77030,9,-75,2015
436916,2.8,143217.0,4575,5800,74430,10,1225,2015
434220,5.0,12056.0,17200,17500,74430,1,300,2015
81290,2.6,123125.0,4975,3500,68360,8,-1475,2015
393705,4.9,12795.0,18550,16600,65610,3,-1950,2015
350883,2.7,123838.0,7600,8000,62960,10,400,2015
319714,4.7,49316.0,25300,27700,73200,1,2400,2015
66107,3.4,70874.0,12550,11500,77030,2,-1050,2015
278242,3.8,62724.0,12000,12100,59100,4,100,2015
334525,2.0,53457.0,10450,8600,82750,3,-1850,2015
184379,4.3,37073.0,11700,12200,63250,1,500,2015
197109,1.9,187403.0,925,300,67090,14,-625,2015
471162,3.6,70360.0,7750,9100,62930,11,1350,2015
378218,3.8,99279.0,7200,8100,64520,7,900,2015
253655,4.8,51581.0,41600,39500,59100,3,-2100,2015
52160,2.4,118913.0,7525,8900,77030,7,1375,2015
384855,3.7,48618.0,17050,17900,65610,3,850,2015
205144,4.3,15767.0,16700,18000,57290,2,1300,2015
92105,5.0,7322.0,14000,15800,68360,2,1800,2015
351982,4.3,11388.0,20200,19250,62960,2,-950,2015
497932,4.3,52481.0,8375,6000,73130,7,-2375,2015
411110,3.3,29180.0,23900,23500,61450,2,-400,2015
266217,3.5,40761.0,7775,8500,59100,3,725,2015
105583,3.7,40809.0,16200,16500,68360,1,300,2015
532178,2.1,34512.0,13250,12200,82150,2,-1050,2015
522832,4.0,27327.0,10600,10800,71660,4,200,2015
307563,4.0,31378.0,15400,15500,59100,3,100,2015
245884,4.4,13908.0,23600,24400,59100,1,800,2015
536502,3.9,61538.0,8100,9100,73640,4,1000,2015
225995,2.1,126200.0,5375,6200,89090,7,825,2015
534879,2.7,108498.0,7825,4900,82150,11,-2925,2015
545112,3.9,28622.0,13150,13200,81400,1,50,2015
506592,3.5,50774.0,22200,19900,80200,3,-2300,2015
398399,2.0,196212.0,2550,3500,61450,9,950,2014
72945,4.1,84554.0,10200,12250,77030,8,2050,2015
433875,1.9,215413.0,900,400,74430,10,-500,2015
112846,3.7,51050.0,9150,9300,68360,2,150,2015
201755,3.5,19328.0,23800,22900,57290,2,-900,2014
360121,3.1,23858.0,28100,26250,62960,3,-1850,2015
48973,5.0,63705.0,17250,23750,77030,9,6500,2015
287572,2.0,38157.0,11350,8400,59100,1,-2950,2015
95362,4.4,13974.0,10950,10400,68360,3,-550,2015
529591,3.5,95191.0,9000,7900,82150,6,-1100,2014
485810,4.5,10902.0,19550,20800,73130,3,1250,2015
460782,3.5,92016.0,23000,18600,61490,7,-4400,2015
531472,3.8,41914.0,16900,17300,82150,2,400,2015
471135,3.2,116573.0,4150,5300,62930,10,1150,2015
348312,1.9,109629.0,1075,350,62960,12,-725,2015
168970,2.1,54206.0,21100,18600,73100,4,-2500,2015
136820,3.8,55663.0,45300,42500,73100,4,-2800,2015
462426,3.2,154968.0,1125,2200,61490,18,1075,2015
482169,4.2,12051.0,30100,30400,73130,1,300,2015
441730,1.9,113618.0,10550,8700,74430,9,-1850,2015
298539,4.7,20628.0,32300,31600,59100,2,-700,2015
30854,4.4,27308.0,21300,21750,77030,2,450,2015
540541,4.1,41876.0,12750,12300,81400,5,-450,2015
338002,3.3,64099.0,14000,14400,82750,4,400,2015
410191,1.9,100816.0,4775,3500,61450,7,-1275,2015
238686,3.4,95030.0,1725,2000,59100,10,275,2014
503385,4.8,14453.0,26700,29400,80610,2,2700,2015
171106,2.9,40278.0,11200,11900,73100,3,700,2015
58621,2.1,157513.0,7275,6800,77030,9,-475,2015
349221,3.7,55825.0,18200,17000,62960,5,-1200,2014
177832,4.1,27253.0,10200,9900,83200,3,-300,2015
93990,2.7,133419.0,5350,3800,68360,7,-1550,2015
505796,3.4,89423.0,4575,5000,80610,12,425,2015
69936,2.2,35892.0,9850,10000,77030,3,150,2015
543885,4.3,37384.0,14150,14400,81400,1,250,2015
377376,4.4,25586.0,13200,14000,64520,2,800,2015
160356,4.9,30091.0,42400,41750,73100,4,-650,2015
253167,2.9,99407.0,4075,6900,59100,10,2825,2015
129172,1.9,51945.0,21200,19200,73100,3,-2000,2015
383154,4.9,23985.0,11700,19400,65610,2,7700,2015
115137,3.7,47849.0,8950,8500,68360,2,-450,2015
300397,3.3,84943.0,10950,10700,59100,8,-250,2015
546243,4.9,26783.0,24000,25600,81400,2,1600,2015
154157,3.1,52370.0,6400,7500,73100,5,1100,2015
472672,1.0,129479.0,9825,6900,62930,5,-2925,2015
15982,3.9,65471.0,20300,23400,77030,2,3100,2015
19156,4.1,55801.0,33300,33000,77030,4,-300,2015
173986,3.3,20928.0,24000,24500,83200,2,500,2014
12393,3.5,44332.0,12300,12600,77030,2,300,2014
384345,4.0,12842.0,17900,16900,65610,1,-1000,2015
461728,1.9,186953.0,1100,600,61490,16,-500,2015
535400,2.0,72065.0,5550,4400,82150,11,-1150,2015
309044,2.6,35802.0,9825,9900,59100,3,75,2015
380944,3.2,84747.0,4750,3500,64520,8,-1250,2015
430198,3.9,23575.0,12700,12700,61450,3,0,2015
211408,2.8,163396.0,3050,2600,57290,8,-450,2015
293824,2.4,58729.0,13300,12200,59100,2,-1100,2015
361510,4.3,143008.0,12350,14600,64520,5,2250,2014
89387,3.6,32238.0,20300,24000,68360,1,3700,2015
382750,1.9,84132.0,12650,10200,65610,8,-2450,2014
352041,3.4,63360.0,37000,36000,62960,3,-1000,2015
165699,1.9,174508.0,6300,6400,73100,9,100,2015
484212,4.5,20234.0,18900,19000,73130,3,100,2015
231061,3.7,113486.0,9100,6000,89090,3,-3100,2015
86912,4.4,40774.0,18150,21700,68360,2,3550,2015
84857,4.6,15153.0,13100,13700,68360,2,600,2015
131251,4.6,22740.0,20500,20000,73100,0,-500,2015
245734,3.1,236413.0,4475,3800,59100,9,-675,2015
46908,3.8,46507.0,40400,41500,77030,3,1100,2015
165014,3.9,25732.0,18650,18300,73100,3,-350,2015
14830,3.6,46675.0,21700,22000,77030,4,300,2015
40563,2.8,161709.0,1625,1600,77030,13,-25,2015
56493,3.1,33584.0,26600,18500,77030,3,-8100,2015
87431,4.2,54844.0,30400,30200,68360,2,-200,2015
302215,4.6,54232.0,14100,15900,59100,4,1800,2015
407449,1.9,202679.0,3775,1600,61450,14,-2175,2015
120798,1.9,159263.0,1875,1000,73100,13,-875,2014
134303,1.0,9723.0,14950,5400,73100,2,-9550,2015
284209,4.5,11037.0,32100,31800,59100,0,-300,2015
413089,4.2,62649.0,12050,12900,61450,8,850,2015
131532,4.3,113725.0,36500,37300,73100,2,800,2015
365812,2.5,76112.0,7375,5400,64520,5,-1975,2015
353088,2.0,171109.0,2250,1850,62960,14,-400,2015
79405,4.6,75891.0,11450,11100,68360,4,-350,2015
257550,4.1,38511.0,10800,10700,59100,2,-100,2015
454881,2.5,130563.0,3850,3400,61490,10,-450,2015
25583,4.0,26081.0,28500,27250,77030,3,-1250,2015
442286,3.6,106914.0,5550,5000,74430,8,-550,2015
143737,4.3,43882.0,22600,23300,73100,3,700,2015
535246,2.8,92486.0,3150,2500,82150,13,-650,2015
367850,3.9,5101.0,44100,44750,64520,1,650,2015
84561,4.8,26296.0,13700,14300,68360,3,600,2015
283251,3.4,41265.0,21000,21400,59100,3,400,2015
248915,4.4,13677.0,65000,66500,59100,3,1500,2015
85118,3.5,46505.0,11550,11100,68360,4,-450,2015
446712,3.5,122237.0,4850,3900,56120,11,-950,2015
252935,2.9,37316.0,10250,9800,59100,4,-450,2015
543594,4.6,15785.0,44400,43750,81400,1,-650,2015
313981,2.9,76945.0,4775,6900,59100,7,2125,2015
227962,4.4,24841.0,25600,23700,89090,8,-1900,2015
71983,4.1,10213.0,13800,15300,77030,2,1500,2015
479403,2.0,81339.0,7925,7400,73130,4,-525,2015
530333,3.3,87024.0,14200,13400,82150,5,-800,2015
153663,2.1,37522.0,18050,15000,73100,7,-3050,2015
316514,3.9,93992.0,17350,13300,73200,2,-4050,2014
138181,4.2,61769.0,19700,19250,73100,7,-450,2015
217950,3.7,52472.0,19600,21200,57290,2,1600,2015
299908,3.5,15170.0,21800,19200,59100,2,-2600,2015
501316,3.5,53273.0,9575,10100,80610,2,525,2015
403038,2.9,36264.0,13900,13800,61450,2,-100,2015
422716,4.1,28232.0,23300,23200,61450,3,-100,2015
366613,4.0,98459.0,2300,3500,64520,9,1200,2015
389103,3.9,23339.0,25700,25500,65610,2,-200,2015
115663,3.2,108120.0,14900,12300,68360,4,-2600,2015
448940,2.5,157421.0,2675,4000,61490,8,1325,2015
278841,4.4,34719.0,13350,14100,59100,4,750,2015
267440,4.6,16004.0,17250,18800,59100,2,1550,2015
518827,4.1,26163.0,19300,19200,71660,1,-100,2015
96607,4.3,66314.0,9650,10500,68360,2,850,2015
372576,5.0,7993.0,23600,24100,64520,1,500,2015
42261,2.7,43212.0,12450,12000,77030,2,-450,2015
152246,4.4,28714.0,10500,11800,73100,3,1300,2015
283129,3.5,62069.0,16850,16300,59100,2,-550,2015
473290,3.5,73465.0,4900,5900,62930,11,1000,2015
143169,3.0,32724.0,16050,17800,73100,4,1750,2015
272266,1.9,70616.0,10550,8775,59100,3,-1775,2015
9485,2.0,164470.0,1075,450,77030,11,-625,2014
8479,4.3,20729.0,15650,19100,77030,2,3450,2015
43088,2.2,211144.0,850,1000,77030,15,150,2015
17997,4.3,38831.0,13800,14800,77030,4,1000,2015
193246,4.4,16009.0,28500,30000,67090,2,1500,2015
17156,1.9,98496.0,3850,3000,77030,11,-850,2015
497860,4.0,25263.0,9950,10800,73130,3,850,2015
78764,1.9,124175.0,2675,2700,68360,14,25,2015
208762,4.7,38969.0,11250,11400,57290,2,150,2015
425146,4.4,7893.0,18400,19800,61450,3,1400,2015
306575,4.5,8131.0,10800,12200,59100,2,1400,2015
298321,3.5,73306.0,20700,19800,59100,8,-900,2015
201992,3.6,6397.0,15450,14500,57290,1,-950,2014
265050,1.9,116355.0,3100,2000,59100,13,-1100,2015
495957,4.9,11027.0,23100,23500,73130,0,400,2015
41337,3.7,98109.0,8875,9500,77030,4,625,2015
527617,4.3,23894.0,21500,21400,70210,2,-100,2015
144406,3.7,88120.0,6025,7000,73100,11,975,2015
76372,3.8,40356.0,16900,16200,68360,4,-700,2014
143274,2.5,135097.0,2700,2200,73100,11,-500,2015
72031,3.4,95349.0,14050,14000,77030,8,-50,2015
520060,3.4,50303.0,33400,31500,71660,2,-1900,2015
460067,3.3,44408.0,14000,14700,61490,3,700,2015
240120,4.1,47689.0,31800,31000,59100,3,-800,2014
448197,3.4,67701.0,10550,11200,56120,7,650,2015
202220,2.3,107752.0,8775,9500,57290,7,725,2014
367894,3.9,17062.0,15050,14500,64520,2,-550,2015
249610,4.8,6751.0,18200,19700,59100,1,1500,2015
60917,3.8,30247.0,27400,23750,77030,3,-3650,2015
248008,2.2,103547.0,4425,4100,59100,9,-325,2015
367371,2.8,61479.0,7725,7050,64520,4,-675,2015
191549,3.2,28531.0,25000,24500,67090,1,-500,2014
439357,2.6,115412.0,7175,5600,74430,8,-1575,2015
46889,3.6,37251.0,13700,13000,77030,2,-700,2015
101490,3.5,62644.0,8725,9300,68360,5,575,2015
12759,2.0,125427.0,1200,1050,77030,18,-150,2014
171687,3.5,33678.0,12600,12600,73100,1,0,2015
211239,3.7,114970.0,6850,7300,57290,10,450,2015
475592,,108270.0,3550,4300,73130,8,750,2014
540956,4.9,5000.0,22800,22700,81400,1,-100,2015
445655,4.4,60542.0,19400,17900,56120,4,-1500,2015
382834,,137998.0,2425,2400,65610,9,-25,2014
288723,3.6,95004.0,6300,6000,59100,4,-300,2015
185737,3.1,68484.0,12400,14200,63250,3,1800,2015
535247,2.6,162158.0,2325,2400,82150,13,75,2015
35426,3.6,36697.0,48000,49000,77030,2,1000,2015
1543,3.7,43544.0,12900,12300,77030,2,-600,2014
269631,2.8,84980.0,3225,2200,59100,9,-1025,2015
387574,3.6,117254.0,20200,16500,65610,4,-3700,2015
387201,4.6,34828.0,10950,11600,65610,2,650,2015
3603,2.7,73978.0,8250,7200,77030,7,-1050,2014
441041,2.5,96700.0,4050,3800,74430,5,-250,2015
27715,4.8,16977.0,31600,35500,77030,7,3900,2015
532038,1.9,73652.0,7650,5100,82150,8,-2550,2015
540581,4.3,42662.0,20000,20200,81400,4,200,2015
114829,4.6,32797.0,48200,49800,68360,1,1600,2015
289827,1.9,135218.0,5550,3600,59100,8,-1950,2015
328809,4.1,24558.0,23100,16000,82750,2,-7100,2015
338449,3.0,20011.0,13250,11600,82750,3,-1650,2015
171960,4.1,26618.0,18000,18600,73100,3,600,2015
131742,1.9,57424.0,17950,14200,73100,3,-3750,2015
389509,4.9,60110.0,9550,12300,65610,5,2750,2015
455481,4.4,14113.0,27700,28300,61490,1,600,2015
426139,2.0,162552.0,2775,2200,61450,10,-575,2015
261138,4.3,10977.0,33400,34000,59100,3,600,2015
404528,4.9,12611.0,19800,20300,61450,2,500,2015
502707,2.9,76995.0,9325,11500,80610,8,2175,2015
231353,2.0,35261.0,10200,3500,89090,2,-6700,2015
326039,4.2,152464.0,4875,4900,82750,11,25,2015
265012,1.9,105815.0,8575,6200,59100,12,-2375,2015
475461,3.1,17896.0,16700,16000,73130,0,-700,2014
173659,,85333.0,5125,5000,83200,13,-125,2014
511356,2.2,98144.0,11300,9800,71660,10,-1500,2015
322004,2.5,17146.0,19150,16700,82750,3,-2450,2015
184791,3.7,4397.0,15850,16500,63250,1,650,2015
463482,4.6,16879.0,51100,51500,61490,1,400,2015
142923,1.9,126815.0,4675,5600,73100,12,925,2015
328832,3.8,35016.0,14300,13200,82750,2,-1100,2015
19138,3.3,53845.0,17700,18500,77030,4,800,2015
134730,4.8,9503.0,14200,11400,73100,1,-2800,2015
74185,,93221.0,4450,4600,68360,7,150,2014
548905,4.0,92595.0,12850,12800,48460,4,-50,2015
298869,2.3,126841.0,9050,3800,59100,8,-5250,2015
440355,2.7,48973.0,24400,23700,74430,2,-700,2015
132050,2.9,62957.0,9775,9900,73100,5,125,2015
47911,4.9,28338.0,30800,31000,77030,3,200,2015
68834,4.4,50860.0,22500,21900,77030,2,-600,2015
64841,4.2,30802.0,9500,10200,77030,3,700,2015
202608,4.3,19901.0,13250,13000,57290,2,-250,2014
493047,3.4,57433.0,12500,12000,73130,2,-500,2015
123770,2.8,33670.0,16000,14300,73100,4,-1700,2015
494662,4.0,9607.0,22600,23000,73130,0,400,2015
481809,3.7,43553.0,11450,10500,73130,3,-950,2015
166059,4.6,26385.0,43100,44000,73100,3,900,2015
310630,4.8,8019.0,51000,47600,59100,0,-3400,2015
219934,3.9,52499.0,21300,22600,57290,2,1300,2015
280336,3.7,66911.0,22700,23600,59100,4,900,2015
131065,2.5,60696.0,9925,16300,73100,4,6375,2015
414098,4.1,111801.0,9050,9900,61450,3,850,2015
366325,3.6,22496.0,21200,20400,64520,4,-800,2015
409644,4.7,53376.0,14550,16000,61450,5,1450,2015
489435,2.9,20924.0,14650,13600,73130,2,-1050,2015
475563,3.5,21771.0,42700,43000,73130,-1,300,2014
300668,3.0,28859.0,12900,10800,59100,2,-2100,2015
410149,3.9,68919.0,2650,2600,61450,12,-50,2015
143064,4.1,28826.0,16400,16100,73100,2,-300,2015
163035,2.7,53347.0,21700,19800,73100,2,-1900,2015
390869,5.0,23284.0,28100,25500,65610,1,-2600,2015
340569,4.4,45253.0,20900,23250,82750,2,2350,2015
523541,2.9,44163.0,10650,10800,71660,2,150,2015
446782,3.6,69862.0,6975,7500,56120,10,525,2015
428534,3.6,48626.0,10450,10500,61450,3,50,2015
356097,2.7,143948.0,6875,3100,62960,9,-3775,2015
199937,4.0,28471.0,17200,15800,67090,4,-1400,2015
54255,2.4,122870.0,3150,2200,77030,9,-950,2015
496645,5.0,3211.0,11250,12700,73130,3,1450,2015
401391,5.0,5072.0,19900,23400,61450,2,3500,2015
395744,3.9,7251.0,29400,30000,65610,1,600,2015
302156,2.9,18783.0,29100,27000,59100,3,-2100,2015
370598,2.7,118555.0,4400,5100,64520,8,700,2015
353318,4.3,55817.0,16350,16400,62960,2,50,2015
542273,4.3,10692.0,20700,19900,81400,1,-800,2015
371333,1.9,116549.0,8250,8000,64520,9,-250,2015
47318,1.9,87209.0,3700,5500,77030,10,1800,2015
251174,2.4,23603.0,15200,14000,59100,3,-1200,2015
499781,3.7,129854.0,6825,7500,80610,6,675,2015
271164,2.8,96440.0,4450,4500,59100,10,50,2015
213236,3.7,1659.0,26200,24400,57290,2,-1800,2015
26153,3.8,79348.0,5225,5200,77030,9,-25,2015
283310,4.2,42950.0,8525,10100,59100,4,1575,2015
268026,1.9,172284.0,11200,11900,59100,9,700,2015
414072,4.8,17838.0,15600,15900,61450,2,300,2015
117117,2.7,55318.0,8325,12900,68360,8,4575,2015
429463,3.6,79834.0,10700,10300,61450,3,-400,2015
242104,4.1,14404.0,35900,36800,59100,1,900,2014
78892,3.7,79097.0,10700,11100,68360,3,400,2015
355192,2.0,1.0,3925,850,62960,14,-3075,2015
86287,1.9,117307.0,4575,4100,68360,7,-475,2015
10030,2.0,38824.0,10400,8300,77030,1,-2100,2014
138838,4.1,31987.0,18250,18700,73100,3,450,2015
134822,4.0,34285.0,13700,14100,73100,3,400,2015
163298,4.4,35947.0,23300,24200,73100,1,900,2015
514083,1.5,48225.0,9025,6200,71660,3,-2825,2015
365657,4.3,94868.0,6900,7300,64520,3,400,2015
206042,4.3,40596.0,14000,14000,57290,1,0,2015
527375,1.9,119424.0,3300,2500,70210,13,-800,2015
97317,2.8,217723.0,3100,3600,68360,11,500,2015
250730,3.5,57162.0,22000,19600,59100,2,-2400,2015
251086,1.0,1.0,7750,1200,59100,11,-6550,2015
211411,4.1,131347.0,5650,7000,57290,9,1350,2015
464260,2.7,21686.0,8550,7000,61490,4,-1550,2015
286086,2.9,33678.0,28000,26300,59100,3,-1700,2015
351898,2.0,150620.0,2175,950,62960,11,-1225,2015
89463,2.8,101484.0,7575,6500,68360,6,-1075,2015
445448,3.4,91591.0,6525,7900,56120,8,1375,2015
494017,2.7,131524.0,5550,4900,73130,8,-650,2015
228699,1.9,134518.0,7875,6600,89090,7,-1275,2015
449326,2.7,106996.0,5325,3800,61490,10,-1525,2014
372757,3.9,108446.0,7900,8600,64520,7,700,2015
163545,3.5,82686.0,7300,7600,73100,7,300,2015
362151,3.6,25105.0,10250,9200,64520,2,-1050,2014
128159,4.4,8901.0,12050,12400,73100,3,350,2015
148556,5.0,14174.0,33400,30900,73100,1,-2500,2015
281912,1.9,88591.0,9375,9600,59100,4,225,2015
469012,1.9,164543.0,1225,700,61490,12,-525,2015
538546,3.2,74721.0,8725,7900,55590,3,-825,2015
434802,2.9,81859.0,8750,6500,74430,8,-2250,2015
177065,1.9,73553.0,28500,21000,83200,6,-7500,2015
285933,4.0,29886.0,17400,18700,59100,1,1300,2015
464362,1.6,118176.0,5125,5900,61490,9,775,2015
407077,2.3,88065.0,5775,5600,61450,9,-175,2015
242633,4.0,14913.0,14500,14800,59100,1,300,2015
410353,3.9,38160.0,22100,22900,61450,3,800,2015
453056,2.6,136382.0,1875,3500,61490,12,1625,2015
11334,2.0,46535.0,26500,13500,77030,2,-13000,2015
354059,3.8,20224.0,13450,13900,62960,2,450,2015
54830,4.1,90068.0,16450,18700,77030,8,2250,2015
56192,1.9,76098.0,8400,8500,77030,3,100,2015
302008,4.7,3249.0,12350,12400,59100,1,50,2015
209611,4.3,46063.0,11600,12500,57290,3,900,2015
3406,2.8,89437.0,14400,15200,77030,7,800,2014
533759,1.9,104204.0,4225,2200,82150,10,-2025,2015
323527,3.4,87177.0,18550,18700,82750,8,150,2015
72700,3.1,93834.0,10350,11000,77030,8,650,2015
69317,4.0,23080.0,17900,17200,77030,0,-700,2015
272545,1.9,95165.0,6850,6000,59100,4,-850,2015
389855,5.0,95714.0,9600,10000,65610,7,400,2015
138759,4.3,23223.0,14100,13400,73100,2,-700,2015
184303,3.2,107109.0,5350,5900,63250,7,550,2015
187250,4.2,50174.0,9225,9500,63250,2,275,2015
423473,4.1,19919.0,15000,14600,61450,1,-400,2015
541221,4.7,16422.0,15450,15800,81400,1,350,2015
88284,2.0,82232.0,6350,4900,68360,8,-1450,2015
213011,3.5,65395.0,17000,19100,57290,5,2100,2015
193517,2.0,109638.0,4350,3900,67090,7,-450,2015
215672,4.4,87418.0,18250,20900,57290,6,2650,2015
395650,3.7,63097.0,24500,22500,65610,3,-2000,2015
116360,1.9,99130.0,6200,3300,68360,8,-2900,2015
485338,2.7,46159.0,11850,11700,73130,3,-150,2015
223872,3.7,105084.0,8850,9700,89090,4,850,2015
433058,,151415.0,2250,900,74430,9,-1350,2014
458721,2.1,111513.0,850,900,61490,13,50,2015
255771,2.6,171233.0,3225,3700,59100,9,475,2015
367907,3.5,23248.0,9225,9100,64520,2,-125,2015
474710,4.7,12296.0,12050,12500,62930,1,450,2015
257090,2.3,29375.0,8825,8300,59100,1,-525,2015
13494,3.2,64271.0,14400,13800,77030,3,-600,2015
393290,4.3,9116.0,26100,25900,65610,3,-200,2015
471618,3.9,22763.0,14250,14000,62930,3,-250,2015
127513,2.6,24427.0,30400,28000,73100,2,-2400,2015
109695,4.2,96233.0,9025,10000,68360,5,975,2015
464283,2.2,117767.0,5350,3800,61490,6,-1550,2015
345774,1.9,130352.0,2025,1850,82750,8,-175,2015
142593,3.7,37004.0,14100,13500,73100,3,-600,2015
93662,2.8,118579.0,2425,3400,68360,8,975,2015
465302,2.0,115683.0,4575,3200,61490,6,-1375,2015
26915,1.9,102739.0,13100,13700,77030,8,600,2015
216188,5.0,1172.0,23200,25800,57290,1,2600,2015
368957,4.2,31973.0,29000,29600,64520,3,600,2015
474823,,75521.0,20400,22200,73130,3,1800,2014
63851,4.1,111959.0,12350,15500,77030,8,3150,2015
290436,3.6,32900.0,14000,13200,59100,3,-800,2015
49157,3.9,39598.0,28600,30000,77030,2,1400,2015
35276,3.5,41358.0,12150,12200,77030,2,50,2015
255209,2.5,117978.0,4450,3500,59100,6,-950,2015
72106,3.1,45560.0,35100,31250,77030,3,-3850,2015
138405,4.0,18399.0,16400,16000,73100,1,-400,2015
465871,4.5,62116.0,9900,9200,61490,3,-700,2015
412897,2.7,36741.0,31100,32750,61450,4,1650,2015
289310,3.7,164383.0,4350,7600,59100,3,3250,2015
386883,4.9,20925.0,26000,24700,65610,2,-1300,2015
507363,1.9,288595.0,450,200,80200,15,-250,2015
377673,3.9,100052.0,10800,10250,64520,2,-550,2015
521162,2.8,28170.0,15850,14300,71660,3,-1550,2015
69567,4.8,10628.0,21900,22250,77030,2,350,2015
18855,3.6,32891.0,13550,14300,77030,3,750,2015
364799,4.2,41062.0,14350,15100,64520,4,750,2015
247813,4.6,47950.0,18300,17400,59100,5,-900,2015
220647,3.5,59943.0,12700,14400,57290,2,1700,2015
331901,4.3,36027.0,9950,17000,82750,3,7050,2015
218443,2.9,38002.0,10300,10100,57290,1,-200,2015
472670,2.6,227987.0,4300,3000,62930,5,-1300,2015
83467,4.1,27214.0,17200,17300,68360,1,100,2015
238999,1.9,142544.0,2100,1700,59100,16,-400,2014
424131,4.3,98159.0,7075,7600,61450,4,525,2015
391060,3.8,36265.0,10800,9500,65610,4,-1300,2015
228097,4.3,63355.0,14700,15300,89090,2,600,2015
236718,,41000.0,15100,15300,59100,2,200,2014
506074,1.9,98599.0,8375,5000,80200,9,-3375,2014
266411,2.1,55395.0,8950,8100,59100,4,-850,2015
99129,2.7,111711.0,8475,8000,68360,8,-475,2015
330612,4.7,62131.0,26200,26200,82750,4,0,2015
297814,3.2,108910.0,17550,17500,59100,4,-50,2015
536383,4.3,115958.0,9050,9600,73640,2,550,2014
226215,2.6,141537.0,2275,1700,89090,11,-575,2015
231869,4.7,9608.0,18650,18000,89090,0,-650,2015
466682,3.5,26242.0,14750,14600,61490,1,-150,2015
373228,4.8,20160.0,12150,11900,64520,1,-250,2015
122113,3.3,27257.0,20100,20600,73100,2,500,2014
231972,1.9,156893.0,3950,2600,89090,7,-1350,2015
236746,,49723.0,23700,22800,59100,2,-900,2014
78887,4.9,40884.0,23000,23300,68360,2,300,2014
423767,3.5,87811.0,5825,7300,61450,3,1475,2015
468046,4.1,51490.0,16450,16500,61490,1,50,2015
81104,4.3,39913.0,18050,18400,68360,2,350,2015
350648,5.0,7570.0,46600,47750,62960,1,1150,2015
56676,5.0,7650.0,16600,17500,77030,2,900,2015
91550,4.3,38274.0,10750,12200,68360,1,1450,2015
174195,3.7,77537.0,9600,11800,83200,10,2200,2014
52874,2.0,129773.0,8300,10000,77030,8,1700,2015
56037,1.9,99585.0,4500,4500,77030,11,0,2015
41461,3.7,81352.0,8650,8000,77030,6,-650,2015
168537,3.4,40395.0,16200,16700,73100,3,500,2015
543666,5.0,10016.0,21500,23000,81400,1,1500,2015
36282,2.4,26875.0,13450,11500,77030,3,-1950,2015
445726,2.6,56282.0,9800,9500,56120,2,-300,2015
117080,2.9,128144.0,14000,14200,68360,7,200,2015
297631,4.0,47877.0,22700,23800,59100,3,1100,2015
130841,4.3,88001.0,7850,9500,73100,8,1650,2015
340261,4.3,26429.0,21700,18900,82750,2,-2800,2015
360852,2.6,86406.0,4875,4100,64520,10,-775,2014
334478,4.3,34640.0,21200,20700,82750,3,-500,2015
434002,2.1,134821.0,2375,2900,74430,12,525,2014
326584,4.0,30408.0,27000,27000,82750,2,0,2015
388452,2.7,104932.0,8400,6600,65610,11,-1800,2015
474821,,60695.0,19550,17600,73130,3,-1950,2014
337506,3.9,29984.0,9450,10700,82750,4,1250,2015
34405,2.8,74863.0,7050,7100,77030,10,50,2015
186584,1.9,181908.0,1625,400,63250,11,-1225,2015
28080,3.5,84068.0,14700,19100,77030,6,4400,2015
228327,2.9,122735.0,6300,3300,89090,9,-3000,2015
427132,4.4,10288.0,16400,17100,61450,3,700,2015
40155,3.4,87643.0,10650,10900,77030,6,250,2015
213390,3.8,65018.0,15750,16500,57290,4,750,2015
180160,2.3,45614.0,13250,12400,83200,2,-850,2015
254589,4.5,21913.0,14800,15300,59100,1,500,2015
506908,2.1,86622.0,7775,8800,80200,6,1025,2015
432791,2.5,103615.0,8250,7000,74430,7,-1250,2014
83708,5.0,37073.0,43200,44100,68360,3,900,2015
380605,4.5,32126.0,11600,12100,64520,3,500,2015
79286,4.9,29156.0,10750,12100,68360,3,1350,2015
434441,2.8,80280.0,13800,12500,74430,12,-1300,2015
51192,2.6,96369.0,5250,5400,77030,8,150,2015
79697,3.9,56720.0,19350,18100,68360,3,-1250,2015
210548,4.1,36960.0,13950,13700,57290,1,-250,2015
77228,3.5,79312.0,8800,8800,68360,3,0,2014
82666,3.7,38559.0,14800,15000,68360,2,200,2015
7270,,73237.0,5775,4000,77030,9,-1775,2014
243364,4.4,31391.0,13800,13200,59100,2,-600,2015
346455,1.0,141210.0,2300,1350,82750,11,-950,2015
49585,3.8,99753.0,6650,9100,77030,3,2450,2015
265186,4.0,23016.0,15300,15000,59100,1,-300,2015
434352,4.0,18310.0,15450,13700,74430,2,-1750,2015
102591,3.8,39702.0,11300,11500,68360,2,200,2015
64307,4.1,148394.0,5525,6800,77030,8,1275,2015
64821,4.3,30700.0,17250,18000,77030,2,750,2015
315080,4.6,30089.0,40400,39400,59100,2,-1000,2015
461052,2.2,124279.0,2875,2500,61490,8,-375,2015
329376,3.7,88164.0,8425,8100,82750,6,-325,2015
396331,4.4,57607.0,24100,24900,65610,4,800,2015
322235,2.9,51353.0,12800,12000,82750,4,-800,2015
477916,3.8,33482.0,14350,14300,73130,2,-50,2015
307132,2.8,117763.0,11100,10800,59100,6,-300,2015
453176,2.9,41773.0,11000,11000,61490,2,0,2015
143234,2.5,109276.0,4675,4300,73100,7,-375,2015
532850,4.2,49981.0,12350,12300,82150,2,-50,2015
364056,3.8,37916.0,25700,25600,64520,3,-100,2015
243112,4.9,6010.0,15150,15400,59100,1,250,2015
535311,2.1,119390.0,1350,950,82150,13,-400,2015
457882,4.4,58563.0,10650,10800,61490,3,150,2015
419965,4.9,19516.0,12800,14000,61450,3,1200,2015
9662,4.4,19991.0,22500,22900,77030,0,400,2014
160757,4.5,21781.0,11350,12000,73100,2,650,2015
258158,3.9,39575.0,12950,13200,59100,2,250,2015
266051,4.9,1568.0,49500,47000,59100,1,-2500,2015
481828,2.9,53078.0,14550,13000,73130,3,-1550,2015
82028,2.6,81864.0,1775,1400,68360,8,-375,2015
450540,1.9,109189.0,3025,3000,61490,10,-25,2015
515802,3.7,32155.0,18950,17500,71660,1,-1450,2015
371062,4.0,39757.0,11350,11700,64520,3,350,2015
299952,4.5,40309.0,41800,47200,59100,3,5400,2015
316907,4.2,83548.0,7825,8700,73200,6,875,2015
100305,2.8,176844.0,1875,2100,68360,12,225,2015
51687,4.5,8163.0,33500,37500,77030,3,4000,2015
529030,3.6,32257.0,28100,25800,70210,2,-2300,2015
443328,4.0,14020.0,38200,38200,74430,1,0,2015
112398,3.1,30697.0,14550,16000,68360,2,1450,2015
250332,2.8,42769.0,17000,16400,59100,5,-600,2015
207324,1.9,96345.0,8300,7900,57290,9,-400,2015
97352,4.4,25013.0,20100,20400,68360,1,300,2015
34512,2.0,85619.0,8525,8900,77030,12,375,2015
179885,3.9,15180.0,16550,16100,83200,1,-450,2015
228991,4.3,205598.0,3400,4900,89090,10,1500,2015
281706,3.7,18317.0,29300,30200,59100,1,900,2015
453333,2.7,107399.0,1925,3600,61490,10,1675,2015
307029,4.5,26477.0,12250,12800,59100,3,550,2015
142376,4.7,21701.0,13650,14400,73100,3,750,2015
72248,2.1,42736.0,21100,21400,77030,8,300,2015
512280,2.0,77087.0,6075,7500,71660,13,1425,2015
457259,3.1,68718.0,7975,8300,61490,4,325,2015
442385,4.9,20768.0,17950,17700,74430,1,-250,2015
266805,2.0,143958.0,8150,7200,59100,8,-950,2015
393149,2.7,105299.0,7575,5900,65610,5,-1675,2015
239276,5.0,5607.0,25400,30400,59100,1,5000,2015
469141,2.9,73545.0,7575,8000,61490,7,425,2015
34612,2.4,163310.0,1125,2000,77030,14,875,2015
516958,4.3,15569.0,33200,33000,71660,0,-200,2015
248667,4.5,24459.0,33900,33400,59100,2,-500,2015
160976,4.1,94856.0,8125,8200,73100,2,75,2015
423699,4.1,23080.0,43200,43000,61450,3,-200,2015
314480,3.3,62660.0,20200,18200,59100,2,-2000,2015
281536,3.1,32805.0,17650,14200,59100,3,-3450,2015
30531,1.9,120574.0,3975,3600,77030,15,-375,2015
121142,2.8,44536.0,32500,32500,73100,2,0,2015
32505,2.3,173980.0,2025,800,77030,16,-1225,2015
118385,5.0,2939.0,25800,26700,68360,1,900,2015
63143,3.7,90432.0,11050,12400,77030,3,1350,2015
247819,1.9,138761.0,3600,1800,59100,5,-1800,2015
96470,4.1,9970.0,15600,16900,68360,0,1300,2015
500559,1.9,150790.0,4550,3500,80610,12,-1050,2015
519515,5.0,9296.0,37900,39500,71660,1,1600,2015
169587,3.8,91021.0,15150,16900,73100,8,1750,2015
129812,3.7,34979.0,9150,9100,73100,4,-50,2015
94129,1.9,79342.0,8500,9200,68360,9,700,2015
41087,4.4,14234.0,22000,22700,77030,3,700,2015
420131,2.0,83096.0,9350,9500,61450,5,150,2015
341151,3.8,11888.0,18050,19100,82750,1,1050,2015
471160,2.0,162126.0,1450,950,62930,10,-500,2015
319979,3.7,39226.0,13650,14800,73200,2,1150,2015
207690,4.5,25018.0,22200,24200,57290,2,2000,2015
404098,4.8,26980.0,34900,34000,61450,1,-900,2015
439112,3.0,103228.0,5125,3400,74430,6,-1725,2015
445285,3.4,177296.0,7825,5900,56120,9,-1925,2015
444092,1.9,145284.0,775,500,74430,14,-275,2015
210351,4.3,35465.0,10250,10000,57290,1,-250,2015
158412,4.4,32649.0,12450,11900,73100,2,-550,2015
219930,2.8,41039.0,21500,19900,57290,2,-1600,2015
334741,3.2,34631.0,22700,22200,82750,4,-500,2015
512304,4.2,47116.0,13550,13200,71660,3,-350,2015
336469,3.4,26412.0,16800,16400,82750,3,-400,2015
207058,4.1,46974.0,26700,28700,57290,3,2000,2015
178017,4.6,5675.0,22100,22300,83200,1,200,2015
260711,1.9,162525.0,775,700,59100,12,-75,2015
369136,4.5,48957.0,13800,13700,64520,4,-100,2015
86724,1.9,100242.0,11350,10900,68360,7,-450,2015
453292,4.3,96336.0,7675,8600,61490,9,925,2015
133649,3.0,21325.0,16250,15400,73100,1,-850,2015
19409,2.7,126705.0,4550,3250,77030,9,-1300,2015
159688,4.0,14115.0,22400,22200,73100,0,-200,2015
146036,4.6,35655.0,22400,22200,73100,3,-200,2015
544556,2.2,56370.0,16100,15500,81400,6,-600,2015
526306,2.5,91199.0,9000,4500,70210,5,-4500,2015
510739,4.8,13313.0,20400,20600,71660,1,200,2015
417064,2.1,105961.0,5700,4700,61450,9,-1000,2015
270104,3.4,30044.0,12250,11600,59100,3,-650,2015
366492,2.0,253910.0,3175,1000,64520,5,-2175,2015
140839,2.1,35929.0,11900,10400,73100,3,-1500,2015
529418,2.7,19715.0,30000,25500,70210,2,-4500,2015
109964,2.0,1.0,1775,1500,68360,18,-275,2015
227099,3.6,87985.0,5175,6100,89090,7,925,2015
155327,2.0,110075.0,7450,5100,73100,7,-2350,2015
340972,4.0,41300.0,15850,16300,82750,3,450,2015
137012,4.3,116763.0,13150,15400,73100,8,2250,2015
136577,1.9,185137.0,2825,2500,73100,14,-325,2015
179620,3.0,164888.0,3850,3950,83200,9,100,2015
436264,2.4,170200.0,4325,6400,74430,8,2075,2015
328080,2.1,60078.0,9375,8100,82750,4,-1275,2015
308337,1.9,164492.0,1050,1150,59100,10,100,2015
179362,4.5,104409.0,16350,14500,83200,6,-1850,2015
151015,5.0,53228.0,25900,26300,73100,3,400,2015
362366,1.9,110947.0,2350,1100,64520,11,-1250,2015
270553,3.1,130696.0,2900,3300,59100,11,400,2015
203812,3.6,16129.0,32700,34000,57290,1,1300,2015
450834,3.4,49379.0,8050,7600,61490,2,-450,2014
331343,4.8,3388.0,13950,13800,82750,1,-150,2015
110645,2.9,134586.0,4650,4500,68360,11,-150,2015
291121,3.7,67879.0,21500,20600,59100,5,-900,2015
411293,4.8,23583.0,21300,22100,61450,3,800,2015
56388,3.7,67736.0,8600,9300,77030,4,700,2015
258143,4.0,32691.0,8450,8600,59100,2,150,2015
504821,2.0,161521.0,1200,1300,80610,10,100,2015
87442,4.1,55325.0,10350,10300,68360,2,-50,2015
238581,2.5,106402.0,3575,3500,59100,9,-75,2014
255857,4.5,17424.0,30400,33000,59100,1,2600,2015
88500,4.1,17104.0,12150,12800,68360,2,650,2015
327181,4.4,74049.0,12150,13500,82750,4,1350,2015
305353,1.9,35413.0,13300,11500,59100,2,-1800,2015
83489,2.0,11809.0,19100,13400,68360,1,-5700,2015
63325,1.9,136311.0,5575,5600,77030,9,25,2015
462292,1.9,222490.0,5750,4500,61490,7,-1250,2015
384711,1.9,137231.0,3475,2200,65610,8,-1275,2015
231676,3.7,54209.0,10150,10600,89090,3,450,2015
509768,3.4,97978.0,14100,12100,71660,4,-2000,2015
531121,3.3,106676.0,4600,4000,82150,8,-600,2015
64177,3.6,45268.0,21500,21800,77030,4,300,2015
161662,3.6,1572.0,14950,13900,73100,1,-1050,2015
27902,3.7,58260.0,9425,10900,77030,3,1475,2015
309111,4.9,21829.0,15550,16600,59100,3,1050,2015
157263,3.2,62447.0,15000,14700,73100,2,-300,2015
282019,4.4,27119.0,11600,12000,59100,1,400,2015
38139,1.0,30818.0,10200,8100,77030,3,-2100,2015
357259,3.3,66203.0,12700,11900,62960,2,-800,2015
475095,,78133.0,11900,13100,73130,5,1200,2014
484103,4.1,41794.0,11750,12400,73130,3,650,2015
191688,3.2,62565.0,15750,15600,67090,1,-150,2014
415059,3.9,103273.0,23800,17200,61450,2,-6600,2015
443868,3.6,168200.0,11150,15600,74430,8,4450,2015
380346,2.5,122991.0,2525,2400,64520,9,-125,2015
39892,3.8,22137.0,49700,50500,77030,3,800,2015
96886,4.0,55314.0,8750,8900,68360,2,150,2015
366474,1.9,144882.0,1975,2100,64520,9,125,2015
120424,2.8,110175.0,14000,13400,73100,7,-600,2014
298596,4.2,12961.0,14400,13900,59100,3,-500,2015
231799,2.5,146777.0,6925,6400,89090,5,-525,2015
82962,4.2,42135.0,39100,39400,68360,1,300,2015
114336,3.7,60720.0,30400,30000,68360,3,-400,2015
323066,1.9,37119.0,15750,11700,82750,3,-4050,2015
94720,4.5,28236.0,16050,17700,68360,1,1650,2015
491638,4.4,18587.0,15550,15200,73130,1,-350,2015
314200,4.0,18531.0,42200,42500,59100,3,300,2015
524440,1.9,133028.0,4400,2100,70210,9,-2300,2014
164242,4.2,133398.0,6750,9700,73100,7,2950,2015
470520,3.5,35244.0,5550,5400,62930,5,-150,2014
385932,2.8,21714.0,16100,14900,65610,2,-1200,2015
201348,5.0,5327.0,22300,22600,57290,0,300,2014
229810,3.5,150202.0,3325,3800,89090,12,475,2015
415043,5.0,21402.0,29200,34100,61450,1,4900,2015
192902,1.0,129204.0,575,350,67090,15,-225,2015
405122,3.7,133329.0,7350,8300,61450,8,950,2015
357674,4.2,36175.0,15950,15500,62960,1,-450,2015
163462,4.1,35995.0,29900,31750,73100,4,1850,2015
1611,4.3,12490.0,13850,15000,77030,2,1150,2014
287336,4.2,19175.0,15500,15600,59100,1,100,2015
73002,3.4,17133.0,20900,20500,77030,2,-400,2015
196627,3.4,23607.0,24800,23750,67090,2,-1050,2015
500443,3.5,96327.0,10850,11800,80610,3,950,2015
391709,4.9,24167.0,14100,13900,65610,2,-200,2015
440953,1.9,93933.0,12700,12600,74430,8,-100,2015
27710,2.3,133087.0,3150,3500,77030,7,350,2015
123974,2.0,73716.0,13750,12200,73100,3,-1550,2015
331693,1.9,169742.0,2550,1300,82750,11,-1250,2015
100950,1.9,127244.0,4550,3400,68360,8,-1150,2015
487477,4.4,52400.0,13400,13700,73130,3,300,2015
501832,4.2,12271.0,22600,21200,80610,2,-1400,2015
354382,4.4,20387.0,25500,27000,62960,2,1500,2015
512093,4.4,78227.0,10100,10700,71660,2,600,2015
30002,4.8,58207.0,15900,17000,77030,4,1100,2015
131360,3.1,30205.0,13450,14600,73100,4,1150,2015
21437,2.7,144664.0,2650,1900,77030,12,-750,2015
520895,3.1,33042.0,13850,13800,71660,1,-50,2015
53371,4.1,21669.0,14400,11500,77030,3,-2900,2015
180063,2.8,59323.0,11550,11100,83200,2,-450,2015
185748,4.6,16969.0,24700,24800,63250,3,100,2015
414389,3.5,41474.0,8450,9400,61450,2,950,2015
407781,3.4,58649.0,9100,9300,61450,11,200,2015
391366,5.0,14559.0,13000,13400,65610,2,400,2015
187776,4.1,49601.0,6050,5900,63250,5,-150,2015
126781,4.2,59186.0,15900,17300,73100,7,1400,2015
159589,4.0,16890.0,16650,16400,73100,1,-250,2015
57842,4.9,27965.0,35900,37600,77030,1,1700,2015
75926,3.0,174472.0,3025,4000,68360,7,975,2014
150217,2.9,55221.0,11850,11700,73100,2,-150,2015
31501,3.8,35415.0,29800,30750,77030,3,950,2015
287371,3.3,48044.0,10050,10600,59100,2,550,2015
122544,3.9,24396.0,15600,14500,73100,2,-1100,2014
477509,3.4,32047.0,11250,9900,73130,2,-1350,2014
187294,3.7,27518.0,21200,22200,63250,2,1000,2015
244389,2.3,151618.0,1975,1400,59100,13,-575,2015
190790,3.8,53912.0,8175,8400,63250,2,225,2015
314446,4.4,32183.0,30200,35000,59100,2,4800,2015
12250,2.1,145565.0,875,900,77030,13,25,2014
361986,5.0,3339.0,17000,16300,64520,0,-700,2014
14185,3.8,74759.0,9700,11500,77030,2,1800,2015
374647,4.8,24567.0,12500,13400,64520,3,900,2015
217877,2.9,29791.0,7425,6800,57290,3,-625,2015
424013,3.6,27312.0,19800,18500,61450,3,-1300,2015
208495,4.2,17593.0,12150,12800,57290,2,650,2015
21684,3.2,31944.0,24900,23300,77030,1,-1600,2015
494086,4.9,17084.0,20000,19400,73130,1,-600,2015
311274,2.1,108185.0,1225,700,59100,15,-525,2015
457510,3.2,77978.0,8725,9000,61490,3,275,2015
395244,5.0,77463.0,2650,4400,65610,8,1750,2015
34255,1.9,105288.0,2475,1200,77030,9,-1275,2015
286641,4.0,14373.0,13800,13700,59100,1,-100,2015
180672,2.4,120732.0,6075,5600,83200,10,-475,2015
549754,2.0,134545.0,3275,4500,48460,9,1225,2015
19159,3.7,44438.0,35400,38000,77030,4,2600,2015
368459,2.1,133665.0,5075,5000,64520,7,-75,2015
193780,3.4,29030.0,22500,22750,67090,3,250,2015
22601,2.9,286216.0,2375,3300,77030,14,925,2015
262195,4.0,25259.0,23400,20900,59100,1,-2500,2015
329762,2.0,3566.0,19450,14750,82750,0,-4700,2015
395809,5.0,25865.0,17650,17800,65610,2,150,2015
160931,3.5,17885.0,8475,9200,73100,9,725,2015
322716,4.4,3307.0,21800,23200,82750,1,1400,2015
39358,3.9,29941.0,13700,18750,77030,2,5050,2015
229657,2.9,121446.0,3325,2900,89090,11,-425,2015
227445,2.9,46805.0,10800,8800,89090,2,-2000,2015
88741,2.7,122641.0,10850,11700,68360,6,850,2015
248849,4.3,41902.0,9275,8200,59100,3,-1075,2015
489562,4.9,21926.0,17850,18400,73130,2,550,2015
64692,2.0,168792.0,475,1200,77030,22,725,2015
276498,3.6,33417.0,16800,16000,59100,4,-800,2015
358388,2.7,115009.0,12350,12800,62960,8,450,2015
377023,3.7,49468.0,9625,9800,64520,2,175,2015
89880,3.5,14209.0,22800,21500,68360,1,-1300,2015
134611,4.2,8292.0,13450,12800,73100,2,-650,2015
521441,2.8,78034.0,5225,3800,71660,7,-1425,2015
313226,1.9,161330.0,1675,1200,59100,15,-475,2015
360605,4.1,30529.0,15000,15000,64520,3,0,2014
504697,3.9,123955.0,16250,16000,80610,4,-250,2015
441664,1.9,91170.0,3300,2000,74430,10,-1300,2015
114217,1.9,170314.0,18500,16800,68360,8,-1700,2015
367687,4.6,7246.0,28700,26900,64520,1,-1800,2015
187961,3.8,37211.0,12900,14500,63250,1,1600,2015
495934,2.9,40004.0,8275,8800,73130,3,525,2015
65905,1.0,14303.0,14150,10200,77030,0,-3950,2015
141593,4.9,90548.0,28200,29500,73100,4,1300,2015
233174,4.2,77325.0,15750,15100,59100,3,-650,2014
403112,4.6,33915.0,12150,11400,61450,3,-750,2015
455607,4.2,42007.0,12100,11400,61490,4,-700,2015
86327,2.2,123741.0,4525,5000,68360,9,475,2015
501599,2.6,73323.0,5800,7100,80610,5,1300,2015
307899,1.9,142284.0,2975,1700,59100,11,-1275,2015
246811,3.8,82734.0,4175,6400,59100,14,2225,2015
207916,3.9,81783.0,6450,8000,57290,6,1550,2015
432205,3.5,74908.0,10850,10000,61450,6,-850,2015
100418,4.8,28778.0,23200,24800,68360,2,1600,2015
1533,3.5,33491.0,21600,23250,77030,2,1650,2014
106666,2.0,80000.0,1350,300,68360,13,-1050,2015
368968,4.5,28297.0,15950,15600,64520,3,-350,2015
489346,3.6,67052.0,14500,15800,73130,3,1300,2015
266561,3.8,71474.0,7325,7500,59100,5,175,2015
26794,3.5,52546.0,15300,17250,77030,6,1950,2015
185269,2.2,118658.0,1525,1550,63250,11,25,2015
80290,1.1,164509.0,4325,2000,68360,11,-2325,2015
353038,4.6,15829.0,16000,16800,62960,2,800,2015
408526,4.2,55354.0,14050,13600,61450,2,-450,2015
442254,2.5,17067.0,21700,16000,74430,4,-5700,2015
384687,4.0,146161.0,5300,4400,65610,7,-900,2015
106382,1.9,135623.0,1450,600,68360,10,-850,2015
437512,2.0,161271.0,1575,300,74430,11,-1275,2015
356872,3.5,27450.0,16000,16500,62960,1,500,2015
55063,1.9,70142.0,9975,11500,77030,4,1525,2015
327636,3.6,18768.0,12000,12700,82750,2,700,2015
443237,1.9,107180.0,600,1200,74430,14,600,2015
36581,2.6,39097.0,15250,15500,77030,2,250,2015
486949,4.0,18714.0,19200,18800,73130,1,-400,2015
330958,3.1,67918.0,11750,12200,82750,7,450,2015
132369,2.9,30302.0,10500,9700,73100,3,-800,2015
541108,4.7,10606.0,21200,20800,81400,0,-400,2015
50250,4.3,18525.0,29500,34000,77030,2,4500,2015
323563,4.5,12771.0,54300,52000,82750,0,-2300,2015
183480,3.5,57248.0,15700,16900,63250,1,1200,2014
158806,3.6,47320.0,17700,18800,73100,7,1100,2015
499911,3.8,40969.0,17600,18400,80610,1,800,2015
375712,1.9,151984.0,1925,1100,64520,13,-825,2015
42808,2.9,57741.0,10000,12000,77030,9,2000,2015
122834,,15769.0,16750,16600,73100,0,-150,2014
207363,1.0,211105.0,625,400,57290,18,-225,2015
242823,3.5,45575.0,27900,24500,59100,5,-3400,2015
261168,2.5,72542.0,7800,6900,59100,5,-900,2015
394537,4.5,10312.0,20000,20000,65610,1,0,2015
132438,4.0,18963.0,14750,15000,73100,1,250,2015
491172,4.3,22533.0,13600,14700,73130,1,1100,2015
328771,4.5,10668.0,12800,12300,82750,1,-500,2015
408773,2.8,102353.0,14300,14200,61450,6,-100,2015
245121,3.8,41951.0,18900,17600,59100,4,-1300,2015
489686,2.5,44017.0,16650,14800,73130,3,-1850,2015
531166,2.2,143531.0,4075,2000,82150,11,-2075,2015
144228,2.4,17362.0,13400,11600,73100,3,-1800,2015
100622,5.0,29633.0,16500,18000,68360,2,1500,2015
319462,3.4,85664.0,5125,6200,73200,11,1075,2015
292931,3.2,29695.0,25100,24000,59100,3,-1100,2015
414095,1.9,91397.0,7250,6200,61450,3,-1050,2015
517751,5.0,33496.0,35500,37000,71660,2,1500,2015
444026,1.9,145332.0,3575,5000,74430,12,1425,2015
37800,3.7,90107.0,5850,7200,77030,10,1350,2015
167484,2.5,43592.0,16400,14000,73100,3,-2400,2015
504024,2.8,54111.0,7875,6200,80610,3,-1675,2015
151132,2.1,62682.0,15950,16100,73100,9,150,2015
193535,1.9,233841.0,4050,500,67090,9,-3550,2015
453008,1.9,265501.0,1775,2600,61490,11,825,2015
400322,2.9,83049.0,9425,9200,61450,2,-225,2014
119185,3.8,35411.0,19200,21650,73100,4,2450,2015
525187,2.6,144822.0,2775,1200,70210,7,-1575,2014
452813,2.0,56239.0,5325,6700,61490,7,1375,2015
345127,2.8,200664.0,1725,2200,82750,11,475,2015
486326,1.9,125357.0,5675,5800,73130,7,125,2015
474037,3.1,78527.0,9600,4400,62930,8,-5200,2015
165449,3.5,55791.0,9925,9900,73100,2,-25,2015
38366,4.1,9682.0,24100,23400,77030,3,-700,2015
114317,4.2,36962.0,16950,17300,68360,2,350,2015
445124,4.2,22376.0,12450,13300,56120,1,850,2015
491413,2.6,20926.0,12300,10800,73130,2,-1500,2015
234907,,115308.0,5175,5800,59100,9,625,2014
510004,4.2,45917.0,15350,14500,71660,3,-850,2015
334844,2.4,51067.0,12350,11400,82750,2,-950,2015
48380,1.9,161621.0,2600,3000,77030,15,400,2015
285775,2.7,134571.0,6825,7200,59100,8,375,2015
181519,4.2,22657.0,24000,25000,83200,2,1000,2015
298210,2.6,23821.0,22500,21400,59100,3,-1100,2015
258478,4.2,38810.0,26900,27200,59100,3,300,2015
372709,3.7,115093.0,1125,1200,64520,14,75,2015
190241,2.7,66824.0,8250,8700,63250,2,450,2015
489958,4.0,22796.0,25000,25900,73130,1,900,2015
309952,1.9,41727.0,19700,15200,59100,3,-4500,2015
39853,3.4,24806.0,20600,19750,77030,3,-850,2015
73028,4.8,35694.0,36400,34500,77030,3,-1900,2015
218808,3.8,53489.0,7100,8200,57290,4,1100,2015
152368,3.0,150923.0,2675,2400,73100,7,-275,2015
108987,3.7,93238.0,4700,4800,68360,7,100,2015
157022,2.5,52456.0,8100,6700,73100,2,-1400,2015
222851,4.1,39517.0,11150,11300,89090,1,150,2014
180791,2.9,46828.0,11450,11300,83200,2,-150,2015
47815,4.0,27067.0,28600,27500,77030,3,-1100,2015
316854,3.0,126076.0,6000,5000,73200,9,-1000,2015
257501,5.0,14474.0,22800,20400,59100,1,-2400,2015
56928,4.6,5173.0,28700,27000,77030,1,-1700,2015
289210,4.0,36193.0,13050,13100,59100,1,50,2015
321058,4.1,41766.0,36500,36500,82750,2,0,2014
547177,1.9,128629.0,2325,1000,78090,9,-1325,2015
483008,4.5,33572.0,13250,14100,73130,3,850,2015
374502,2.9,76682.0,9475,9300,64520,5,-175,2015
122222,4.8,36619.0,10300,10900,73100,2,600,2014
279951,1.9,110354.0,1875,1450,59100,13,-425,2015
324828,5.0,8084.0,33700,35750,82750,1,2050,2015
56577,4.8,12612.0,23900,23500,77030,0,-400,2015
42150,4.0,9004.0,11550,12300,77030,1,750,2015
14428,4.5,5383.0,50300,50500,77030,1,200,2015
498602,4.8,30511.0,12700,14700,80610,2,2000,2014
239125,4.8,14533.0,18200,20900,59100,1,2700,2015
355161,2.0,1.0,7700,1800,62960,11,-5900,2015
470456,2.3,46473.0,8750,6500,62930,3,-2250,2014
255142,3.7,49325.0,23900,21200,59100,4,-2700,2015
227987,2.9,84316.0,7725,6700,89090,9,-1025,2015
105353,4.1,26332.0,14700,15000,68360,4,300,2015
389421,3.4,31093.0,10500,9800,65610,2,-700,2015
289071,2.7,121027.0,5825,4700,59100,12,-1125,2015
57946,3.3,34283.0,13550,13200,77030,1,-350,2015
336275,3.7,29720.0,21400,20800,82750,3,-600,2015
82428,1.9,24653.0,17350,8000,68360,1,-9350,2015
148614,4.6,25100.0,26100,25600,73100,3,-500,2015
279191,4.4,30053.0,16500,17000,59100,1,500,2015
194757,3.9,29156.0,12200,12400,67090,2,200,2015
497057,4.4,30970.0,27600,28800,73130,3,1200,2015
351391,3.4,165644.0,4150,4200,62960,9,50,2015
214327,4.6,30337.0,13050,13000,57290,1,-50,2015
242415,4.0,29292.0,15700,15300,59100,1,-400,2015
426176,1.9,225803.0,1600,1800,61450,12,200,2015
456160,2.0,84571.0,4475,3100,61490,7,-1375,2015
391776,3.9,20729.0,18300,18100,65610,1,-200,2015
147509,1.9,59795.0,8975,6900,73100,3,-2075,2015
297792,3.4,72254.0,11450,11800,59100,4,350,2015
286166,4.3,24813.0,14000,14000,59100,3,0,2015
121931,4.1,20423.0,13700,14300,73100,2,600,2014
327595,4.7,7457.0,18550,18600,82750,1,50,2015
31694,3.7,23959.0,22500,23500,77030,3,1000,2015
539619,1.9,223459.0,12500,9200,55590,1,-3300,2015
474838,2.4,49889.0,10300,10700,73130,3,400,2014
538254,4.3,7330.0,29200,30000,55590,1,800,2015
229190,2.0,80694.0,8225,5000,89090,4,-3225,2015
385371,3.8,27320.0,22400,19900,65610,2,-2500,2015
7347,2.8,150330.0,4750,3600,77030,11,-1150,2015
207547,4.9,26062.0,15600,18000,57290,1,2400,2015
356089,3.9,107928.0,9450,11300,62960,7,1850,2015
39386,4.7,18609.0,13550,13750,77030,2,200,2015
222393,3.9,96824.0,6700,6600,89090,4,-100,2014
152718,4.5,44977.0,15500,17600,73100,3,2100,2015
402462,2.3,202501.0,4825,4300,61450,9,-525,2015
145978,3.0,183089.0,825,600,73100,19,-225,2015
40371,1.0,123342.0,6100,4000,77030,9,-2100,2015
217682,3.9,31431.0,10300,8500,57290,2,-1800,2015
144741,3.2,131173.0,4275,3600,73100,8,-675,2015
42772,3.4,79973.0,6775,6500,77030,8,-275,2015
547962,1.9,148508.0,3300,1100,78090,9,-2200,2015
136275,2.6,27085.0,9050,7900,73100,3,-1150,2015
227155,2.0,85010.0,5725,4500,89090,8,-1225,2015
88899,3.6,28918.0,11250,11400,68360,2,150,2015
163057,3.6,36351.0,15550,14900,73100,3,-650,2015
323189,4.3,30758.0,12550,13500,82750,3,950,2015
384453,4.9,63392.0,8200,10000,65610,7,1800,2015
54925,4.5,23391.0,38800,38500,77030,2,-300,2015
67067,2.0,41952.0,7625,6100,77030,2,-1525,2015
275011,4.4,28695.0,13800,14000,59100,3,200,2015
176031,4.0,22476.0,19000,20300,83200,1,1300,2015
526035,1.9,124633.0,2350,1700,70210,11,-650,2015
221074,3.5,29544.0,13250,13500,57290,1,250,2015
464302,2.0,160903.0,2575,2500,61490,7,-75,2015
272855,2.7,78238.0,11350,8900,59100,8,-2450,2015
245677,4.9,33255.0,8925,10400,59100,8,1475,2015
195848,4.3,34384.0,27200,28750,67090,3,1550,2015
98839,2.9,9426.0,15100,16600,68360,2,1500,2015
477178,3.0,23959.0,13250,13300,73130,1,50,2015
62435,3.9,64037.0,8325,8900,77030,3,575,2015
374825,4.4,90417.0,12700,12500,64520,5,-200,2015
328119,4.7,18771.0,29700,30000,82750,1,300,2015
482262,3.0,37650.0,9625,10400,73130,4,775,2015
522369,1.9,120729.0,5275,6100,71660,10,825,2015
237919,2.6,39726.0,8450,9000,59100,4,550,2014
304523,2.6,36481.0,21300,20500,59100,2,-800,2015
194481,2.4,67220.0,22000,23700,67090,7,1700,2015
263776,3.2,80454.0,19400,18400,59100,4,-1000,2015
377818,2.5,137361.0,1875,1200,64520,11,-675,2015
27475,3.0,38407.0,23200,21700,77030,2,-1500,2015
128314,4.4,7426.0,13350,13200,73100,2,-150,2015
447565,4.3,57113.0,9100,9600,56120,2,500,2015
65973,2.2,39975.0,10300,10000,77030,1,-300,2015
512485,2.6,83533.0,8900,9000,71660,4,100,2015
46315,3.2,108600.0,6075,8100,77030,9,2025,2015
251213,4.0,22928.0,23600,24000,59100,4,400,2015
542392,3.3,58639.0,11750,12000,81400,3,250,2015
239277,4.4,17454.0,29400,29000,59100,1,-400,2015
260528,2.8,118000.0,5500,4600,59100,8,-900,2015
58104,3.0,23856.0,18100,17900,77030,1,-200,2015
32612,4.3,7125.0,19800,20750,77030,1,950,2015
70215,3.9,18597.0,19400,19500,77030,1,100,2015
504339,4.8,31487.0,27200,27500,80610,1,300,2015
211167,4.2,128700.0,15250,15500,57290,4,250,2015
113783,1.9,120910.0,3975,1800,68360,6,-2175,2015
278726,3.2,61565.0,14150,13600,59100,3,-550,2015
70443,2.8,58501.0,21700,21500,77030,2,-200,2015
125228,2.7,50926.0,26500,29900,73100,4,3400,2015
381920,3.4,60421.0,18500,23100,64520,13,4600,2015
497001,3.0,11.0,23000,25000,73130,0,2000,2015
98100,3.7,14105.0,16950,17600,68360,3,650,2015
334764,2.3,89741.0,6600,7400,82750,8,800,2015
70996,4.6,8628.0,128000,108000,77030,0,-20000,2015
411883,3.8,100268.0,5450,5900,61450,7,450,2015
491943,3.8,60433.0,23200,23150,73130,2,-50,2015
190652,1.9,99634.0,1450,1250,63250,12,-200,2015
429100,2.9,50070.0,9575,7700,61450,2,-1875,2015
240977,1.9,142548.0,1575,1300,59100,15,-275,2014
523267,3.4,101816.0,9050,8600,71660,3,-450,2015
251061,5.0,20786.0,16050,16200,59100,0,150,2015
198633,3.6,38786.0,20500,20000,67090,3,-500,2015
525507,4.4,37703.0,14950,15100,70210,2,150,2015
322593,4.0,95035.0,5150,5400,82750,13,250,2015
433883,1.9,141380.0,5125,2400,74430,12,-2725,2014
74620,,144276.0,1675,2400,68360,10,725,2014
77303,3.5,78803.0,6250,6200,68360,3,-50,2014
26707,3.7,45878.0,9975,10100,77030,4,125,2015
273202,2.6,2508.0,10800,10600,59100,0,-200,2015
413943,4.6,39078.0,11750,12100,61450,1,350,2015
69684,4.3,8845.0,33900,34250,77030,3,350,2015
71475,4.3,19501.0,21000,19500,77030,2,-1500,2015
365385,1.9,59260.0,9800,6250,64520,4,-3550,2015
410212,3.8,91439.0,4875,5500,61450,11,625,2015
468491,4.4,44866.0,10100,11300,61490,2,1200,2015
418889,2.7,43903.0,17100,16000,61450,3,-1100,2015
60269,3.5,33993.0,18600,18750,77030,3,150,2015
506770,2.7,93051.0,3975,3300,80200,10,-675,2015
250598,2.0,136296.0,1050,900,59100,13,-150,2015
211045,4.4,14801.0,26000,28000,57290,2,2000,2015
262126,4.8,31961.0,16350,18200,59100,1,1850,2015
329403,3.9,111236.0,9275,9600,82750,7,325,2015
3034,2.4,102192.0,2800,2900,77030,6,100,2014
405858,4.7,28860.0,25400,26500,61450,2,1100,2015
429075,4.6,29782.0,11300,12300,61450,1,1000,2015
418614,2.0,52181.0,16250,15200,61450,2,-1050,2015
116373,1.9,90153.0,4400,4000,68360,8,-400,2015
226779,2.2,175415.0,3575,2300,89090,12,-1275,2015
514004,4.8,31832.0,24900,25800,71660,3,900,2015
460065,3.2,57321.0,11650,12100,61490,2,450,2015
101261,3.9,122362.0,14100,12000,68360,7,-2100,2015
504467,4.8,15492.0,32500,29300,80610,1,-3200,2015
118251,4.7,92966.0,10900,10000,68360,8,-900,2015
22864,1.0,49212.0,12550,9200,77030,2,-3350,2015
210096,4.1,18155.0,27400,30200,57290,9,2800,2015
110516,2.7,152240.0,1725,1200,68360,6,-525,2015
13867,1.9,70157.0,7275,6000,77030,7,-1275,2015
229847,4.9,10055.0,31200,32000,89090,1,800,2015
477561,2.4,140397.0,6525,5700,73130,6,-825,2014
438133,2.3,118093.0,1450,1300,74430,16,-150,2015
221320,2.0,64674.0,15950,14600,57290,3,-1350,2015
274355,1.9,76454.0,7525,7800,59100,5,275,2015
425676,1.9,185310.0,1075,600,61450,14,-475,2015
394292,4.2,63483.0,23000,22700,65610,4,-300,2015
117744,4.8,13558.0,22100,22400,68360,1,300,2015
249619,1.9,136448.0,2625,1400,59100,12,-1225,2015
366834,3.7,46760.0,22300,21000,64520,2,-1300,2015
490723,4.0,14927.0,19650,19000,73130,0,-650,2015
416558,3.5,137179.0,3700,4300,61450,9,600,2015
272790,3.2,52296.0,9025,7200,59100,7,-1825,2015
42280,3.5,55624.0,9575,9800,77030,2,225,2015
333857,1.0,98824.0,8425,6000,82750,9,-2425,2015
135704,3.3,48301.0,28300,24900,73100,3,-3400,2015
3305,1.9,91199.0,15200,15500,77030,7,300,2014
409079,4.1,11426.0,16200,17300,61450,1,1100,2015
464145,1.9,173486.0,3675,3100,61490,10,-575,2015
32041,4.7,48574.0,29200,31250,77030,7,2050,2015
455168,3.7,66302.0,8500,9900,61490,4,1400,2015
17372,4.5,32387.0,17850,16700,77030,1,-1150,2015
425277,4.8,9383.0,21800,21800,61450,1,0,2015
167253,5.0,9734.0,23200,20800,73100,1,-2400,2015
3496,3.0,132960.0,11000,11500,77030,7,500,2014
290576,2.7,59384.0,8200,7800,59100,5,-400,2015
190378,3.4,54754.0,14550,13200,63250,1,-1350,2015
61233,2.0,115901.0,3450,2800,77030,10,-650,2015
156799,2.7,95735.0,11400,11600,73100,8,200,2015
181548,2.9,26554.0,18600,16600,83200,4,-2000,2015
226059,3.1,115845.0,3950,4600,89090,8,650,2015
527500,3.5,34653.0,11850,11000,70210,3,-850,2015
235322,,153867.0,4175,3700,59100,11,-475,2014
522218,2.8,79183.0,7400,6900,71660,3,-500,2015
368824,4.2,50993.0,12250,12201,64520,2,-49,2015
101830,3.5,82564.0,8650,8500,68360,7,-150,2015
42779,2.2,94267.0,9675,8600,77030,8,-1075,2015
225057,2.0,163996.0,1750,1300,89090,12,-450,2015
345187,4.2,52488.0,22200,20400,82750,2,-1800,2015
438404,5.0,9935.0,15950,16500,74430,0,550,2015
94597,2.5,143632.0,1825,2300,68360,9,475,2015
35416,4.4,35825.0,13650,14100,77030,1,450,2015
225572,2.9,97220.0,5750,5600,89090,7,-150,2015
166033,4.3,46162.0,26900,26400,73100,2,-500,2015
145671,3.5,13782.0,22500,23000,73100,1,500,2015
515212,3.7,22272.0,14100,15800,71660,2,1700,2015
506572,3.1,34262.0,16000,15400,80200,2,-600,2015
507581,3.8,58207.0,20800,21100,80200,3,300,2015
118196,4.5,62932.0,9150,9200,68360,6,50,2015
308788,5.0,15158.0,10800,10700,59100,1,-100,2015
266598,3.3,39048.0,28100,26000,59100,6,-2100,2015
63739,3.5,110364.0,3200,4000,77030,10,800,2015
205623,4.9,21162.0,23500,23000,57290,1,-500,2015
465876,4.5,38018.0,29800,30600,61490,4,800,2015
357338,3.4,39027.0,13000,12000,62960,1,-1000,2015
398750,2.0,267879.0,100,500,61450,16,400,2015
272272,3.3,47828.0,26500,25600,59100,3,-900,2015
476511,3.2,38570.0,23900,23600,73130,1,-300,2014
70884,4.9,23746.0,14000,16000,77030,3,2000,2015
359410,4.2,32757.0,13450,14400,62960,1,950,2015
502388,2.4,96828.0,8825,9200,80610,5,375,2015
244844,4.0,87959.0,50700,45500,59100,2,-5200,2015
181551,3.6,51460.0,10400,10400,83200,1,0,2015
260598,3.8,72457.0,4675,7500,59100,9,2825,2015
132806,4.1,40694.0,15150,14600,73100,4,-550,2015
267119,4.2,11851.0,18250,18500,59100,1,250,2015
16831,3.6,41189.0,22200,23000,77030,5,800,2015
5086,,150478.0,2150,250,77030,14,-1900,2014
269661,3.6,161797.0,6900,6200,59100,13,-700,2015
357347,4.2,18587.0,11600,11300,62960,1,-300,2015
422063,4.6,27773.0,11850,13700,61450,5,1850,2015
370207,4.7,30185.0,31200,29900,64520,2,-1300,2015
535285,4.1,63196.0,15150,17200,82150,7,2050,2015
251630,3.5,48601.0,31500,30800,59100,5,-700,2015
437878,2.8,115649.0,4000,6100,74430,10,2100,2015
256688,4.7,16308.0,12250,12100,59100,3,-150,2015
478112,4.0,40381.0,18400,18800,73130,1,400,2015
231257,3.3,44637.0,16850,16750,89090,2,-100,2015
544558,2.4,76822.0,23900,24800,81400,7,900,2015
227131,3.3,108666.0,4750,4300,89090,7,-450,2015
404488,4.9,27004.0,19850,19000,61450,1,-850,2015
531288,3.5,57022.0,14350,14000,82150,2,-350,2015
544704,4.5,51536.0,20000,23800,81400,6,3800,2015
480715,2.6,98058.0,6250,4900,73130,7,-1350,2015
476599,4.4,34390.0,22200,23400,73130,1,1200,2014
279644,3.7,54911.0,11200,11000,59100,3,-200,2015
363800,3.6,42300.0,22300,21200,64520,3,-1100,2015
5962,3.7,38764.0,28200,28300,77030,1,100,2014
187106,3.9,12433.0,18100,17500,63250,1,-600,2015
213195,5.0,2473.0,39400,44200,57290,1,4800,2015
188513,3.6,57253.0,14700,14300,63250,2,-400,2015
249485,4.0,10575.0,12750,11900,59100,1,-850,2015
97113,2.5,89254.0,9650,9800,68360,6,150,2015
475790,,106403.0,3775,6500,73130,9,2725,2014
53896,4.7,24078.0,22900,24400,77030,3,1500,2015
47415,1.9,167125.0,1100,800,77030,12,-300,2015
85682,3.6,36118.0,9875,10800,68360,2,925,2015
482805,2.5,93378.0,4325,4800,73130,8,475,2015
228822,4.2,78450.0,10200,10000,89090,4,-200,2015
180447,4.4,14903.0,15300,15500,83200,1,200,2015
334454,3.6,141968.0,7525,6000,82750,9,-1525,2015
399803,2.0,127798.0,875,1100,61450,12,225,2014
311090,2.0,136000.0,2725,2200,59100,10,-525,2015
536435,2.0,39606.0,14500,11600,73640,2,-2900,2015
328079,3.9,40066.0,19000,18600,82750,4,-400,2015
143033,3.8,24480.0,11950,11700,73100,2,-250,2015
314040,2.8,192104.0,2025,1800,59100,15,-225,2015
278521,1.9,116462.0,5475,4800,59100,9,-675,2015
458824,4.3,50016.0,19050,19000,61490,1,-50,2015
241357,2.8,25669.0,22200,19800,59100,3,-2400,2015
114667,4.2,88930.0,18350,19300,68360,5,950,2015
104102,4.0,49986.0,9150,9800,68360,4,650,2015
445137,3.0,30131.0,12600,10400,56120,1,-2200,2015
484486,4.0,34034.0,16600,16600,73130,4,0,2015
395495,3.5,67641.0,33200,29500,65610,4,-3700,2015
538417,2.3,68735.0,6075,6300,55590,7,225,2015
299592,1.9,110003.0,12900,6400,59100,7,-6500,2015
292202,2.2,137613.0,3925,1500,59100,7,-2425,2015
56713,4.6,23092.0,31100,26000,77030,3,-5100,2015
362900,2.6,109196.0,4425,4400,64520,4,-25,2014
360304,3.4,65234.0,30200,30250,62960,6,50,2015
372663,2.9,49251.0,38600,39100,64520,3,500,2015
429927,3.6,64877.0,16400,16900,61450,5,500,2015
80516,3.9,48508.0,9950,10000,68360,2,50,2015
482681,3.0,15314.0,15050,14900,73130,1,-150,2015
535764,3.8,35156.0,26300,25000,82150,3,-1300,2015
496790,4.8,17484.0,23600,26700,73130,2,3100,2015
284544,4.3,42400.0,11900,11600,59100,3,-300,2015
258623,4.2,27464.0,12350,15400,59100,3,3050,2015
248581,4.8,34983.0,14750,15400,59100,2,650,2015
547359,2.9,106972.0,2225,1000,78090,11,-1225,2015
10261,3.4,51292.0,11350,11100,77030,2,-250,2014
154922,2.7,95302.0,12450,11200,73100,4,-1250,2015
134714,2.0,92385.0,2850,400,73100,12,-2450,2015
312397,3.8,32256.0,12100,12400,59100,3,300,2015
208398,4.8,14524.0,31200,26600,57290,1,-4600,2015
57774,4.6,17446.0,21600,22750,77030,2,1150,2015
247758,3.7,37442.0,19150,18400,59100,4,-750,2015
470826,3.5,106684.0,4150,4600,62930,6,450,2014
364475,1.9,120106.0,3125,500,64520,11,-2625,2015
381141,3.6,15459.0,26100,26500,64520,2,400,2015
110869,1.9,78879.0,7600,7100,68360,12,-500,2015
282870,3.5,88506.0,9225,9400,59100,5,175,2015
167601,4.2,22894.0,19650,19900,73100,0,250,2015
215591,3.5,73401.0,17450,16600,57290,8,-850,2015
360458,4.1,67820.0,9175,10500,62960,4,1325,2015
88901,3.9,78728.0,9900,11700,68360,3,1800,2015
183192,2.0,135609.0,1375,850,63250,12,-525,2014
81945,2.9,177330.0,2325,2600,68360,8,275,2015
187345,1.9,114075.0,5025,3600,63250,9,-1425,2015
221698,4.4,18539.0,19100,18500,57290,1,-600,2015
457543,3.7,40788.0,12450,12600,61490,1,150,2015
183601,,16495.0,34800,31500,63250,8,-3300,2014
188771,3.2,29550.0,31300,30500,63250,1,-800,2015
539565,4.2,47394.0,12800,10600,55590,3,-2200,2015
246277,4.7,5059.0,14850,15400,59100,2,550,2015
486425,4.2,5214.0,36000,30200,73130,1,-5800,2015
289252,2.7,44936.0,10700,10900,59100,2,200,2015
8603,4.2,22395.0,36000,37200,77030,3,1200,2015
326152,3.6,24885.0,10750,10100,82750,1,-650,2015
255870,4.3,9582.0,34000,35200,59100,2,1200,2015
181574,3.4,46893.0,9400,9500,83200,2,100,2015
410023,2.8,192943.0,975,1100,61450,15,125,2015
119834,4.2,41607.0,24800,24500,73100,4,-300,2014
104266,2.0,103499.0,18800,12900,68360,8,-5900,2015
109058,1.9,180285.0,1600,550,68360,14,-1050,2015
16282,4.8,21195.0,10300,11900,77030,3,1600,2015
446977,2.8,126313.0,5575,5900,56120,9,325,2015
66964,2.0,114633.0,8875,4100,77030,12,-4775,2015
91399,2.6,114588.0,5750,4000,68360,9,-1750,2015
371863,2.4,206110.0,1000,1100,64520,8,100,2015
244958,3.5,53948.0,9250,10000,59100,3,750,2015
474543,1.9,235813.0,3600,4200,62930,5,600,2015
536218,1.9,95689.0,4425,5100,82150,12,675,2015
215915,4.4,10381.0,38300,39500,57290,1,1200,2015
81365,3.8,47218.0,8950,9200,68360,3,250,2015
25197,3.9,23691.0,15100,14500,77030,1,-600,2015
150853,2.0,109636.0,6675,5800,73100,7,-875,2015
225077,2.0,248838.0,850,300,89090,17,-550,2015
87310,3.3,48889.0,9100,7800,68360,10,-1300,2015
312432,2.2,27283.0,13850,12100,59100,3,-1750,2015
422875,3.8,92337.0,16650,17000,61450,2,350,2015
320166,,43608.0,8925,7700,82750,4,-1225,2014
154719,5.0,8790.0,29000,28000,73100,1,-1000,2015
537873,2.4,63631.0,8550,8400,55590,2,-150,2014
212505,3.9,78182.0,5575,7000,57290,9,1425,2015
461429,3.4,137479.0,5000,5400,61490,9,400,2015
529331,2.7,71160.0,10000,8400,70210,7,-1600,2015
73703,2.6,104200.0,9600,7800,68360,6,-1800,2014
160433,3.7,77147.0,13450,12900,73100,6,-550,2015
396735,4.3,21073.0,13100,13600,65610,2,500,2015
433187,1.0,226479.0,1725,700,74430,10,-1025,2014
334859,3.7,62903.0,14900,14700,82750,2,-200,2015
289460,2.0,173064.0,975,1700,59100,12,725,2015
98776,2.8,115709.0,7250,9700,68360,10,2450,2015
319230,3.6,53880.0,10100,10100,73200,2,0,2015
256258,2.9,140615.0,6425,5500,59100,10,-925,2015
353402,3.6,71245.0,15200,16250,62960,7,1050,2015
17665,3.9,22142.0,24600,25250,77030,2,650,2015
17747,3.9,21705.0,22300,20500,77030,2,-1800,2015
432503,2.0,79044.0,6100,5100,74430,5,-1000,2015
45578,4.2,25215.0,16100,15100,77030,2,-1000,2015
150381,3.9,19348.0,13450,14200,73100,3,750,2015
45327,1.4,138028.0,2300,2600,77030,12,300,2015
432479,4.0,13069.0,17150,17100,74430,0,-50,2014
310217,3.5,52762.0,19750,20300,59100,3,550,2015
21507,1.9,179851.0,1425,900,77030,14,-525,2015
316318,,230481.0,1350,2700,73200,12,1350,2014
226326,4.1,20708.0,25000,24000,89090,1,-1000,2015
373311,4.7,6088.0,46800,47000,64520,1,200,2015
271680,1.9,158058.0,2350,1000,59100,8,-1350,2015
135413,4.6,11187.0,55500,56250,73100,1,750,2015
384449,2.0,124433.0,4175,3900,65610,6,-275,2015
240702,1.9,72664.0,4600,3300,59100,9,-1300,2014
254046,3.8,37834.0,20900,20800,59100,1,-100,2015
325509,3.5,97918.0,10450,9000,82750,3,-1450,2015
519537,4.4,53420.0,20200,20700,71660,4,500,2015
101343,1.9,99642.0,11850,12500,68360,8,650,2015
262592,4.7,17112.0,12850,12700,59100,3,-150,2015
155732,2.4,47132.0,21500,20500,73100,3,-1000,2015
336335,3.7,12086.0,13450,12800,82750,3,-650,2015
294167,4.7,15005.0,39800,43200,59100,0,3400,2015
371547,4.9,67522.0,18450,18800,64520,5,350,2015
341053,2.3,43738.0,21200,18200,82750,4,-3000,2015
422635,4.4,69942.0,11400,12500,61450,7,1100,2015
384637,4.2,49747.0,21000,21900,65610,4,900,2015
345892,2.9,28928.0,15500,13000,82750,2,-2500,2015
297411,2.8,40888.0,14750,13200,59100,6,-1550,2015
1053,,21072.0,17550,13400,77030,2,-4150,2014
289489,2.6,54215.0,4825,6300,59100,15,1475,2015
413930,4.1,31191.0,10400,10600,61450,1,200,2015
498178,1.9,59381.0,11550,11200,73130,2,-350,2015
67623,1.0,29630.0,11950,8000,77030,3,-3950,2015
266609,1.9,139570.0,3825,2200,59100,6,-1625,2015
539167,3.5,132676.0,3050,4800,55590,11,1750,2015
21099,3.0,96826.0,7750,8300,77030,8,550,2015
344880,4.8,152062.0,5375,5500,82750,7,125,2015
290186,4.9,15960.0,17950,17800,59100,1,-150,2015
93316,3.7,38387.0,13850,14200,68360,2,350,2015
524675,,117414.0,2850,2900,70210,12,50,2014
500810,2.5,99274.0,15800,13300,80610,4,-2500,2015
222333,3.4,63574.0,9675,9100,89090,2,-575,2014
454099,2.1,175220.0,1300,1800,61490,16,500,2015
240564,1.9,110590.0,6100,5600,59100,7,-500,2014
351115,3.6,38224.0,9925,9900,62960,1,-25,2015
205218,4.5,51008.0,15500,15500,57290,4,0,2015
36272,4.3,48390.0,18000,20000,77030,2,2000,2015
459563,4.1,68495.0,25200,27500,61490,2,2300,2015
358812,4.5,11726.0,15050,15000,62960,1,-50,2015
470612,,159583.0,4925,5400,62930,8,475,2014
528494,3.6,79431.0,5175,5200,70210,5,25,2015
195808,5.0,37075.0,44500,47200,67090,3,2700,2015
426177,2.0,102811.0,2050,1900,61450,12,-150,2015
529073,2.3,111032.0,2425,1200,70210,9,-1225,2015
55538,2.7,139680.0,2350,3400,77030,15,1050,2015
541709,4.5,34050.0,20500,21700,81400,3,1200,2015
226467,2.9,108361.0,11500,10000,89090,4,-1500,2015
333532,3.7,82754.0,21900,18000,82750,1,-3900,2015
143340,4.6,19595.0,23200,23100,73100,2,-100,2015
413568,2.8,58593.0,12700,12700,61450,3,0,2015
80737,4.4,105978.0,10650,10800,68360,4,150,2015
224030,1.0,138145.0,4675,2500,89090,7,-2175,2015
6992,,80945.0,3450,5100,77030,7,1650,2014
445433,4.8,84291.0,7225,6700,56120,4,-525,2015
390106,4.5,50635.0,17350,17600,65610,2,250,2015
476251,,104288.0,825,650,73130,14,-175,2014
309861,3.4,42134.0,31600,29600,59100,3,-2000,2015
381237,4.0,19118.0,11500,11800,64520,2,300,2015
399123,2.9,38036.0,13400,11900,61450,2,-1500,2014
222843,5.0,21324.0,22700,24200,89090,0,1500,2014
131629,4.1,26802.0,12650,13700,73100,3,1050,2015
18000,2.7,77796.0,21000,19100,77030,5,-1900,2015
333786,4.1,48321.0,15300,15200,82750,4,-100,2015
401397,2.4,49146.0,12000,11500,61450,1,-500,2014
544529,3.9,68329.0,14900,14600,81400,4,-300,2015
138005,2.9,42010.0,11750,9700,73100,3,-2050,2015
81919,2.6,36803.0,5000,5800,68360,7,800,2015
397816,1.9,80291.0,10150,10100,61450,4,-50,2014
485543,4.0,39709.0,24700,25600,73130,3,900,2015
375954,3.8,45122.0,16900,17700,64520,3,800,2015
403769,3.7,38754.0,14050,14600,61450,3,550,2015
295181,4.1,20081.0,28400,27000,59100,1,-1400,2015
548032,4.9,3254.0,17250,17250,78090,0,0,2015
315160,3.7,32695.0,15450,15100,59100,4,-350,2015
507989,3.9,33947.0,17950,17600,71660,0,-350,2014
516633,4.2,25560.0,35100,33800,71660,2,-1300,2015
369673,4.3,24190.0,13100,12500,64520,2,-600,2015
386032,3.8,40149.0,27300,23900,65610,6,-3400,2015
15050,2.0,84630.0,7325,5100,77030,7,-2225,2015
303332,4.4,11831.0,19750,20900,59100,1,1150,2015
116175,3.7,82654.0,10500,11400,68360,4,900,2015
497253,1.9,107317.0,6225,5700,73130,6,-525,2015
414529,3.2,52048.0,10450,10400,61450,3,-50,2015
203606,4.3,48473.0,10500,12100,57290,3,1600,2015
240422,2.2,38999.0,27400,26300,59100,6,-1100,2015
40847,4.2,29078.0,23400,23500,77030,2,100,2015
546851,3.9,70304.0,22500,22000,81400,6,-500,2015
439350,2.7,71536.0,15300,16200,74430,8,900,2015
542708,4.7,16977.0,16600,18300,81400,2,1700,2015
160882,4.3,55911.0,24000,18500,73100,5,-5500,2015
214437,4.6,41180.0,39100,38900,57290,1,-200,2015
5993,4.1,37440.0,11350,12100,77030,1,750,2014
448898,2.4,149954.0,3275,3000,61490,6,-275,2014
341638,2.9,86819.0,13450,14800,82750,6,1350,2015
51405,1.9,139929.0,1250,2000,77030,11,750,2015
420245,2.5,105782.0,4400,4500,61450,9,100,2015
487192,4.6,25250.0,17950,17200,73130,1,-750,2015
284296,4.4,34729.0,13900,14600,59100,2,700,2015
228090,3.5,61694.0,11650,11400,89090,2,-250,2015
392483,2.7,139042.0,5925,6950,65610,9,1025,2015
349798,4.9,10066.0,41500,45000,62960,1,3500,2015
151962,4.3,100512.0,9200,8700,73100,7,-500,2015
527141,4.1,41389.0,9500,9600,70210,3,100,2015
33247,3.8,28895.0,15800,18500,77030,3,2700,2015
374747,5.0,16459.0,15950,16300,64520,2,350,2015
489272,2.5,139805.0,8850,9300,73130,6,450,2015
69618,3.2,37869.0,39200,40000,77030,3,800,2015
255274,3.8,170403.0,5025,6000,59100,10,975,2015
329063,3.7,43952.0,17650,16600,82750,3,-1050,2015
207831,2.8,38652.0,9825,9000,57290,2,-825,2015
213610,4.8,18083.0,27900,29000,57290,3,1100,2015
415419,3.4,43184.0,41500,39000,61450,3,-2500,2015
470150,3.7,126456.0,3525,5300,61490,8,1775,2015
128008,4.3,31338.0,8575,10200,73100,7,1625,2015
49281,3.8,32523.0,19850,21750,77030,3,1900,2015
520575,3.6,48570.0,13100,13200,71660,2,100,2015
388,3.6,54715.0,9900,10600,77030,1,700,2014
502906,4.4,41918.0,39000,40300,80610,1,1300,2015
238943,2.9,123531.0,2075,2600,59100,14,525,2014
54618,4.6,3174.0,13300,14000,77030,2,700,2015
41606,4.0,74374.0,9375,13000,77030,8,3625,2015
389906,2.8,149243.0,1925,1900,65610,11,-25,2015
319089,2.8,41978.0,12500,12200,73200,2,-300,2015
251376,2.0,151696.0,7100,6400,59100,9,-700,2015
99616,2.8,56622.0,13200,13200,68360,6,0,2015
119941,2.6,97458.0,11300,10700,73100,4,-600,2014
23657,2.9,69671.0,20400,21000,77030,11,600,2015
245360,3.9,26948.0,15250,14200,59100,6,-1050,2015
362244,2.6,165124.0,3900,3900,64520,6,0,2014
106652,2.5,160663.0,4800,3100,68360,11,-1700,2015
180546,4.4,46666.0,13100,13900,83200,4,800,2015
322488,3.1,79613.0,5125,5700,82750,9,575,2015
340959,4.4,35197.0,16350,16600,82750,3,250,2015
285389,4.0,32723.0,14850,14500,59100,1,-350,2015
366375,1.9,104301.0,2000,400,64520,7,-1600,2015
122601,4.3,45745.0,16750,18000,73100,2,1250,2014
302341,3.1,103377.0,5725,4500,59100,10,-1225,2015
127367,2.9,38419.0,35000,35600,73100,2,600,2015
208572,1.9,102789.0,4350,3100,57290,5,-1250,2015
232152,3.8,29821.0,22900,22000,89090,2,-900,2015
83379,4.1,51230.0,26600,25800,68360,1,-800,2015
260566,1.9,186879.0,2400,3400,59100,9,1000,2015
292732,3.7,31936.0,19850,18200,59100,1,-1650,2015
151556,1.9,78702.0,4750,3800,73100,10,-950,2015
116340,3.7,127647.0,4400,3500,68360,7,-900,2015
113598,4.8,32512.0,14450,14300,68360,1,-150,2015
407138,3.7,63686.0,16400,16000,61450,2,-400,2015
411862,2.7,106802.0,6400,5800,61450,7,-600,2015
174229,4.7,6836.0,11950,12300,83200,1,350,2014
224576,2.0,113515.0,2100,1900,89090,14,-200,2015
369769,4.1,48941.0,18600,17300,64520,3,-1300,2015
18509,4.3,98453.0,5375,7900,77030,11,2525,2015
297528,4.4,20126.0,13100,12300,59100,1,-800,2015
518862,4.3,18200.0,13400,15500,71660,3,2100,2015
466043,3.6,192980.0,1350,2900,61490,17,1550,2015
8264,,177404.0,5075,4100,77030,11,-975,2014
79107,3.4,17683.0,11950,11900,68360,1,-50,2015
341143,4.5,25819.0,15200,14700,82750,1,-500,2015
395452,4.2,51139.0,9075,9000,65610,2,-75,2015
164802,2.0,151608.0,1100,800,73100,9,-300,2015
194454,4.2,36420.0,14350,14900,67090,3,550,2015
210274,4.9,31591.0,21600,21900,57290,1,300,2015
329857,3.3,25227.0,13850,13000,82750,3,-850,2015
338860,3.6,33879.0,9875,8900,82750,2,-975,2015
115541,3.6,110926.0,6600,7900,68360,3,1300,2015
540674,4.4,60927.0,10250,12500,81400,3,2250,2015
235694,3.5,31555.0,22900,21600,59100,1,-1300,2015
85115,4.6,71698.0,16450,16400,68360,4,-50,2015
32125,3.4,129926.0,12850,12200,77030,8,-650,2015
17209,3.9,90522.0,2250,3300,77030,12,1050,2015
427017,2.0,162483.0,11000,7000,61450,9,-4000,2015
63252,3.3,128457.0,7750,8700,77030,7,950,2015
426004,4.4,15992.0,12150,13000,61450,0,850,2015
75758,4.2,26636.0,21800,21500,68360,3,-300,2015
529610,2.5,93605.0,3700,2800,82150,7,-900,2014
25097,2.1,113100.0,3475,3200,77030,9,-275,2015
379718,5.0,29565.0,29500,31600,64520,1,2100,2015
367427,4.7,21606.0,15500,16100,64520,4,600,2015
476831,3.3,55409.0,12950,12900,73130,2,-50,2014
452388,3.3,124754.0,7700,7200,61490,9,-500,2015
29186,4.4,13468.0,37700,33500,77030,1,-4200,2015
12021,2.8,138712.0,3550,2700,77030,9,-850,2015
361084,4.2,91027.0,8550,8000,64520,2,-550,2014
145141,2.6,141705.0,3725,2400,73100,14,-1325,2015
480943,3.1,31206.0,23300,21500,73130,4,-1800,2015
466508,3.3,46453.0,12550,13400,61490,1,850,2015
47938,2.9,72612.0,19250,19800,77030,3,550,2015
43260,3.6,42158.0,32500,31500,77030,2,-1000,2015
418248,2.1,23795.0,22700,22200,61450,3,-500,2015
531639,2.7,77380.0,8875,8900,82150,9,25,2015
152806,4.4,81867.0,16850,15900,73100,4,-950,2015
395470,4.4,52481.0,11100,11200,65610,2,100,2015
54719,2.0,1.0,20800,10500,77030,8,-10300,2015
533476,2.7,134380.0,4325,3100,82150,10,-1225,2015
46302,4.1,190271.0,6525,8000,77030,9,1475,2015
265304,4.2,29873.0,19150,20800,59100,1,1650,2015
247590,4.7,10936.0,32900,33600,59100,3,700,2015
520736,5.0,932.0,18550,18300,71660,0,-250,2015
189276,2.9,73013.0,7550,7800,63250,3,250,2015
537943,3.5,58164.0,9550,10000,55590,3,450,2015
262962,4.2,35812.0,21400,21400,59100,1,0,2015
238374,3.5,175575.0,5975,5200,59100,8,-775,2014
95663,4.3,31346.0,13550,13800,68360,2,250,2015
425124,2.6,2660.0,10950,9200,61450,0,-1750,2015
300042,2.2,126897.0,8525,7900,59100,7,-625,2015
387854,2.5,50087.0,9450,9800,65610,3,350,2015
505687,4.2,32359.0,19100,20000,80610,3,900,2015
419651,3.5,48401.0,11650,11100,61450,3,-550,2015
332632,3.6,29485.0,21600,20100,82750,3,-1500,2015
302918,4.3,45651.0,21500,22200,59100,3,700,2015
458657,2.0,111514.0,4425,4300,61490,12,-125,2015
507079,2.0,135033.0,8125,8600,80200,8,475,2015
190230,2.3,77757.0,9800,9500,63250,7,-300,2015
202567,3.7,52257.0,8500,8500,57290,2,0,2014
18953,2.9,38808.0,13250,12500,77030,3,-750,2015
1028,2.8,22548.0,10500,10500,77030,2,0,2014
174347,4.9,19191.0,18150,19800,83200,2,1650,2015
285823,2.2,56395.0,11900,10100,59100,9,-1800,2015
189403,4.4,8290.0,9225,9800,63250,2,575,2015
518445,3.6,25555.0,23800,25400,71660,1,1600,2015
434081,1.0,139949.0,750,700,74430,15,-50,2014
20303,3.7,24152.0,10300,11300,77030,2,1000,2015
6561,4.2,34177.0,35100,35250,77030,2,150,2014
185794,3.0,67872.0,11300,12400,63250,5,1100,2015
460085,2.6,53953.0,15550,14500,61490,3,-1050,2015
414331,3.7,29850.0,16200,17700,61450,1,1500,2015
479454,2.7,98094.0,4250,4000,73130,8,-250,2015
94481,1.8,1.0,8775,6200,68360,7,-2575,2015
124455,4.7,22664.0,17950,18500,73100,4,550,2015
397871,,58741.0,8300,9800,61450,4,1500,2014
366233,4.1,92907.0,7450,6200,64520,7,-1250,2015
278527,1.9,125424.0,9500,9300,59100,9,-200,2015
497879,3.6,29669.0,14600,15600,73130,3,1000,2015
101867,1.9,80229.0,4125,3700,68360,8,-425,2015
285939,4.0,26281.0,16450,15700,59100,1,-750,2015
448538,2.5,125629.0,12300,12900,56120,7,600,2015
291179,4.9,3482.0,17100,16600,59100,1,-500,2015
206407,3.9,31622.0,19250,17200,57290,4,-2050,2015
499489,2.7,21310.0,17500,16800,80610,3,-700,2015
271913,1.9,68021.0,11700,11901,59100,2,201,2015
210498,5.0,20056.0,28700,28200,57290,1,-500,2015
231813,2.1,170736.0,1350,1200,89090,13,-150,2015
263642,2.2,37684.0,14400,12400,59100,3,-2000,2015
250027,4.1,18121.0,32000,28700,59100,1,-3300,2015
131280,4.3,7468.0,15950,16500,73100,2,550,2015
149926,1.9,38801.0,13500,11800,73100,2,-1700,2015
62627,3.5,63285.0,8325,7100,77030,8,-1225,2015
355151,1.9,120666.0,1950,1200,62960,11,-750,2015
170231,2.6,21934.0,7900,6200,73100,2,-1700,2015
203533,3.2,29243.0,12350,12300,57290,3,-50,2015
199115,2.3,53654.0,9575,10000,67090,2,425,2015
348349,1.4,118003.0,1075,600,62960,12,-475,2014
106551,3.7,30805.0,31500,29800,68360,1,-1700,2015
51758,3.7,36411.0,21000,21750,77030,2,750,2015
542915,4.9,10437.0,17900,18900,81400,1,1000,2015
429885,4.5,78830.0,11800,13000,61450,8,1200,2015
297656,2.9,29672.0,12000,10800,59100,3,-1200,2015
61632,4.0,29660.0,38000,37250,77030,3,-750,2015
150086,4.1,53140.0,10200,11200,73100,3,1000,2015
460916,1.9,208268.0,1175,1200,61490,14,25,2015
543743,3.1,35059.0,12350,11900,81400,3,-450,2015
456841,4.7,18627.0,16350,16300,61490,1,-50,2015
441266,1.9,156223.0,1125,1800,74430,11,675,2015
455470,3.9,129081.0,5150,7700,61490,12,2550,2015
240998,1.9,119732.0,725,600,59100,18,-125,2015
342716,4.2,27681.0,11700,12500,82750,3,800,2015
315625,2.8,27997.0,18300,18200,59100,3,-100,2015
23678,4.8,19751.0,20400,20400,77030,1,0,2015
29695,2.1,138189.0,1575,1600,77030,13,25,2015
416207,4.3,114623.0,4725,6200,61450,5,1475,2015
540991,3.0,11677.0,14000,13600,81400,2,-400,2015
363002,3.5,121282.0,3475,2400,64520,7,-1075,2015
14988,2.0,64882.0,10200,7000,77030,6,-3200,2015
130030,4.6,6179.0,25300,26500,73100,1,1200,2015
417681,2.0,106293.0,1450,1700,61450,13,250,2015
521661,4.1,43068.0,13700,14500,71660,3,800,2015
286722,3.5,98654.0,7250,7200,59100,5,-50,2015
117743,4.3,15322.0,20600,20600,68360,1,0,2015
428950,3.2,93585.0,12950,11900,61450,5,-1050,2015
183911,3.3,68772.0,12700,12300,63250,2,-400,2015
298085,4.6,69825.0,11950,11500,59100,2,-450,2015
104738,3.7,38539.0,21800,23300,68360,2,1500,2015
510616,1.9,87664.0,8125,4400,71660,6,-3725,2015
521092,3.5,34513.0,21700,20900,71660,1,-800,2015
45029,2.0,111885.0,5025,4600,77030,7,-425,2015
53767,3.2,43161.0,14550,13500,77030,2,-1050,2015
521192,2.2,88737.0,4425,3000,71660,7,-1425,2015
65465,4.1,30085.0,22200,21500,77030,3,-700,2015
297838,3.6,74973.0,9700,8600,59100,5,-1100,2015
74741,,202661.0,3900,4500,68360,10,600,2014
345474,3.8,58609.0,29900,30500,82750,5,600,2015
96223,1.9,101934.0,4350,3900,68360,7,-450,2015
135434,3.2,12186.0,25900,22400,73100,2,-3500,2015
118111,5.0,56524.0,16750,17500,68360,3,750,2015
121904,3.8,42919.0,10450,11300,73100,2,850,2014
8923,3.6,18599.0,10650,11000,77030,3,350,2014
233700,,126432.0,10450,8500,59100,5,-1950,2014
10941,2.1,151343.0,3075,3100,77030,10,25,2015
33529,3.5,13564.0,11800,11250,77030,3,-550,2015
180189,3.4,63282.0,13500,16700,83200,2,3200,2015
351113,2.0,199490.0,1000,350,62960,14,-650,2015
149905,3.5,53118.0,10250,8900,73100,2,-1350,2015
409818,4.1,29036.0,9350,10400,61450,3,1050,2015
471272,2.0,205177.0,4250,1600,62930,5,-2650,2015
263321,1.9,30331.0,15800,14400,59100,3,-1400,2015
500226,3.8,92992.0,3525,2900,80610,8,-625,2015
310528,3.4,66644.0,12150,11800,59100,4,-350,2015
156873,2.5,7736.0,20100,19300,73100,1,-800,2015
20047,4.2,23282.0,51400,52000,77030,2,600,2015
407884,3.5,171401.0,2675,2700,61450,8,25,2015
173944,3.1,124168.0,16700,15300,83200,2,-1400,2014
83769,3.8,52697.0,22700,24200,68360,4,1500,2015
502845,4.0,66083.0,15100,16000,80610,4,900,2015
368754,4.5,120538.0,7675,8000,64520,11,325,2015
302225,4.2,15840.0,13350,13800,59100,4,450,2015
282400,1.9,115315.0,4825,4900,59100,10,75,2015
498686,4.9,2266.0,15750,14000,80610,1,-1750,2014
179880,2.9,43741.0,11450,12000,83200,2,550,2015
510580,3.8,85292.0,12550,12500,71660,4,-50,2015
3394,1.9,107515.0,3300,2500,77030,7,-800,2014
311739,3.8,25742.0,11100,11300,59100,2,200,2015
254290,1.8,123354.0,8625,6900,59100,9,-1725,2015
329706,3.0,37038.0,12450,8500,82750,4,-3950,2015
357657,3.8,40497.0,11100,11500,62960,2,400,2015
425304,4.6,19709.0,19650,19400,61450,1,-250,2015
84102,3.7,10503.0,15350,15800,68360,2,450,2015
243708,4.3,27254.0,12350,14200,59100,3,1850,2015
90776,2.3,101001.0,9825,8000,68360,4,-1825,2015
519405,4.3,42292.0,21100,19700,71660,2,-1400,2015
9797,1.0,13590.0,13950,9200,77030,0,-4750,2014
261221,4.1,52441.0,15700,16000,59100,2,300,2015
69392,3.8,60871.0,15050,14800,77030,2,-250,2015
186741,3.7,19731.0,15000,14900,63250,1,-100,2015
375524,3.2,109472.0,8025,8000,64520,9,-25,2015
388409,3.9,54589.0,9675,9000,65610,4,-675,2015
51095,3.5,28442.0,7825,7900,77030,6,75,2015
93688,2.9,100611.0,7975,6100,68360,9,-1875,2015
110960,3.4,18463.0,23200,23900,68360,2,700,2015
247438,4.9,41663.0,18350,18100,59100,1,-250,2015
538664,4.2,25848.0,16600,15600,55590,3,-1000,2015
84440,2.9,139874.0,10350,8800,68360,7,-1550,2015
172080,5.0,4420.0,30700,29800,73100,0,-900,2015
384350,4.5,106915.0,10000,10400,65610,3,400,2015
411557,2.6,80465.0,7550,7300,61450,4,-250,2015
188944,3.5,45631.0,39600,36750,63250,2,-2850,2015
112068,3.8,147951.0,6200,5500,68360,11,-700,2015
365725,4.6,34448.0,17050,14900,64520,3,-2150,2015
249991,4.7,16256.0,30200,30400,59100,1,200,2015
337622,4.2,22862.0,13100,12100,82750,3,-1000,2015
18645,4.9,13252.0,13800,14500,77030,1,700,2015
496865,4.8,55610.0,16950,16500,73130,3,-450,2015
481768,3.2,22028.0,12700,13300,73130,3,600,2015
31020,2.5,205383.0,3875,3800,77030,7,-75,2015
522932,4.2,78099.0,23600,23100,71660,2,-500,2015
189642,2.5,62780.0,8950,10000,63250,4,1050,2015
216599,4.3,21170.0,21500,21500,57290,2,0,2015
183119,3.5,34853.0,11600,11800,63250,0,200,2014
322236,2.7,21962.0,14750,14100,82750,4,-650,2015
247234,2.6,117046.0,5025,6700,59100,9,1675,2015
426017,4.9,10272.0,13800,14400,61450,0,600,2015
68166,3.6,108062.0,5775,6100,77030,8,325,2015
492247,4.1,33482.0,10950,18200,73130,1,7250,2015
242214,4.0,29530.0,18450,17500,59100,1,-950,2015
41298,3.8,33830.0,19100,19000,77030,4,-100,2015
20568,4.1,46242.0,30300,32500,77030,3,2200,2015
120227,3.3,105788.0,6725,6900,73100,6,175,2014
513220,2.6,124787.0,9675,6900,71660,3,-2775,2015
260778,2.5,159439.0,1350,1600,59100,13,250,2015
305931,4.8,14821.0,54700,54900,59100,1,200,2015
376702,4.4,53464.0,13150,14800,64520,3,1650,2015
362555,4.8,2349.0,34000,38750,64520,0,4750,2014
347566,2.7,132065.0,4850,4700,82750,11,-150,2015
544955,4.0,37217.0,13200,13600,81400,2,400,2015
456085,3.4,54787.0,15000,17300,61490,3,2300,2015
448688,3.5,73429.0,21000,21900,61490,4,900,2014
519985,4.1,96475.0,6325,6700,71660,9,375,2015
280311,3.4,26807.0,22700,22400,59100,4,-300,2015
270128,4.4,44787.0,11300,12000,59100,3,700,2015
465774,3.8,90040.0,6750,7600,61490,8,850,2015
412563,3.4,55396.0,27700,28600,61450,2,900,2015
379190,4.1,44057.0,9950,10000,64520,2,50,2015
209554,3.8,27273.0,23600,17200,57290,2,-6400,2015
228972,3.3,83305.0,10300,8000,89090,8,-2300,2015
103367,4.8,7292.0,16450,17000,68360,1,550,2015
446969,3.5,33335.0,7300,6400,56120,7,-900,2015
319884,2.3,49280.0,10150,10300,73200,2,150,2015
154116,3.6,29299.0,34400,34400,73100,2,0,2015
154983,3.3,118032.0,3725,4000,73100,7,275,2015
371963,2.6,35542.0,13850,13000,64520,2,-850,2015
532365,2.8,97582.0,6125,3600,82150,9,-2525,2015
355350,3.6,81416.0,9425,10250,62960,10,825,2015
361513,3.7,95879.0,16550,15500,64520,5,-1050,2014
429821,1.9,106729.0,5725,3100,61450,9,-2625,2015
69224,2.0,54908.0,12250,8250,77030,2,-4000,2015
306827,4.2,23140.0,13050,13700,59100,1,650,2015
423167,4.4,21389.0,19700,19500,61450,0,-200,2015
237527,4.2,25031.0,31400,30500,59100,2,-900,2014
40312,1.9,137970.0,3400,3500,77030,8,100,2015
305916,3.6,29233.0,14550,13800,59100,1,-750,2015
68,4.0,8037.0,67000,65000,77030,1,-2000,2015
542021,1.9,67672.0,21600,23900,81400,8,2300,2015
66513,3.7,52548.0,9050,9100,77030,2,50,2015
284228,3.8,31166.0,10450,11100,59100,2,650,2015
50707,4.5,31607.0,34200,33000,77030,3,-1200,2015
411012,3.7,188989.0,9875,10400,61450,8,525,2015
407018,4.1,20390.0,32500,30800,61450,2,-1700,2015
36873,3.5,83687.0,8575,8600,77030,6,25,2015
59513,2.8,68731.0,35400,32250,77030,4,-3150,2015
71184,4.7,17969.0,29700,32000,77030,1,2300,2015
163878,2.7,101410.0,10700,10900,73100,5,200,2015
212019,4.9,12493.0,35200,37900,57290,1,2700,2015
280069,3.9,22519.0,12150,11600,59100,2,-550,2015
353096,4.6,6480.0,25500,23500,62960,1,-2000,2015
509632,4.6,43270.0,26200,26000,71660,4,-200,2015
201070,2.7,40979.0,18300,17000,57290,4,-1300,2015
541952,4.2,39145.0,12750,13500,81400,2,750,2015
297096,2.8,177681.0,1000,600,59100,13,-400,2015
7905,4.6,43589.0,41700,41250,77030,3,-450,2014
491364,2.6,72644.0,9425,9000,73130,2,-425,2015
512723,1.9,129145.0,4275,3300,71660,7,-975,2015
107629,2.0,241165.0,2400,1800,68360,13,-600,2015
85159,2.0,33298.0,16700,14600,68360,4,-2100,2015
397599,2.8,44335.0,16650,18300,61450,3,1650,2014
224856,2.0,9162.0,9600,2200,89090,1,-7400,2015
503725,3.2,37514.0,11550,11400,80610,2,-150,2015
244669,4.7,19986.0,21300,22000,59100,1,700,2015
122478,,21023.0,23500,21400,73100,2,-2100,2014
204468,5.0,65937.0,9200,10300,57290,2,1100,2015
460870,4.3,189127.0,4475,6300,61490,11,1825,2015
254949,2.6,31460.0,21100,20000,59100,3,-1100,2015
362963,4.2,16729.0,21000,20000,64520,3,-1000,2014
28074,3.9,139494.0,10800,10500,77030,6,-300,2015
357289,3.5,42964.0,10050,10200,62960,1,150,2015
253093,4.0,11485.0,20500,20500,59100,1,0,2015
113012,2.8,86628.0,15150,14600,68360,5,-550,2015
173460,,168047.0,2200,2200,83200,9,0,2014
189540,3.0,78862.0,8275,9000,63250,6,725,2015
25591,2.6,82845.0,9150,9000,77030,8,-150,2015
445390,4.2,25015.0,17050,16400,56120,1,-650,2015
442299,1.9,181210.0,3075,2200,74430,10,-875,2015
393429,4.3,24497.0,28200,28000,65610,3,-200,2015
163496,4.8,1922.0,73000,79500,73100,5,6500,2015
341242,2.5,23683.0,23900,21000,82750,2,-2900,2015
300175,3.8,13766.0,19000,19000,59100,1,0,2015
195737,4.6,73775.0,10600,11600,67090,2,1000,2015
378542,5.0,4982.0,23800,23600,64520,0,-200,2015
275551,4.8,54664.0,11550,11800,59100,3,250,2015
542659,3.6,118401.0,15250,15200,81400,9,-50,2015
341478,3.3,28675.0,9275,9300,82750,6,25,2015
349303,2.0,145123.0,800,400,62960,13,-400,2014
128063,2.7,137876.0,8575,7500,73100,11,-1075,2015
10916,1.0,1.0,5975,800,77030,8,-5175,2014
363128,4.9,13591.0,11950,15000,64520,1,3050,2015
139159,3.8,35887.0,10700,11200,73100,3,500,2015
472061,2.0,57894.0,11400,4800,62930,5,-6600,2015
356644,3.1,55338.0,14650,14000,62960,3,-650,2015
222361,2.8,64455.0,12450,11500,89090,3,-950,2014
245268,3.5,104318.0,8250,8800,59100,5,550,2015
12314,2.0,13931.0,14050,8200,77030,0,-5850,2014
543591,4.4,9891.0,11450,12800,81400,1,1350,2015
485300,4.8,22207.0,14450,14900,73130,2,450,2015
168454,3.7,56301.0,18850,19100,73100,3,250,2015
118398,4.0,14406.0,21000,21000,68360,1,0,2015
213960,4.7,29342.0,15100,18400,57290,1,3300,2015
246258,3.4,31016.0,11350,10600,59100,2,-750,2015
281109,4.5,27737.0,13700,13800,59100,3,100,2015
255283,4.9,1490.0,13500,13900,59100,1,400,2015
64444,2.1,141693.0,3450,2800,77030,14,-650,2015
55917,2.1,180181.0,3500,2900,77030,7,-600,2015
239333,3.3,9577.0,15950,21000,59100,0,5050,2014
171499,2.8,66611.0,8975,9300,73100,2,325,2015
114912,3.3,53091.0,10000,11400,68360,2,1400,2015
192334,4.4,9633.0,15350,15300,67090,1,-50,2015
37505,3.2,62908.0,7975,8700,77030,3,725,2015
72862,4.2,13567.0,20600,20300,77030,0,-300,2015
138966,3.4,23948.0,17250,15200,73100,3,-2050,2015
408322,1.9,102502.0,3500,1300,61450,11,-2200,2015
410822,4.2,11201.0,23400,23300,61450,2,-100,2015
32760,2.7,69369.0,8025,12500,77030,10,4475,2015
536147,1.9,183286.0,3650,3100,82150,8,-550,2015
503342,3.8,38595.0,22100,22500,80610,1,400,2015
488210,2.5,33816.0,9975,9400,73130,5,-575,2015
505036,4.0,33576.0,35400,33600,80610,1,-1800,2015
112027,2.8,123839.0,10950,9100,68360,7,-1850,2015
446985,1.9,105508.0,9550,9700,56120,11,150,2015
28346,4.0,24624.0,15950,14700,77030,1,-1250,2015
489611,1.9,116258.0,4150,600,73130,7,-3550,2015
136885,4.2,80050.0,7875,7200,73100,6,-675,2015
420368,4.3,27609.0,16250,16500,61450,1,250,2015
110232,4.6,25148.0,15150,11400,68360,2,-3750,2015
211369,1.9,86968.0,15150,13000,57290,4,-2150,2015
525413,2.2,169025.0,4800,3150,70210,9,-1650,2015
227969,1.0,161573.0,3075,900,89090,8,-2175,2015
247455,4.4,11890.0,13950,13500,59100,1,-450,2015
290225,5.0,20649.0,25700,26000,59100,1,300,2015
135025,3.5,36314.0,10700,10700,73100,2,0,2015
9400,3.4,120124.0,2325,2100,77030,10,-225,2015
183326,4.7,4467.0,37700,37200,63250,0,-500,2014
480491,2.2,17997.0,13000,12500,73130,3,-500,2015
340465,2.0,146667.0,2475,1600,82750,9,-875,2015
5681,4.6,12508.0,23800,22500,77030,0,-1300,2014
87671,3.7,194598.0,6050,6800,68360,7,750,2015
155301,4.5,66226.0,13250,13500,73100,2,250,2015
86357,2.3,188303.0,1825,1300,68360,11,-525,2015
119707,3.7,38784.0,13300,13000,73100,3,-300,2014
77925,2.7,32940.0,19300,19100,68360,2,-200,2015
177333,4.0,28725.0,16600,16500,83200,1,-100,2015
451737,2.6,173476.0,1925,3000,61490,12,1075,2015
511023,4.8,23932.0,11350,12700,71660,2,1350,2015
134751,3.6,54346.0,15600,15600,73100,2,0,2015
430521,2.8,111571.0,5300,5700,61450,7,400,2015
192879,3.7,138862.0,1750,1300,67090,10,-450,2015
472634,4.5,46656.0,17000,18250,62930,3,1250,2015
398327,3.6,13705.0,17050,18000,61450,0,950,2014
484222,4.1,34982.0,20000,19000,73130,3,-1000,2015
398839,4.4,33792.0,20900,21200,61450,1,300,2014
436271,4.4,153251.0,7425,8600,74430,8,1175,2015
275303,3.5,82502.0,4625,6300,59100,11,1675,2015
143666,4.5,20983.0,24700,24900,73100,2,200,2015
373319,5.0,6870.0,45500,46500,64520,1,1000,2015
286480,4.2,36730.0,27800,31200,59100,3,3400,2015
389732,2.8,60865.0,10050,8100,65610,7,-1950,2015
293374,3.6,35167.0,33800,32000,59100,2,-1800,2015
342121,2.8,36038.0,12400,12200,82750,3,-200,2015
486486,3.7,53150.0,11550,11000,73130,2,-550,2015
303561,3.6,42633.0,13000,12800,59100,2,-200,2015
347100,2.9,44574.0,8800,7200,82750,6,-1600,2015
520071,4.5,34597.0,22700,32500,71660,1,9800,2015
344286,2.7,93777.0,10150,10800,82750,7,650,2015
225877,3.2,16168.0,15650,14700,89090,3,-950,2015
509448,4.7,18379.0,21500,22500,71660,1,1000,2015
140803,4.2,22455.0,24600,23500,73100,3,-1100,2015
163721,4.1,38052.0,14350,14400,73100,4,50,2015
283240,3.1,51518.0,11150,10100,59100,3,-1050,2015
173059,1.9,52719.0,8275,3100,83200,4,-5175,2014
386729,4.9,21779.0,29100,28000,65610,2,-1100,2015
393935,3.9,27134.0,22300,23100,65610,4,800,2015
237977,3.6,58308.0,9350,9800,59100,5,450,2014
119111,4.1,24897.0,29100,30400,73100,2,1300,2014
83994,2.3,106753.0,2100,3400,68360,11,1300,2015
182848,,92084.0,3150,4000,63250,8,850,2014
497286,1.9,84227.0,7875,5600,73130,8,-2275,2015
189848,4.3,7401.0,10650,9300,63250,0,-1350,2015
272544,4.3,80512.0,6975,6100,59100,4,-875,2015
197195,2.1,287051.0,1250,300,67090,11,-950,2015
156296,2.3,118858.0,7925,8500,73100,8,575,2015
446898,3.0,2557.0,19100,15700,56120,0,-3400,2015
157757,3.5,108716.0,15950,16200,73100,8,250,2015
413672,2.4,92897.0,12550,12900,61450,5,350,2015
147229,3.5,110703.0,13800,13100,73100,8,-700,2015
351545,4.2,44328.0,15850,15500,62960,2,-350,2015
470629,1.9,175712.0,1825,700,62930,10,-1125,2015
65470,4.4,29791.0,22400,21000,77030,3,-1400,2015
98268,3.3,54817.0,7700,8500,68360,6,800,2015
540798,3.5,54158.0,16050,17200,81400,2,1150,2015
407996,4.3,44662.0,10200,9500,61450,3,-700,2015
418088,1.9,148484.0,6275,3700,61450,10,-2575,2015
229756,1.9,87326.0,5900,4900,89090,7,-1000,2015
283772,4.1,16220.0,15700,16400,59100,1,700,2015
97097,4.4,64858.0,12300,14000,68360,5,1700,2015
71898,2.8,146713.0,1475,2700,77030,13,1225,2015
58828,1.9,37281.0,10050,9000,77030,3,-1050,2015
463474,2.8,130382.0,3150,4200,61490,15,1050,2015
15683,2.8,80267.0,1975,2900,77030,13,925,2015
140454,3.5,52250.0,17150,16700,73100,5,-450,2015
4069,2.0,16637.0,16800,9600,77030,0,-7200,2014
146039,4.4,17583.0,18200,19300,73100,3,1100,2015
457779,3.7,57142.0,8800,9600,61490,3,800,2015
527355,2.3,104706.0,12000,9500,70210,8,-2500,2015
383442,3.0,56303.0,9625,8300,65610,2,-1325,2014
123342,4.1,32649.0,10550,10600,73100,3,50,2015
98760,3.2,70847.0,4275,4600,68360,7,325,2015
385614,2.8,104853.0,8100,7400,65610,7,-700,2015
262511,2.8,59779.0,9050,8100,59100,2,-950,2015
276394,2.4,30311.0,10700,9800,59100,3,-900,2015
391696,2.7,149541.0,3200,2900,65610,13,-300,2015
504775,4.8,12124.0,12050,12300,80610,1,250,2015
13254,3.7,99782.0,6950,7100,77030,7,150,2015
13191,4.0,64459.0,17250,17250,77030,4,0,2015
256080,4.1,77615.0,12050,14000,59100,5,1950,2015
260718,2.7,82810.0,3275,3300,59100,12,25,2015
315099,3.7,50918.0,58900,58800,59100,2,-100,2015
421637,4.1,87321.0,7200,7500,61450,3,300,2015
532407,2.1,126164.0,6100,5800,82150,10,-300,2015
315385,4.1,32480.0,37200,31200,59100,2,-6000,2015
419458,2.7,343369.0,2200,4300,61450,11,2100,2015
32791,1.0,48367.0,10200,2250,77030,2,-7950,2015
297464,2.0,78878.0,2975,3800,59100,10,825,2015
444622,,259602.0,1100,2200,56120,13,1100,2014
206140,3.5,22321.0,29100,30250,57290,2,1150,2015
542260,3.6,109452.0,3650,5200,81400,11,1550,2015
113064,2.9,34946.0,12950,10900,68360,1,-2050,2015
133124,4.0,25549.0,12800,11300,73100,1,-1500,2015
123427,4.1,23806.0,23800,24500,73100,3,700,2015
484160,3.3,25050.0,10850,10400,73130,3,-450,2015
215213,3.2,133206.0,7125,6700,57290,6,-425,2015
75744,2.8,21141.0,22300,21250,68360,3,-1050,2015
457474,2.3,114760.0,6575,6800,61490,8,225,2015
134586,2.5,97798.0,6000,5300,73100,10,-700,2015
263399,3.9,29135.0,22200,21000,59100,3,-1200,2015
281382,4.5,21888.0,20200,22400,59100,2,2200,2015
317948,2.6,108632.0,8100,9100,73200,9,1000,2015
10660,2.6,163258.0,1325,950,77030,10,-375,2014
535983,2.8,207549.0,1200,1800,82150,9,600,2015
471209,2.0,1.0,9750,1600,62930,7,-8150,2015
360754,4.6,83240.0,3225,3800,64520,7,575,2014
299786,3.7,44343.0,12700,12500,59100,2,-200,2015
76217,2.5,93486.0,27300,24000,68360,2,-3300,2014
210923,3.7,72240.0,20500,19200,57290,5,-1300,2015
473288,3.2,82925.0,4875,4800,62930,10,-75,2015
63339,2.0,146834.0,3375,2100,77030,10,-1275,2015
307825,2.7,78470.0,7925,8700,59100,9,775,2015
441645,3.6,94005.0,11500,13500,74430,5,2000,2015
408702,4.3,56921.0,9725,10000,61450,2,275,2015
232571,2.5,104673.0,8550,9100,89090,8,550,2015
151989,3.9,86385.0,19450,22400,73100,8,2950,2015
210142,2.3,161636.0,6675,7500,57290,10,825,2015
222241,,279714.0,850,750,89090,14,-100,2014
15085,3.4,80878.0,8250,11400,77030,7,3150,2015
476243,,126325.0,2225,1500,73130,13,-725,2014
431346,1.0,91574.0,9600,6800,61450,6,-2800,2015
66090,3.1,69124.0,10750,10700,77030,2,-50,2015
514862,1.9,201133.0,500,300,71660,18,-200,2015
456456,3.7,127062.0,3825,3300,61490,10,-525,2015
183893,4.6,59101.0,12950,13900,63250,0,950,2014
189346,2.0,153322.0,3450,1050,63250,11,-2400,2015
509334,2.3,17656.0,18150,16800,71660,2,-1350,2015
434562,1.9,142442.0,2700,2400,74430,9,-300,2015
441517,3.7,53739.0,9675,9500,74430,4,-175,2015
246056,2.3,120617.0,1025,900,59100,15,-125,2015
434518,3.4,114147.0,5050,5000,74430,4,-50,2015
253921,2.8,113680.0,7900,7400,59100,9,-500,2015
207302,2.2,100621.0,7100,4700,57290,8,-2400,2015
98180,1.9,68060.0,8850,4100,68360,4,-4750,2015
193539,2.8,97757.0,3050,2300,67090,9,-750,2015
114052,3.4,177364.0,6875,8000,68360,9,1125,2015
458205,2.4,42457.0,8400,8900,61490,7,500,2015
123345,3.7,11491.0,10550,10400,73100,3,-150,2015
224791,1.9,146444.0,2625,3100,89090,14,475,2015
471992,1.9,168709.0,850,450,62930,9,-400,2015
256589,3.5,85655.0,1950,3000,59100,10,1050,2015
126956,1.9,124882.0,7375,4200,73100,9,-3175,2015
116934,2.4,97036.0,7550,6000,68360,4,-1550,2015
380213,3.5,45298.0,8200,8200,64520,2,0,2015
512893,4.3,23139.0,15200,15100,71660,2,-100,2015
516856,3.3,111272.0,18050,17800,71660,8,-250,2015
89994,4.3,13241.0,31000,29700,68360,1,-1300,2015
302738,1.0,243600.0,225,350,59100,13,125,2015
264200,2.7,57564.0,15700,16200,59100,5,500,2015
187228,2.7,154472.0,5200,6500,63250,9,1300,2015
373198,4.4,25255.0,12750,12600,64520,3,-150,2015
50968,2.9,45018.0,13600,11800,77030,4,-1800,2015
121181,3.1,18428.0,16600,13700,73100,1,-2900,2014
44410,4.1,38882.0,11050,11300,77030,2,250,2015
546607,4.7,28667.0,10900,11300,81400,2,400,2015
75948,2.0,145940.0,4775,4500,68360,7,-275,2014
420044,3.8,36989.0,7725,9100,61450,3,1375,2015
397318,3.7,18050.0,16800,16000,65610,2,-800,2015
226492,4.5,2175.0,20400,22900,89090,7,2500,2015
179119,3.7,50390.0,10200,10300,83200,2,100,2015
73287,,78367.0,35200,37000,68360,3,1800,2014
446440,4.2,86242.0,3800,3700,56120,8,-100,2015
281045,2.9,24769.0,14100,14200,59100,3,100,2015
109651,4.0,78019.0,14000,13900,68360,4,-100,2015
342912,3.6,66465.0,14200,14400,82750,5,200,2015
244406,2.8,148100.0,1075,1500,59100,13,425,2015
322516,1.9,214686.0,3225,2900,82750,10,-325,2015
222867,4.3,77772.0,20100,16100,89090,2,-4000,2015
147521,3.2,64065.0,15600,15200,73100,3,-400,2015
41086,4.2,40033.0,20900,21700,77030,3,800,2015
403200,3.3,81561.0,15500,14700,61450,4,-800,2015
121689,3.5,52520.0,37600,36250,73100,3,-1350,2015
113556,3.4,147442.0,15900,17900,68360,11,2000,2015
264165,4.0,21350.0,14700,14500,59100,1,-200,2015
518813,1.9,146287.0,3000,3300,71660,10,300,2015
100755,2.0,100334.0,17500,14900,68360,4,-2600,2015
289297,4.2,11024.0,28800,31400,59100,2,2600,2015
550077,4.4,36443.0,47600,49000,48460,2,1400,2015
92120,3.9,43946.0,12050,12500,68360,2,450,2015
380446,4.6,20142.0,26700,26300,64520,2,-400,2015
281503,4.4,26963.0,20400,18800,59100,3,-1600,2015
486415,3.0,156670.0,8525,7500,73130,14,-1025,2015
296376,4.4,16279.0,24000,24200,59100,1,200,2015
371921,2.9,37939.0,13700,14000,64520,2,300,2015
169013,5.0,3085.0,35200,37000,73100,4,1800,2015
332431,4.3,29697.0,21100,21300,82750,3,200,2015
220864,2.7,62989.0,11200,11400,57290,2,200,2015
540016,3.9,39793.0,12200,12400,81400,2,200,2015
516805,4.7,60574.0,20600,22900,71660,6,2300,2015
477848,3.6,71213.0,21000,21600,73130,4,600,2015
128956,2.9,124984.0,1350,1800,73100,14,450,2015
316246,,143244.0,3000,2500,73200,10,-500,2014
314037,1.9,95295.0,2400,1000,59100,15,-1400,2015
282028,2.0,156243.0,8175,7200,59100,11,-975,2015
291071,4.2,21905.0,18850,12700,59100,3,-6150,2015
385137,4.4,31855.0,25100,26700,65610,3,1600,2015
204655,4.5,29625.0,20100,22800,57290,2,2700,2015
444088,2.3,176843.0,3950,3800,74430,14,-150,2015
293413,3.8,53469.0,14800,15000,59100,2,200,2015
7106,,92422.0,7875,8500,77030,8,625,2014
429409,3.1,42323.0,13200,11400,61450,2,-1800,2015
94309,2.6,103322.0,6075,6500,68360,4,425,2015
345155,4.9,18210.0,21100,20400,82750,1,-700,2015
468928,2.0,111807.0,5325,5100,61490,5,-225,2015
535342,2.0,33204.0,7250,5100,82150,7,-2150,2015
252121,3.6,17174.0,25100,21000,59100,2,-4100,2015
287495,2.8,105537.0,6675,6800,59100,6,125,2015
299828,3.9,29980.0,11150,11300,59100,2,150,2015
399727,4.8,37191.0,19750,19200,61450,1,-550,2015
476609,3.6,18229.0,10750,10600,73130,1,-150,2014
67970,4.6,45110.0,13850,13000,77030,4,-850,2015
519642,3.3,128006.0,24100,22500,71660,4,-1600,2015
293600,2.2,89065.0,10300,9600,59100,3,-700,2015
197376,2.5,45543.0,29700,28300,67090,4,-1400,2015
401205,4.9,10788.0,15400,15800,61450,1,400,2015
59987,3.8,65641.0,32400,32500,77030,5,100,2015
363462,3.7,79195.0,17900,17300,64520,4,-600,2015
46916,4.4,37929.0,28100,29750,77030,3,1650,2015
186209,3.7,35011.0,12600,12700,63250,1,100,2015
481197,4.7,16507.0,21000,20900,73130,1,-100,2015
355709,4.1,63044.0,11000,11300,62960,2,300,2015
192740,3.1,40802.0,14150,13100,67090,3,-1050,2015
256076,2.5,113021.0,7250,6500,59100,5,-750,2015
240347,3.0,16884.0,13350,13000,59100,1,-350,2015
432724,2.6,124123.0,6375,7200,74430,7,825,2015
294069,4.1,47286.0,21100,21000,59100,2,-100,2015
169346,2.8,96270.0,17300,16200,73100,6,-1100,2015
483753,4.2,43063.0,13800,13900,73130,1,100,2015
64624,3.7,218757.0,2350,4500,77030,9,2150,2015
253037,2.5,65735.0,15250,14450,59100,5,-800,2015
257920,4.4,30417.0,25900,27900,59100,4,2000,2015
283973,4.3,25659.0,7750,10000,59100,3,2250,2015
495618,2.4,116467.0,12100,13000,73130,7,900,2015
50301,3.4,39944.0,14150,14100,77030,2,-50,2015
121352,,6331.0,27300,23750,73100,1,-3550,2014
476289,,117137.0,1600,1600,73130,14,0,2014
370366,4.7,38075.0,23100,23500,64520,3,400,2015
480189,4.7,29224.0,10750,10900,73130,1,150,2015
453185,3.5,31815.0,14950,14300,61490,2,-650,2015
449766,4.2,33957.0,14850,14800,61490,2,-50,2014
414552,2.5,123660.0,4000,4800,61450,6,800,2015
331702,4.5,88487.0,12450,8600,82750,12,-3850,2015
327700,4.3,22051.0,10200,10800,82750,3,600,2015
66341,2.1,64149.0,6875,4400,77030,7,-2475,2015
270431,1.9,252016.0,2400,3900,59100,7,1500,2015
463176,3.7,110251.0,4025,4800,61490,10,775,2015
301091,1.9,29036.0,20300,18100,59100,2,-2200,2015
542823,5.0,10407.0,21100,21100,81400,0,0,2015
211975,3.7,144264.0,6250,7300,57290,12,1050,2015
184546,2.0,180329.0,10150,4700,63250,15,-5450,2015
297949,2.0,152896.0,3525,3300,59100,10,-225,2015
464226,4.7,31216.0,12050,12000,61490,3,-50,2015
79856,2.9,97669.0,6650,7100,68360,5,450,2015
93142,2.7,79395.0,3450,4600,68360,6,1150,2015
265944,4.3,25138.0,32000,35400,59100,2,3400,2015
122968,,36613.0,19000,17800,73100,3,-1200,2014
34386,2.7,103508.0,3900,3100,77030,10,-800,2015
536047,2.4,167512.0,5575,6800,82150,14,1225,2015
198231,1.0,143698.0,1675,1000,67090,15,-675,2015
83922,2.4,97417.0,18400,20700,68360,7,2300,2015
295632,2.0,32082.0,12950,10300,59100,1,-2650,2015
283796,4.6,6801.0,20800,20600,59100,1,-200,2015
183948,4.1,35864.0,17450,17800,63250,2,350,2015
127787,4.8,5342.0,16500,16900,73100,1,400,2015
299533,1.9,55812.0,9300,4900,59100,4,-4400,2015
287372,4.1,17578.0,16250,16900,59100,0,650,2015
49343,3.1,35847.0,18550,17500,77030,4,-1050,2015
160797,2.8,19152.0,21700,20800,73100,2,-900,2015
341233,3.9,59757.0,11200,12400,82750,2,1200,2015
151330,3.8,38224.0,29300,32000,73100,4,2700,2015
162286,3.9,37686.0,19050,18800,73100,3,-250,2015
311103,3.9,69937.0,6200,7700,59100,10,1500,2015
74927,,166917.0,2725,4200,68360,12,1475,2014
325123,3.4,33082.0,15300,13400,82750,4,-1900,2015
55663,3.0,38758.0,11200,11000,77030,2,-200,2015
441860,3.4,82253.0,7325,8100,74430,5,775,2015
27574,4.3,25931.0,11250,11900,77030,2,650,2015
168922,2.9,38447.0,14100,13600,73100,3,-500,2015
125691,2.5,120947.0,6725,6700,73100,10,-25,2015
87317,1.0,112205.0,4225,3800,68360,10,-425,2015
373070,2.6,103139.0,5225,5500,64520,7,275,2015
149107,4.7,16142.0,21500,19600,73100,2,-1900,2015
168759,4.5,15392.0,14450,15700,73100,3,1250,2015
268640,4.8,42536.0,26700,26900,59100,4,200,2015
194371,1.9,45744.0,13950,11700,67090,4,-2250,2015
36647,4.5,32642.0,15200,15500,77030,3,300,2015
5824,4.0,27842.0,36600,37250,77030,1,650,2015
234762,,141718.0,6025,5400,59100,9,-625,2014
222095,3.7,93554.0,10150,11000,89090,7,850,2014
274627,2.9,94929.0,2250,3700,59100,13,1450,2015
529627,,122953.0,4075,2200,82150,8,-1875,2014
508282,4.9,11217.0,25700,26500,71660,1,800,2014
381082,2.5,29959.0,11050,11200,64520,1,150,2015
135900,4.6,63795.0,6450,8400,73100,7,1950,2015
375511,4.8,29073.0,8875,10200,64520,4,1325,2015
472973,4.6,20050.0,14950,15800,62930,2,850,2015
532179,3.9,56681.0,11950,11500,82150,2,-450,2015
126698,2.8,110746.0,6825,4900,73100,6,-1925,2015
102976,2.9,131027.0,6925,7400,68360,6,475,2015
412065,1.9,148192.0,3550,4100,61450,9,550,2015
39390,4.1,33563.0,14500,15300,77030,2,800,2015
56555,4.8,31720.0,43400,43500,77030,2,100,2015
327179,3.5,55598.0,7675,7100,82750,4,-575,2015
266017,2.5,82049.0,13150,12300,59100,6,-850,2015
41162,4.2,29714.0,26600,27750,77030,3,1150,2015
78540,3.0,126030.0,21200,20000,68360,3,-1200,2015
264905,2.7,163092.0,3075,2400,59100,11,-675,2015
447491,4.4,50474.0,12750,12600,56120,2,-150,2015
362241,2.7,132409.0,2175,2350,64520,6,175,2014
92440,4.1,61492.0,29900,31800,68360,4,1900,2015
460296,3.2,112465.0,9450,10000,61490,8,550,2015
42429,4.6,30828.0,42300,45250,77030,3,2950,2015
323140,2.7,35414.0,26000,25250,82750,3,-750,2015
251921,4.5,60221.0,31700,31400,59100,4,-300,2015
363430,4.5,50933.0,15400,16600,64520,3,1200,2015
444669,3.6,37904.0,10650,9600,56120,1,-1050,2014
61988,4.1,37766.0,11500,10000,77030,3,-1500,2015
315456,2.8,57731.0,8525,8900,59100,5,375,2015
280499,3.6,130869.0,11650,12200,59100,8,550,2015
270166,4.0,23866.0,52900,53250,59100,3,350,2015
20414,3.3,71338.0,8600,8500,77030,3,-100,2015
255936,3.0,65699.0,10450,10100,59100,3,-350,2015
396373,2.9,68189.0,10050,7400,65610,5,-2650,2015
447472,2.6,71060.0,2025,2100,56120,13,75,2015
472025,4.4,43817.0,10950,10800,62930,3,-150,2015
432353,4.3,69526.0,32000,31300,74430,3,-700,2014
494069,4.9,36303.0,25900,27200,73130,1,1300,2015
339504,4.4,37670.0,39200,40000,82750,3,800,2015
69113,2.6,58941.0,14550,13900,77030,1,-650,2015
62328,3.7,40765.0,25900,26300,77030,2,400,2015
449861,1.9,142864.0,5200,5000,61490,10,-200,2014
489275,2.7,193883.0,4175,3800,73130,8,-375,2015
161,4.6,13736.0,18350,17700,77030,1,-650,2014
367873,5.0,248.0,40300,42000,64520,1,1700,2015
80947,2.5,101911.0,4675,3600,68360,8,-1075,2015
367936,4.6,21024.0,12350,12900,64520,2,550,2015
150581,3.7,18897.0,19000,20500,73100,1,1500,2015
486452,3.1,69095.0,13550,13100,73130,2,-450,2015
204868,2.5,70359.0,11400,12000,57290,8,600,2015
286433,3.7,52908.0,20800,22600,59100,2,1800,2015
542932,4.8,23687.0,24900,24300,81400,2,-600,2015
330076,1.9,77644.0,8825,6100,82750,4,-2725,2015
463017,4.5,38460.0,24200,22800,61490,1,-1400,2015
197816,1.9,67853.0,10950,12100,67090,2,1150,2015
121700,3.9,42818.0,37000,36000,73100,3,-1000,2015
403298,3.5,133620.0,6975,7300,61450,7,325,2015
289998,1.9,182188.0,775,300,59100,11,-475,2015
270565,2.1,116161.0,5250,4900,59100,12,-350,2015
372269,4.7,33422.0,33300,32700,64520,4,-600,2015
473126,4.5,78106.0,18300,17400,62930,3,-900,2015
27052,3.2,159001.0,4625,4200,77030,9,-425,2015
300091,2.5,128873.0,5925,4900,59100,9,-1025,2015
130467,2.0,152304.0,3425,1200,73100,8,-2225,2015
227862,3.1,63864.0,12100,12300,89090,3,200,2015
225528,4.3,107814.0,6225,6000,89090,13,-225,2015
32337,2.8,134916.0,2625,4500,77030,11,1875,2015
512107,3.5,43007.0,27300,27200,71660,2,-100,2015
533489,3.4,60875.0,15050,14400,82150,4,-650,2015
173391,2.7,113624.0,13800,11400,83200,8,-2400,2014
256278,3.1,149317.0,2725,2000,59100,11,-725,2015
40396,3.6,153540.0,2650,2500,77030,10,-150,2015
282885,2.8,75429.0,12550,12400,59100,7,-150,2015
289538,2.9,50509.0,9725,8700,59100,3,-1025,2015
233630,2.7,144106.0,7075,6900,59100,5,-175,2014
342950,3.2,132434.0,6100,5800,82750,8,-300,2015
273933,3.6,39938.0,12750,13500,59100,2,750,2015
5837,4.2,6191.0,20100,19500,77030,0,-600,2014
396343,3.7,27039.0,21100,21000,65610,4,-100,2015
306125,2.8,98210.0,6475,6800,59100,5,325,2015
298282,3.0,39495.0,25000,24600,59100,4,-400,2015
121912,2.4,53809.0,10150,9400,73100,2,-750,2014
482114,4.9,15814.0,29200,29600,73130,2,400,2015
59302,4.1,6320.0,20100,19400,77030,1,-700,2015
393709,4.4,46000.0,13700,13200,65610,4,-500,2015
489991,4.0,19971.0,35500,38750,73130,2,3250,2015
299833,2.4,53855.0,9375,9400,59100,2,25,2015
505979,2.0,114297.0,5550,6400,80610,8,850,2015
239660,3.2,51120.0,10750,10800,59100,1,50,2014
519622,4.3,23240.0,18500,18400,71660,3,-100,2015
481000,3.0,131773.0,1550,900,73130,13,-650,2015
298806,2.8,84744.0,7675,6000,59100,7,-1675,2015
150354,3.4,27795.0,12900,12800,73100,3,-100,2015
249911,4.0,16543.0,16600,16300,59100,1,-300,2015
348179,,93413.0,2200,2800,62960,9,600,2014
303915,1.9,73713.0,6200,3100,59100,8,-3100,2015
116068,4.9,37764.0,43400,46000,68360,3,2600,2015
529578,2.9,128597.0,5300,3450,82150,5,-1850,2014
526107,1.9,135514.0,7800,4600,70210,12,-3200,2015
242392,4.0,21380.0,16150,16100,59100,1,-50,2015
45470,3.9,8419.0,21200,21000,77030,1,-200,2015
464736,2.8,45440.0,7150,7300,61490,4,150,2015
518603,4.2,34464.0,16850,17200,71660,2,350,2015
160316,4.4,17992.0,8350,9900,73100,4,1550,2015
500491,4.3,48026.0,15900,17900,80610,4,2000,2015
511937,4.2,27226.0,21900,22200,71660,1,300,2015
377709,4.4,32833.0,16800,17200,64520,4,400,2015
101133,4.6,42774.0,20700,20800,68360,1,100,2015
47141,3.1,89359.0,4475,6200,77030,7,1725,2015
191005,2.8,61962.0,8175,8300,63250,3,125,2015
52427,2.9,121083.0,3300,5100,77030,12,1800,2015
138081,3.0,7872.0,20700,20500,73100,1,-200,2015
259158,2.7,72565.0,18850,17500,59100,6,-1350,2015
476247,,76064.0,1900,2800,73130,14,900,2014
403399,3.5,91735.0,6975,8100,61450,9,1125,2015
534409,2.4,201196.0,1300,400,82150,14,-900,2015
72490,3.7,16332.0,58300,54000,77030,2,-4300,2015
247938,3.1,89746.0,20600,20000,59100,8,-600,2015
441184,4.2,53964.0,6200,7900,74430,6,1700,2015
76484,4.4,42568.0,21800,21800,68360,0,0,2014
259586,4.7,24302.0,21500,19400,59100,2,-2100,2015
450691,4.3,24788.0,16050,16000,61490,0,-50,2014
315494,3.2,83081.0,8550,9700,59100,8,1150,2015
489066,4.0,14444.0,10850,10500,73130,1,-350,2015
404225,3.7,40246.0,16600,16700,61450,3,100,2015
49070,4.4,21154.0,37600,37500,77030,2,-100,2015
173105,,76751.0,6500,5250,83200,4,-1250,2014
489780,4.0,18464.0,34800,34500,73130,1,-300,2015
546501,4.3,143845.0,1725,3300,81400,15,1575,2015
79701,4.9,41345.0,16600,17300,68360,1,700,2015
446815,1.9,143788.0,1375,1900,56120,14,525,2015
464768,1.9,97986.0,10250,11700,61490,8,1450,2015
475114,1.9,40228.0,5050,4600,73130,5,-450,2014
290862,4.1,23426.0,12350,12800,59100,2,450,2015
349129,4.2,26297.0,22200,22250,62960,2,50,2014
372545,3.2,225864.0,6525,3200,64520,13,-3325,2015
345910,3.3,486.0,36000,29900,82750,0,-6100,2015
216932,1.9,196901.0,900,1550,57290,10,650,2015
345812,4.2,12837.0,31500,31500,82750,0,0,2015
22966,4.3,29283.0,12350,13900,77030,3,1550,2015
278607,4.2,54706.0,11600,12900,59100,2,1300,2015
229878,3.8,56242.0,11900,11800,89090,2,-100,2015
8476,4.1,20897.0,14300,15400,77030,2,1100,2015
140344,4.1,38239.0,22400,24100,73100,3,1700,2015
459589,3.8,74311.0,9300,9600,61490,3,300,2015
147103,4.3,49480.0,11150,12500,73100,3,1350,2015
44590,2.9,28309.0,11850,6500,77030,2,-5350,2015
473035,1.9,97406.0,7775,6000,62930,5,-1775,2015
248386,1.9,163479.0,1300,600,59100,17,-700,2015
384883,4.8,63248.0,23800,22500,65610,4,-1300,2015
369322,2.0,111820.0,4225,2600,64520,9,-1625,2015
505816,5.0,10258.0,27500,28100,80610,1,600,2015
30974,4.1,23011.0,12300,13500,77030,2,1200,2015
31954,4.1,134705.0,14300,15000,77030,5,700,2015
527171,4.5,81678.0,12000,12700,70210,7,700,2015
382259,3.6,132736.0,12850,9700,65610,4,-3150,2014
380449,4.6,24020.0,26400,26800,64520,2,400,2015
187502,3.0,93303.0,6200,6600,63250,5,400,2015
431367,3.5,167487.0,3350,4100,61450,7,750,2015
295964,4.3,43081.0,18400,19000,59100,2,600,2015
38517,4.8,43155.0,26500,27500,77030,3,1000,2015
393321,4.4,12781.0,21600,21000,65610,0,-600,2015
154169,4.9,53182.0,19900,22500,73100,5,2600,2015
431595,4.3,20532.0,14100,13200,61450,1,-900,2015
292461,2.8,144225.0,6500,5700,59100,3,-800,2015
177949,4.1,107134.0,18400,16100,83200,4,-2300,2015
259386,4.9,12.0,24000,28800,59100,1,4800,2015
547209,3.9,17452.0,14950,15000,78090,3,50,2015
1242,3.9,66109.0,9325,8900,77030,2,-425,2014
221659,3.6,69898.0,15300,17200,57290,3,1900,2015
235327,3.7,38228.0,11200,11500,59100,1,300,2015
230760,3.2,72648.0,8275,8100,89090,3,-175,2015
174768,4.0,16808.0,19900,20400,83200,1,500,2015
243966,2.9,32051.0,20600,20200,59100,4,-400,2015
38448,2.5,39229.0,24900,23000,77030,3,-1900,2015
233357,,49433.0,8850,9200,59100,3,350,2014
171711,4.4,29259.0,31300,31800,73100,2,500,2015
5356,5.0,5797.0,24800,26400,77030,0,1600,2014
193236,5.0,12186.0,23600,23750,67090,0,150,2015
152887,4.3,57437.0,18350,17400,73100,4,-950,2015
211734,2.4,83447.0,7500,7600,57290,4,100,2015
182465,2.8,109534.0,9125,8100,63250,3,-1025,2014
88990,3.7,15322.0,15750,16000,68360,2,250,2015
76197,1.9,85532.0,8850,7300,68360,2,-1550,2014
354679,2.8,63217.0,9350,9500,62960,2,150,2015
301554,4.4,21570.0,10400,10800,59100,3,400,2015
210480,4.7,13341.0,13750,14000,57290,1,250,2015
95423,3.7,42462.0,18000,18250,68360,4,250,2015
468519,3.7,133384.0,9350,10100,61490,4,750,2015
485755,4.9,12030.0,23200,22200,73130,0,-1000,2015
544855,4.2,26015.0,21400,22750,81400,2,1350,2015
534177,3.9,33447.0,14750,13800,82150,3,-950,2015
47917,2.6,121340.0,6225,7400,77030,3,1175,2015
293829,3.8,51278.0,8775,8601,59100,2,-174,2015
505848,4.3,23940.0,14450,15000,80610,1,550,2015
196428,4.2,8402.0,14350,13800,67090,1,-550,2015
386353,3.7,106203.0,5975,6000,65610,7,25,2015
385026,5.0,20934.0,25300,23500,65610,2,-1800,2015
267156,4.1,15436.0,17950,18500,59100,1,550,2015
180412,4.1,66649.0,6025,6900,83200,4,875,2015
325846,3.9,69701.0,24800,26750,82750,7,1950,2015
364365,4.2,31352.0,14850,14000,64520,4,-850,2015
295811,4.4,4220.0,38400,37000,59100,1,-1400,2015
40918,4.4,3787.0,15400,16000,77030,2,600,2015
100923,2.1,80251.0,17300,17600,68360,7,300,2015
183881,1.0,94331.0,6625,5900,63250,10,-725,2014
19721,4.8,1727.0,63000,67000,77030,1,4000,2015
115016,1.9,66356.0,11500,9100,68360,7,-2400,2015
428949,1.9,114022.0,4125,2600,61450,5,-1525,2015
282730,4.1,111359.0,6825,8500,59100,9,1675,2015
290016,1.9,134337.0,1650,2400,59100,11,750,2015
216640,4.9,19968.0,22400,25200,57290,2,2800,2015
521038,1.9,139085.0,3275,2900,71660,13,-375,2015
456018,1.9,171183.0,2325,2200,61490,9,-125,2015
59065,1.0,16083.0,14100,9500,77030,1,-4600,2015
178333,3.5,41667.0,12300,13000,83200,3,700,2015
549409,2.7,98626.0,6625,3500,48460,8,-3125,2015
211674,4.4,38789.0,13800,13400,57290,1,-400,2015
45738,1.9,121650.0,7325,5300,77030,11,-2025,2015
67140,4.3,36896.0,16450,16500,77030,3,50,2015
262850,3.6,30140.0,50100,46200,59100,2,-3900,2015
419786,1.9,140159.0,2800,2300,61450,11,-500,2015
363923,2.7,41949.0,13600,13000,64520,2,-600,2015
113975,1.9,102768.0,8475,9100,68360,5,625,2015
311126,2.0,56924.0,7575,5800,59100,11,-1775,2015
287609,2.9,146959.0,3600,3500,59100,10,-100,2015
308004,2.1,154069.0,1050,1600,59100,18,550,2015
476268,,165320.0,1750,850,73130,14,-900,2014
68574,4.6,30661.0,21200,22250,77030,3,1050,2015
244194,1.9,134608.0,3025,1800,59100,9,-1225,2015
52691,3.8,76436.0,11550,12300,77030,3,750,2015
222593,2.0,232977.0,450,300,89090,24,-150,2014
364292,3.1,55696.0,11850,10500,64520,3,-1350,2015
208121,4.0,21955.0,27800,29200,57290,1,1400,2015
251250,3.0,13959.0,12500,12200,59100,1,-300,2015
536932,4.9,5369.0,18250,18700,73640,1,450,2015
130236,3.0,6837.0,12050,12600,73100,1,550,2015
26630,2.6,95390.0,9775,6200,77030,4,-3575,2015
515936,4.8,11600.0,18900,21000,71660,2,2100,2015
283389,2.0,76068.0,13350,10700,59100,6,-2650,2015
265665,4.0,33149.0,10650,10500,59100,2,-150,2015
287295,1.9,125576.0,1500,1900,59100,14,400,2015
354541,4.4,21315.0,21800,21000,62960,4,-800,2015
477978,4.0,28705.0,16350,15300,73130,1,-1050,2015
353884,2.0,135845.0,1575,750,62960,11,-825,2015
330528,4.8,33459.0,17300,17200,82750,3,-100,2015
256723,4.0,16628.0,12600,12700,59100,1,100,2015
507037,3.4,50024.0,21200,19500,80200,3,-1700,2015
76155,4.6,18244.0,12100,12900,68360,1,800,2014
372794,4.1,52092.0,15400,15600,64520,2,200,2015
243537,4.8,17530.0,23100,22400,59100,3,-700,2015
251151,4.6,41861.0,11500,12000,59100,3,500,2015
428678,4.2,62707.0,12650,13500,61450,2,850,2015
150273,3.8,52751.0,12150,12100,73100,2,-50,2015
540242,4.3,11111.0,32800,32800,81400,0,0,2015
38066,4.3,38337.0,11200,11000,77030,2,-200,2015
445568,3.0,159779.0,2200,3500,56120,12,1300,2015
189231,2.0,44144.0,9225,7800,63250,2,-1425,2015
70198,5.0,11101.0,16400,16500,77030,1,100,2015
471460,4.2,17940.0,16350,16500,62930,1,150,2015
462322,2.3,162808.0,4550,4300,61490,8,-250,2015
449497,2.6,169284.0,1300,1600,61490,15,300,2015
368108,4.4,29817.0,18900,19700,64520,4,800,2015
246827,1.9,111224.0,2050,1300,59100,15,-750,2015
497559,3.0,21139.0,21500,23500,73130,2,2000,2015
437426,2.5,154576.0,1050,700,74430,15,-350,2015
511905,2.8,94216.0,8700,6900,71660,7,-1800,2015
424057,4.2,27226.0,11150,11700,61450,2,550,2015
58534,3.0,29141.0,12900,12600,77030,1,-300,2015
184419,4.0,54452.0,10450,10700,63250,2,250,2015
495850,4.1,37191.0,13550,13900,73130,1,350,2015
200017,4.3,85462.0,7675,8500,67090,4,825,2015
4119,3.4,98955.0,6225,7500,77030,9,1275,2014
371654,2.4,121778.0,4675,4000,64520,11,-675,2015
363243,4.8,61058.0,12500,12800,64520,2,300,2015
537083,3.7,55298.0,13750,16000,73640,4,2250,2015
9964,4.3,26210.0,12500,12400,77030,1,-100,2014
331216,1.9,122934.0,2900,2800,82750,12,-100,2015
260397,2.8,125871.0,5175,5100,59100,5,-75,2015
506570,1.0,3575.0,16450,11700,80200,1,-4750,2015
257857,4.4,41387.0,16800,18300,59100,3,1500,2015
455369,3.5,119409.0,1850,3500,61490,14,1650,2015
418678,3.7,21614.0,20000,20800,61450,1,800,2015
137628,1.9,87466.0,6025,3000,73100,7,-3025,2015
345616,4.2,13213.0,14900,15000,82750,2,100,2015
284158,2.6,182617.0,6475,5500,59100,12,-975,2015
301644,1.9,65570.0,6350,6200,59100,5,-150,2015
107100,3.7,17299.0,13450,14300,68360,1,850,2015
282045,1.9,86097.0,3750,3500,59100,13,-250,2015
478502,3.2,10702.0,22000,19200,73130,2,-2800,2015
536907,2.3,100133.0,5875,7300,73640,9,1425,2015
372423,1.0,160672.0,3525,1900,64520,9,-1625,2015
335170,3.4,96777.0,6525,6600,82750,7,75,2015
353201,4.8,18738.0,20200,19900,62960,0,-300,2015
321401,3.6,54729.0,21500,22400,82750,4,900,2014
127936,3.7,60550.0,21500,18700,73100,4,-2800,2015
292067,3.9,7485.0,13700,13200,59100,3,-500,2015
165799,4.0,38620.0,29000,25000,73100,4,-4000,2015
521476,2.4,73578.0,7900,7800,71660,2,-100,2015
364327,2.9,92975.0,7100,7600,64520,4,500,2015
414701,4.6,12658.0,15750,17100,61450,1,1350,2015
393617,4.0,53979.0,9175,10100,65610,2,925,2015
543511,2.9,79912.0,10200,13400,81400,8,3200,2015
315587,3.5,8183.0,19750,19400,59100,1,-350,2015
479799,4.4,51591.0,11050,12600,73130,3,1550,2015
107,3.7,15727.0,66000,65000,77030,0,-1000,2014
259647,3.7,29734.0,12050,11300,59100,2,-750,2015
380126,3.3,9787.0,16350,14000,64520,2,-2350,2015
235472,3.1,140748.0,5200,4700,59100,12,-500,2015
431173,4.3,18612.0,31700,31000,61450,0,-700,2015
522943,3.0,53730.0,9175,10100,71660,2,925,2015
491884,3.5,51528.0,9050,8600,73130,2,-450,2015
243106,4.8,16306.0,28400,27600,59100,1,-800,2015
535391,2.8,93205.0,5575,6000,82150,10,425,2015
298468,4.1,48213.0,9825,10800,59100,2,975,2015
61088,3.7,100502.0,7575,9300,77030,9,1725,2015
201692,4.3,64443.0,22300,23500,57290,2,1200,2014
430667,2.5,141287.0,5575,4250,61450,9,-1325,2015
348706,3.4,40006.0,18250,18800,62960,1,550,2014
149563,3.5,47856.0,11200,10900,73100,3,-300,2015
483488,2.9,42794.0,26000,25200,73130,3,-800,2015
20559,3.5,55263.0,13300,14200,77030,3,900,2015
124367,3.1,36548.0,11450,10500,73100,2,-950,2014
35782,2.4,93155.0,3850,4500,77030,9,650,2015
115401,1.9,93773.0,12350,11900,68360,11,-450,2015
249700,2.7,200515.0,1125,1100,59100,17,-25,2015
468650,3.3,74940.0,8850,9200,61490,5,350,2015
163297,4.6,784.0,57800,57500,73100,1,-300,2015
113291,3.3,30496.0,18900,17200,68360,3,-1700,2015
227742,3.8,79437.0,6200,5100,89090,4,-1100,2015
356698,3.8,83279.0,14700,21100,62960,11,6400,2015
285752,1.9,95801.0,11900,11100,59100,7,-800,2015
407026,2.0,60393.0,8125,8301,61450,3,176,2015
502713,2.0,119427.0,4775,3700,80610,13,-1075,2015
317876,4.2,52484.0,9575,9600,73200,2,25,2015
108654,3.5,90958.0,14750,14400,68360,7,-350,2015
131063,4.4,33458.0,12900,11000,73100,4,-1900,2015
357452,2.6,27425.0,14800,13000,62960,1,-1800,2015
30580,4.9,10946.0,18150,19000,77030,1,850,2015
289219,4.7,2367.0,78000,79250,59100,1,1250,2015
111884,3.6,60451.0,23900,22000,68360,5,-1900,2015
214519,3.5,32316.0,25300,23200,57290,2,-2100,2015
498846,4.3,60533.0,13550,13900,80610,1,350,2014
222583,2.0,168151.0,1600,300,89090,19,-1300,2014
365183,3.6,101606.0,8750,9500,64520,10,750,2015
119197,3.2,32888.0,20200,17200,73100,3,-3000,2014
304085,3.9,70456.0,15200,15600,59100,1,400,2015
512553,3.5,116777.0,11000,13800,71660,7,2800,2015
318029,4.1,36729.0,13900,14000,73200,2,100,2015
5440,4.7,6558.0,13800,13700,77030,0,-100,2014
517501,4.6,41216.0,11500,11100,71660,1,-400,2015
487649,2.9,29841.0,11050,10300,73130,3,-750,2015
512221,2.9,35684.0,22400,21700,71660,3,-700,2015
110664,2.8,163464.0,2150,1300,68360,13,-850,2015
530557,1.9,151545.0,1300,400,82150,12,-900,2015
432334,4.0,18253.0,23400,24500,74430,0,1100,2014
119791,3.9,109713.0,8925,8600,73100,4,-325,2014
269064,2.0,159204.0,1975,1800,59100,11,-175,2015
230563,1.9,160550.0,2150,2200,89090,15,50,2015
87952,4.6,9511.0,21000,21000,68360,1,0,2015
214189,3.3,24316.0,14400,18300,57290,2,3900,2015
409876,4.0,18222.0,11000,12000,61450,4,1000,2015
392974,4.9,18164.0,12500,13800,65610,3,1300,2015
154890,4.6,35190.0,23600,24900,73100,3,1300,2015
128530,2.7,23694.0,10100,10200,73100,4,100,2015
290781,4.9,9484.0,16100,16900,59100,1,800,2015
212592,5.0,8536.0,35000,37100,57290,1,2100,2015
354191,4.6,13686.0,14300,15500,62960,3,1200,2015
366606,3.7,94167.0,6825,7700,64520,6,875,2015
471943,3.1,98242.0,3525,3200,62930,10,-325,2015
547794,3.4,75871.0,14150,11500,78090,4,-2650,2015
518735,4.2,37167.0,12150,13900,71660,3,1750,2015
32683,4.5,16078.0,86000,87000,77030,1,1000,2015
272649,3.7,168573.0,12450,13800,59100,5,1350,2015
415401,4.6,58228.0,9800,10800,61450,3,1000,2015
289943,2.8,82735.0,6425,7600,59100,10,1175,2015
426989,4.8,36148.0,23000,22200,61450,3,-800,2015
343728,1.9,113644.0,5275,3000,82750,9,-2275,2015
405959,3.5,45071.0,10550,10600,61450,1,50,2015
268587,1.9,52116.0,9000,7500,59100,3,-1500,2015
222444,1.9,65154.0,5100,5100,89090,8,0,2014
457723,3.7,31465.0,12150,10600,61490,2,-1550,2015
126725,2.0,101748.0,7075,6400,73100,6,-675,2015
466233,2.6,105866.0,10850,10800,61490,9,-50,2015
177109,2.5,111415.0,4800,5400,83200,10,600,2015
106855,3.4,90058.0,8200,5800,68360,4,-2400,2015
38425,1.0,23371.0,13200,10500,77030,1,-2700,2015
205703,4.2,23047.0,22600,24500,57290,2,1900,2015
400432,2.8,92038.0,3950,2800,61450,9,-1150,2015
307874,2.9,133225.0,2625,3100,59100,10,475,2015
162149,3.5,39538.0,63000,62800,73100,7,-200,2015
408985,4.3,7810.0,40600,40000,61450,0,-600,2015
52230,2.4,120060.0,5300,6700,77030,8,1400,2015
43177,4.6,7949.0,18250,17900,77030,1,-350,2015
254562,2.3,104767.0,2350,2000,59100,16,-350,2015
220415,4.2,55040.0,16650,18700,57290,5,2050,2015
383673,4.0,55772.0,8625,8000,65610,4,-625,2014
93631,4.4,59007.0,24500,26000,68360,7,1500,2015
372868,4.1,92262.0,7275,8300,64520,7,1025,2015
80520,2.5,30145.0,11150,9800,68360,2,-1350,2015
36559,3.4,38546.0,13050,13000,77030,2,-50,2015
339356,4.0,35757.0,22200,18000,82750,3,-4200,2015
353078,2.0,87266.0,3750,4500,62960,11,750,2015
325390,3.6,17291.0,12650,12500,82750,3,-150,2015
43988,4.2,99833.0,4725,6800,77030,6,2075,2015
96037,2.4,80870.0,22400,23700,68360,4,1300,2015
182764,1.9,91595.0,6900,6900,63250,7,0,2014
505646,4.4,28203.0,7625,8100,80610,2,475,2015
285725,2.3,115362.0,14050,12800,59100,7,-1250,2015
192690,3.2,36010.0,13250,12100,67090,3,-1150,2015
523505,3.9,24867.0,15000,16100,71660,1,1100,2015
65951,3.9,147805.0,6125,6200,77030,10,75,2015
133666,4.0,16055.0,16600,16300,73100,1,-300,2015
293246,4.2,34562.0,16900,16700,59100,1,-200,2015
27905,1.9,41690.0,19200,18000,77030,3,-1200,2015
427336,3.2,27503.0,9650,7900,61450,1,-1750,2015
129048,3.6,39072.0,12300,11800,73100,2,-500,2015
148782,4.5,36436.0,11700,12100,73100,3,400,2015
126025,4.0,5272.0,15050,14400,73100,1,-650,2015
407304,3.9,30686.0,20700,20600,61450,2,-100,2015
260476,4.5,69880.0,13600,13800,59100,7,200,2015
253944,2.7,195812.0,5075,4100,59100,11,-975,2015
68429,2.0,99066.0,8725,8000,77030,11,-725,2015
151614,1.1,141810.0,2725,950,73100,12,-1775,2015
71837,2.5,123697.0,3625,3000,77030,10,-625,2015
444798,1.0,272517.0,425,600,56120,18,175,2014
146647,2.2,39295.0,15350,12800,73100,3,-2550,2015
512382,4.8,18084.0,30200,30200,71660,1,0,2015
411837,3.6,112658.0,11900,13200,61450,7,1300,2015
174666,4.7,35723.0,22500,23000,83200,2,500,2015
89211,2.9,74698.0,18350,16600,68360,3,-1750,2015
413848,2.6,71456.0,7775,9700,61450,10,1925,2015
316079,3.3,88329.0,14600,15900,73200,6,1300,2014
220539,4.2,50797.0,18650,18750,57290,3,100,2015
405524,4.8,13274.0,24100,26600,61450,1,2500,2015
330513,3.8,68477.0,20600,22400,82750,3,1800,2015
216158,4.5,34676.0,15800,15700,57290,1,-100,2015
71907,1.9,149219.0,700,500,77030,14,-200,2015
344463,2.5,22041.0,13800,11400,82750,1,-2400,2015
476550,3.7,24968.0,15350,16000,73130,1,650,2014
544222,4.2,98121.0,9000,9300,81400,3,300,2015
514956,4.4,14737.0,17700,17200,71660,1,-500,2015
292138,2.6,90872.0,11600,11000,59100,5,-600,2015
206601,4.7,18186.0,25500,27300,57290,1,1800,2015
92046,4.6,16813.0,21800,23000,68360,2,1200,2015
449471,,180834.0,1275,800,61490,13,-475,2014
226256,1.0,107351.0,1600,225,89090,12,-1375,2015
522337,4.0,137916.0,13900,13800,71660,7,-100,2015
493593,3.3,47517.0,16800,16600,73130,2,-200,2015
492333,3.6,15148.0,22400,22700,73130,2,300,2015
41428,4.2,41839.0,9425,11500,77030,6,2075,2015
517958,1.9,186786.0,4600,5700,71660,10,1100,2015
87185,2.7,167421.0,8025,7500,68360,6,-525,2015
445189,1.0,19240.0,12950,8100,56120,1,-4850,2015
245074,2.3,70658.0,6000,5400,59100,3,-600,2015
46339,1.9,72076.0,2975,3600,77030,10,625,2015
263119,3.9,69186.0,8850,9100,59100,3,250,2015
92452,2.5,126085.0,4050,3000,68360,4,-1050,2015
129667,4.0,33678.0,41300,40900,73100,1,-400,2015
203109,3.7,24394.0,16800,16000,57290,3,-800,2015
227411,2.9,116331.0,1025,1500,89090,17,475,2015
147182,4.1,43446.0,18550,19200,73100,4,650,2015
45719,3.8,122185.0,6450,7600,77030,9,1150,2015
113125,2.9,62299.0,11250,11500,68360,2,250,2015
460716,4.2,18459.0,33800,31500,61490,3,-2300,2015
189324,1.9,157881.0,5475,4800,63250,7,-675,2015
532679,3.1,93015.0,7125,6600,82150,7,-525,2015
88535,2.5,146211.0,5750,7500,68360,9,1750,2015
415467,4.1,134254.0,14900,10900,61450,4,-4000,2015
261326,2.9,35047.0,19100,19300,59100,2,200,2015
296484,3.6,27434.0,16900,17400,59100,1,500,2015
84826,3.7,36265.0,21900,22000,68360,1,100,2015
263882,2.3,79922.0,10500,8700,59100,4,-1800,2015
192078,5.0,14210.0,16550,17200,67090,1,650,2014
23818,4.1,76871.0,8300,9400,77030,6,1100,2015
42913,4.6,42215.0,10300,14700,77030,10,4400,2015
241144,2.7,17011.0,15250,14200,59100,1,-1050,2014
305253,3.8,21057.0,23900,23000,59100,1,-900,2015
308164,3.6,61823.0,13800,13000,59100,2,-800,2015
108907,3.0,132308.0,8425,5200,68360,3,-3225,2015
2626,4.4,19448.0,18300,19000,77030,4,700,2014
185730,4.7,25685.0,15200,16500,63250,3,1300,2015
253852,2.6,80710.0,7325,7700,59100,6,375,2015
412734,5.0,16586.0,21700,23100,61450,2,1400,2015
401988,3.6,40643.0,8300,9100,61450,3,800,2015
331201,2.7,140130.0,2725,2300,82750,11,-425,2015
75100,,167816.0,650,500,68360,15,-150,2014
33601,3.5,56755.0,27900,31750,77030,4,3850,2015
386219,4.5,60780.0,17050,17800,65610,5,750,2015
392601,4.9,22469.0,28200,27100,65610,1,-1100,2015
419659,2.3,26111.0,18550,16900,61450,3,-1650,2015
278838,3.6,58287.0,8250,8300,59100,4,50,2015
416489,5.0,7152.0,24000,27000,61450,2,3000,2015
341173,4.4,44344.0,16300,16000,82750,2,-300,2015
4244,,87726.0,7475,8900,77030,9,1425,2014
384031,4.9,1882.0,14100,13400,65610,1,-700,2015
164438,4.2,57768.0,10500,10800,73100,2,300,2015
323528,3.9,109955.0,9700,10200,82750,8,500,2015
314927,4.4,35237.0,12550,13800,59100,4,1250,2015
25327,3.0,83624.0,15150,14900,77030,5,-250,2015
360779,3.0,107654.0,6350,4950,64520,9,-1400,2015
314734,4.8,26954.0,16850,16100,59100,1,-750,2015
280145,2.8,112856.0,7450,7900,59100,8,450,2015
115392,2.4,58339.0,10500,11100,68360,10,600,2015
535422,4.0,37836.0,12750,12000,82150,2,-750,2015
312032,3.8,7292.0,32500,35600,59100,2,3100,2015
28349,3.0,22285.0,31800,26400,77030,1,-5400,2015
482009,5.0,23625.0,19200,19700,73130,1,500,2015
488010,4.2,32705.0,23100,24800,73130,4,1700,2015
446123,3.3,120796.0,16300,15100,56120,9,-1200,2015
426167,3.3,196961.0,3200,4000,61450,12,800,2015
272547,2.9,76863.0,9825,10300,59100,4,475,2015
25291,3.0,31508.0,10250,10200,77030,3,-50,2015
239323,4.9,10811.0,17100,17300,59100,0,200,2014
444186,2.7,52294.0,10850,10700,74430,2,-150,2015
460303,3.3,99324.0,7650,8300,61490,9,650,2015
274057,3.5,93418.0,7100,7900,59100,3,800,2015
7288,3.4,14799.0,17450,17100,77030,0,-350,2014
277211,4.6,7805.0,15100,16800,59100,2,1700,2015
479848,4.3,40320.0,15800,14400,73130,3,-1400,2015
420976,4.1,197851.0,1500,2900,61450,13,1400,2015
417610,3.6,82459.0,14900,16800,61450,7,1900,2015
46617,2.1,262821.0,100,300,77030,17,200,2015
272772,3.6,92006.0,10300,9400,59100,7,-900,2015
305266,4.4,13077.0,19050,19800,59100,1,750,2015
91221,1.9,112804.0,4050,3300,68360,7,-750,2015
452761,3.3,114141.0,6350,6800,61490,6,450,2015
521331,4.1,24392.0,12200,12300,71660,1,100,2015
2890,2.1,99436.0,6500,4100,77030,5,-2400,2014
66013,2.5,8850.0,49100,43000,77030,1,-6100,2015
283590,1.9,173935.0,775,3600,59100,10,2825,2015
518009,4.2,25003.0,24800,24500,71660,3,-300,2015
41683,3.9,125087.0,6050,6000,77030,9,-50,2015
154298,4.3,41401.0,11050,10200,73100,3,-850,2015
327467,2.4,59097.0,11650,11800,82750,5,150,2015
129652,4.1,51977.0,18950,18700,73100,4,-250,2015
520403,1.9,125466.0,3250,2500,71660,12,-750,2015
333560,5.0,3482.0,17950,18750,82750,1,800,2015
265425,4.0,8335.0,12750,12600,59100,1,-150,2015
83637,4.5,29791.0,11250,11600,68360,2,350,2015
269283,4.9,10318.0,13850,15000,59100,2,1150,2015
206785,4.1,87838.0,11950,13600,57290,8,1650,2015
380135,3.6,24408.0,15900,15200,64520,2,-700,2015
489463,2.3,56791.0,9375,7600,73130,8,-1775,2015
367879,4.8,34503.0,17350,18200,64520,2,850,2015
118778,3.8,89561.0,5750,6300,68360,11,550,2015
471606,2.0,25017.0,11600,7000,62930,1,-4600,2015
319626,3.5,7782.0,20100,20000,73200,1,-100,2015
374852,2.8,113654.0,5350,2500,64520,7,-2850,2015
460697,4.8,20272.0,33400,33500,61490,2,100,2015
330067,3.6,47944.0,11300,9700,82750,3,-1600,2015
382435,,92832.0,9000,9200,65610,6,200,2014
214065,3.9,27363.0,18600,20000,57290,2,1400,2015
465194,3.7,68953.0,12800,13000,61490,3,200,2015
182859,,156791.0,2400,3200,63250,8,800,2014
27901,3.9,37951.0,10900,12100,77030,3,1200,2015
219207,2.0,39878.0,14250,13500,57290,1,-750,2015
220204,2.9,207251.0,1775,2500,57290,12,725,2015
35496,3.2,34411.0,26000,24750,77030,3,-1250,2015
453525,4.0,79137.0,8475,9800,61490,3,1325,2015
507701,4.4,126761.0,14750,14700,80200,4,-50,2015
231197,2.8,146921.0,7050,6300,89090,11,-750,2015
104211,2.7,58102.0,12600,10400,68360,6,-2200,2015
138913,4.4,37315.0,14500,15200,73100,3,700,2015
260262,3.7,30914.0,17800,17000,59100,3,-800,2015
183506,,9364.0,14150,14000,63250,0,-150,2014
33510,3.4,52477.0,10850,12750,77030,3,1900,2015
204199,2.9,90965.0,5600,5100,57290,5,-500,2015
258596,4.6,20497.0,12750,13600,59100,3,850,2015
146357,3.9,96411.0,17650,18800,73100,7,1150,2015
538699,4.1,55938.0,13150,13400,55590,2,250,2015
237992,3.5,75866.0,12350,13600,59100,5,1250,2014
222820,2.0,195429.0,875,300,89090,16,-575,2014
279256,4.9,38262.0,16600,16500,59100,1,-100,2015
69428,3.3,54094.0,9325,9900,77030,2,575,2015
97720,2.5,131577.0,1675,2300,68360,9,625,2015
271220,2.0,32631.0,14500,10900,59100,1,-3600,2015
308721,2.1,120719.0,1100,700,59100,17,-400,2015
101840,2.7,121461.0,5475,5100,68360,7,-375,2015
363217,5.0,10336.0,21300,21300,64520,0,0,2015
225813,3.7,69244.0,18000,17300,89090,6,-700,2015
265488,2.4,1498.0,16250,14800,59100,0,-1450,2015
12255,2.6,163734.0,3525,2900,77030,14,-625,2014
201584,4.9,12077.0,25100,28000,57290,1,2900,2014
141083,4.3,75463.0,22500,22700,73100,5,200,2015
28551,3.8,48471.0,10700,10900,77030,2,200,2015
54142,1.9,225471.0,5825,6300,77030,6,475,2015
16854,4.1,85082.0,7350,9300,77030,5,1950,2015
6478,3.8,19204.0,22300,22500,77030,1,200,2014
235381,,109012.0,3325,3700,59100,11,375,2014
406673,2.3,82028.0,10950,8800,61450,6,-2150,2015
106510,4.4,37899.0,12750,13000,68360,1,250,2015
25182,3.3,147554.0,1025,800,77030,17,-225,2015
79086,1.9,149370.0,5050,2800,68360,10,-2250,2015
65602,4.5,61911.0,7750,9300,77030,9,1550,2015
439654,4.4,93967.0,6725,7500,74430,7,775,2015
200666,4.2,40481.0,22100,21400,67090,3,-700,2015
157111,2.7,49677.0,22700,21300,73100,2,-1400,2015
428455,1.9,111850.0,4175,4400,61450,7,225,2015
503849,3.8,23631.0,14500,13800,80610,1,-700,2015
475756,2.2,117907.0,8575,3500,73130,9,-5075,2014
339217,2.8,124037.0,6200,5800,82750,9,-400,2015
166974,3.7,136161.0,6875,6600,73100,5,-275,2015
123526,3.7,4060.0,21800,20700,73100,1,-1100,2015
60893,4.4,41229.0,20900,21250,77030,2,350,2015
429407,4.5,23044.0,16000,16600,61450,2,600,2015
179020,2.7,72105.0,5925,6300,83200,5,375,2015
271550,3.6,19518.0,11150,11200,59100,4,50,2015
202664,2.8,81181.0,8000,7500,57290,3,-500,2014
224545,2.8,142679.0,4200,4200,89090,11,0,2015
251201,1.9,34515.0,10450,10000,59100,3,-450,2015
399089,3.6,57932.0,12850,12900,61450,3,50,2015
450534,2.6,112876.0,1750,1400,61490,9,-350,2014
97023,3.4,100252.0,31900,32500,68360,4,600,2015
121498,4.3,28922.0,14050,14100,73100,1,50,2014
282508,2.0,52089.0,1050,1700,59100,15,650,2015
529739,3.3,170674.0,2175,2000,82150,12,-175,2014
384359,4.0,12857.0,15400,14600,65610,1,-800,2015
186643,3.5,45552.0,19650,20800,63250,2,1150,2015
433622,2.7,47242.0,12450,7600,74430,2,-4850,2015
476912,2.6,13229.0,13800,12600,73130,2,-1200,2014
176243,3.6,53330.0,13100,13500,83200,2,400,2015
453442,3.5,176426.0,4825,5600,61490,11,775,2015
507237,3.8,142020.0,3425,2900,80200,13,-525,2015
388691,5.0,35121.0,14150,15000,65610,2,850,2015
392247,5.0,103033.0,11600,12700,65610,12,1100,2015
59763,2.7,25416.0,21200,18500,77030,2,-2700,2015
257872,4.1,42945.0,22000,24600,59100,3,2600,2015
400663,4.4,22948.0,22700,22400,61450,2,-300,2015
224797,2.0,181623.0,1100,450,89090,14,-650,2015
317725,3.7,28046.0,12900,11700,73200,2,-1200,2015
12789,4.6,11994.0,11050,12000,77030,1,950,2015
74638,,109420.0,5400,8100,68360,10,2700,2014
132818,3.4,24416.0,17450,17700,73100,4,250,2015
347453,4.0,49638.0,28600,28250,82750,2,-350,2015
528268,1.0,137547.0,5400,1000,70210,10,-4400,2015
57716,2.8,62056.0,11300,10200,77030,2,-1100,2015
331861,4.3,39376.0,27900,28750,82750,3,850,2015
229684,4.9,3774.0,18500,16600,89090,2,-1900,2015
362015,3.6,37146.0,20000,19800,64520,1,-200,2014
107876,2.0,57754.0,9400,8400,68360,2,-1000,2015
536304,3.5,32981.0,11550,11200,73640,1,-350,2015
303739,4.1,94831.0,18050,17500,59100,4,-550,2015
182493,3.7,78045.0,12800,13300,63250,3,500,2014
61149,1.9,137672.0,3550,3000,77030,14,-550,2015
321939,3.4,22794.0,16750,16800,82750,2,50,2014
138199,4.0,16784.0,16400,16200,73100,1,-200,2015
230769,2.6,93821.0,5575,5100,89090,7,-475,2015
356520,2.3,13292.0,13650,14800,62960,1,1150,2015
163520,2.8,129087.0,17600,16000,73100,6,-1600,2015
513668,1.9,78838.0,6025,5100,71660,7,-925,2015
26114,2.8,140912.0,4325,4200,77030,8,-125,2015
453778,3.8,33060.0,11800,12400,61490,2,600,2015
231925,3.7,54293.0,9725,9700,89090,2,-25,2015
373452,4.1,37314.0,27400,28750,64520,3,1350,2015
20268,2.5,60168.0,14150,12000,77030,2,-2150,2015
533463,2.4,114302.0,4800,4400,82150,6,-400,2015
123519,2.0,106566.0,2075,425,73100,9,-1650,2014
327538,2.9,145651.0,3725,2600,82750,8,-1125,2015
44530,4.2,47947.0,11800,13100,77030,2,1300,2015
53203,3.8,39549.0,11450,12000,77030,2,550,2015
498756,2.4,111540.0,17900,19500,80610,7,1600,2014
101799,2.4,106891.0,8375,3600,68360,5,-4775,2015
189238,1.9,47126.0,8025,7000,63250,3,-1025,2015
542224,2.3,123464.0,5000,4600,81400,7,-400,2015
117659,1.9,102490.0,13050,10900,68360,10,-2150,2015
408725,3.5,46699.0,13750,14800,61450,3,1050,2015
404148,3.5,43436.0,12950,12700,61450,3,-250,2015
237550,2.2,22796.0,13200,10800,59100,2,-2400,2014
177758,3.2,194976.0,3100,4000,83200,12,900,2015
532122,2.0,159942.0,4175,3100,82150,11,-1075,2015
111432,2.1,240461.0,4825,2900,68360,14,-1925,2015
238815,2.4,188889.0,1350,400,59100,12,-950,2014
79231,3.5,21932.0,17150,17400,68360,2,250,2015
325466,3.6,39106.0,12100,11600,82750,3,-500,2015
326317,3.5,14008.0,17700,16700,82750,2,-1000,2015
25070,3.6,52190.0,4600,6800,77030,8,2200,2015
549950,3.8,94937.0,6675,8400,48460,9,1725,2015
348266,2.0,110042.0,3125,1200,62960,10,-1925,2014
117606,4.4,76870.0,12500,12600,68360,5,100,2015
42577,4.3,31388.0,31400,31000,77030,1,-400,2015
103387,1.0,1.0,18350,7000,68360,1,-11350,2015
38547,4.4,23218.0,12700,13500,77030,3,800,2015
229026,1.9,236803.0,925,700,89090,18,-225,2015
282575,4.9,12763.0,29100,30400,59100,1,1300,2015
191583,4.2,16923.0,53400,51000,67090,2,-2400,2015
465638,2.7,131196.0,850,1800,61490,17,950,2015
203254,4.3,23540.0,25500,26500,57290,3,1000,2015
73151,3.7,27065.0,24300,20100,68360,2,-4200,2014
242240,4.0,29383.0,18350,18500,59100,1,150,2015
474331,4.2,46716.0,9550,9900,62930,2,350,2015
404977,3.9,72670.0,15400,14700,61450,6,-700,2015
307891,1.9,88785.0,4050,3200,59100,11,-850,2015
388889,5.0,5221.0,12950,13700,65610,1,750,2015
128920,3.7,73056.0,3175,4300,73100,12,1125,2015
512005,4.4,31797.0,12100,12000,71660,1,-100,2015
222619,2.6,39305.0,12000,9900,89090,2,-2100,2015
276843,2.0,155212.0,2600,3350,59100,12,750,2015
8704,,28395.0,10750,3200,77030,6,-7550,2014
344599,3.6,8310.0,14550,14000,82750,2,-550,2015
38418,3.7,28520.0,10950,12700,77030,3,1750,2015
433407,2.5,113773.0,1075,1600,74430,12,525,2014
339226,4.1,45436.0,14450,12900,82750,3,-1550,2015
318040,4.8,79365.0,10300,11900,73200,4,1600,2015
15875,5.0,1955.0,18250,25900,77030,1,7650,2015
320548,2.2,200827.0,3400,2800,82750,10,-600,2015
123330,3.8,37430.0,11200,9600,73100,3,-1600,2015
307523,2.6,74266.0,8825,7200,59100,3,-1625,2015
127983,4.6,154072.0,3125,3550,73100,6,425,2015
381939,3.5,58883.0,30000,28750,64520,3,-1250,2015
506704,2.9,55117.0,11550,11300,80200,2,-250,2015
148030,4.2,33408.0,17500,17400,73100,1,-100,2015
126807,4.0,37667.0,17400,16400,73100,1,-1000,2015
494316,3.3,88983.0,9650,11000,73130,7,1350,2015
209606,3.2,20655.0,10600,11000,57290,3,400,2015
316269,2.9,83441.0,4125,5600,73200,10,1475,2014
544223,4.1,72435.0,27600,26800,81400,3,-800,2015
142574,4.1,44499.0,16450,16800,73100,3,350,2015
405418,1.9,207886.0,2525,2200,61450,14,-325,2015
508047,,123008.0,11100,8200,71660,6,-2900,2014
389607,4.6,159270.0,2375,2200,65610,13,-175,2015
151726,3.8,28361.0,11550,10900,73100,2,-650,2015
56893,4.1,31974.0,21700,21000,77030,3,-700,2015
377833,1.9,139048.0,1100,700,64520,14,-400,2015
38620,3.0,65235.0,11950,11600,77030,3,-350,2015
497553,1.9,67880.0,8850,8700,73130,2,-150,2015
66545,3.9,37128.0,12050,12750,77030,2,700,2015
240679,2.9,117726.0,7575,8300,59100,9,725,2014
96133,3.8,97588.0,11850,13200,68360,6,1350,2015
544021,1.0,138416.0,2125,550,81400,13,-1575,2015
511412,4.9,23355.0,28100,28000,71660,1,-100,2015
201981,4.3,14928.0,27200,26500,57290,1,-700,2014
299802,4.0,7176.0,49400,42200,59100,2,-7200,2015
319077,4.1,44778.0,10150,10300,73200,2,150,2015
332218,3.7,8909.0,11600,11300,82750,1,-300,2015
146562,4.5,31706.0,14100,14000,73100,2,-100,2015
306381,2.0,45266.0,10750,8900,59100,4,-1850,2015
297667,3.1,26613.0,12200,12000,59100,3,-200,2015
127616,3.7,45148.0,15450,17300,73100,4,1850,2015
546875,4.9,22498.0,32200,27000,81400,0,-5200,2015
141292,4.2,75780.0,5575,8200,73100,10,2625,2015
489851,4.0,22359.0,13500,13600,73130,1,100,2015
395490,4.8,35833.0,12750,12000,65610,3,-750,2015
391669,4.1,83908.0,17100,18300,65610,7,1200,2015
155667,3.0,99396.0,6150,4250,73100,10,-1900,2015
139076,4.6,30031.0,15950,17400,73100,3,1450,2015
146696,4.6,27454.0,23700,25600,73100,3,1900,2015
52651,4.2,35683.0,12650,13600,77030,3,950,2015
305799,2.4,55092.0,8950,7600,59100,5,-1350,2015
38724,3.5,59590.0,16250,15500,77030,4,-750,2015
58063,3.7,62602.0,9850,9800,77030,3,-50,2015
200032,2.7,60136.0,11500,11800,67090,2,300,2015
123793,2.8,54597.0,14050,12500,73100,10,-1550,2015
94979,4.1,6522.0,28300,28750,68360,1,450,2015
245445,1.9,72458.0,8025,5500,59100,6,-2525,2015
181776,3.0,24627.0,15250,15400,83200,1,150,2015
21098,2.3,174693.0,2675,4100,77030,8,1425,2015
120133,2.0,63904.0,18700,20000,73100,6,1300,2014
480638,3.0,19267.0,13400,13300,73130,1,-100,2015
132463,3.2,26642.0,25100,22250,73100,3,-2850,2015
89329,3.4,187248.0,14700,15400,68360,4,700,2015
20086,3.5,26682.0,14100,13500,77030,2,-600,2015
199792,5.0,24010.0,35400,37800,67090,1,2400,2015
19013,4.6,55781.0,10850,12250,77030,3,1400,2015
4371,3.0,202703.0,2425,2600,77030,11,175,2015
267244,5.0,10296.0,18400,18200,59100,1,-200,2015
192482,4.2,13801.0,36500,35800,67090,2,-700,2015
16861,3.5,30978.0,21900,26000,77030,5,4100,2015
347627,3.6,64579.0,14550,14600,82750,4,50,2015
339300,4.2,30444.0,14550,14900,82750,3,350,2015
456454,3.4,165089.0,2050,2900,61490,9,850,2015
125318,2.7,43697.0,11200,10400,73100,4,-800,2015
388219,4.5,41288.0,14200,14300,65610,1,100,2015
113837,1.9,125404.0,1850,1500,68360,11,-350,2015
176113,2.1,138350.0,4600,4500,83200,10,-100,2015
294820,4.3,77483.0,18600,18000,59100,4,-600,2015
2269,3.8,43231.0,34400,33500,77030,3,-900,2014
537165,3.4,49693.0,8675,8850,73640,2,175,2015
309007,3.8,42461.0,11650,11800,59100,3,150,2015
192405,4.5,4268.0,14300,14200,67090,0,-100,2015
170778,3.8,12957.0,3425,4800,73100,8,1375,2015
546087,2.9,123525.0,3825,4200,81400,6,375,2015
308256,4.5,38153.0,14900,14200,59100,2,-700,2015
494597,3.0,13525.0,23100,24700,73130,1,1600,2015
431787,2.8,113562.0,7575,4900,61450,6,-2675,2015
163434,3.7,31136.0,19800,19200,73100,4,-600,2015
162481,3.7,22748.0,14850,29000,73100,2,14150,2015
186886,3.6,60580.0,13450,13300,63250,1,-150,2015
36792,4.5,5339.0,11850,11750,77030,1,-100,2015
364457,2.5,102354.0,3850,3500,64520,10,-350,2015
296326,3.4,84011.0,7975,8300,59100,8,325,2015
279737,4.3,55568.0,12150,13700,59100,5,1550,2015
274090,4.7,30722.0,18700,19400,59100,3,700,2015
481241,4.3,34428.0,18350,18400,73130,1,50,2015
62103,3.5,69413.0,13450,12500,77030,7,-950,2015
508907,3.2,99276.0,5900,4900,71660,9,-1000,2014
240353,3.0,27970.0,17900,18200,59100,1,300,2015
176500,4.1,50700.0,8475,8400,83200,5,-75,2015
361612,4.3,69808.0,5225,5700,64520,7,475,2014
73450,1.9,58733.0,30300,23500,68360,5,-6800,2015
457999,2.4,70271.0,10550,7200,61490,4,-3350,2015
123989,4.4,39123.0,13800,13700,73100,1,-100,2015
106182,3.9,37181.0,18750,17700,68360,1,-1050,2015
527221,3.7,18477.0,20900,20800,70210,1,-100,2015
50025,1.9,141585.0,1175,950,77030,11,-225,2015
4077,3.0,32950.0,18500,11100,77030,0,-7400,2014
44662,4.9,8855.0,20600,19750,77030,2,-850,2015
203149,3.6,31314.0,20600,21000,57290,1,400,2015
520166,3.1,28832.0,11850,11800,71660,1,-50,2015
505984,3.6,23893.0,10300,10700,80610,2,400,2015
35384,4.4,30791.0,13500,16750,77030,7,3250,2015
401220,4.4,14796.0,15150,15000,61450,1,-150,2015
281785,3.3,36761.0,16250,15100,59100,3,-1150,2015
378469,2.3,98793.0,5875,7500,64520,8,1625,2015
119595,4.2,13746.0,9800,10500,73100,3,700,2014
48887,4.4,47526.0,40400,41500,77030,3,1100,2015
244538,2.0,17320.0,13250,11400,59100,1,-1850,2015
29759,4.2,41936.0,18250,18750,77030,3,500,2015
353548,3.5,56371.0,8800,8800,62960,2,0,2015
484891,4.4,15953.0,21300,21300,73130,1,0,2015
507445,2.6,18436.0,29800,28000,80200,1,-1800,2015
383905,3.8,112883.0,11550,9500,65610,8,-2050,2015
488319,2.0,70797.0,1200,1600,73130,11,400,2015
27940,4.1,57197.0,10650,11100,77030,3,450,2015
229827,2.5,241774.0,2875,3800,89090,15,925,2015
166497,4.4,42894.0,15800,17750,73100,11,1950,2015
411947,3.4,54458.0,16250,18400,61450,8,2150,2015
510703,1.7,146720.0,2700,600,71660,10,-2100,2015
180796,3.4,11658.0,18800,18500,83200,0,-300,2015
32396,2.8,279072.0,525,1400,77030,12,875,2015
173575,,172479.0,1075,700,83200,11,-375,2014
433211,,72551.0,4725,6300,74430,10,1575,2014
283257,3.5,31387.0,18900,17200,59100,4,-1700,2015
510536,4.3,28747.0,14550,15000,71660,1,450,2015
433121,,199069.0,2075,2000,74430,10,-75,2014
502077,2.4,104115.0,7275,6400,80610,7,-875,2015
38879,2.9,154939.0,1925,2400,77030,10,475,2015
503182,3.5,17532.0,9475,9300,80610,2,-175,2015
131790,3.6,41999.0,10200,9900,73100,3,-300,2015
457520,3.4,37351.0,14900,15200,61490,3,300,2015
96805,4.7,18834.0,14350,15700,68360,2,1350,2015
197641,2.9,93148.0,7325,8900,67090,5,1575,2015
403249,2.8,74943.0,14600,14700,61450,5,100,2015
520967,4.7,44824.0,27000,26500,71660,2,-500,2015
279997,3.6,19210.0,17500,16900,59100,1,-600,2015
278472,4.0,146651.0,8700,10700,59100,5,2000,2015
209316,4.2,96886.0,13600,14100,57290,5,500,2015
21075,3.3,117525.0,4350,4800,77030,8,450,2015
389407,5.0,59981.0,13000,13500,65610,2,500,2015
222804,2.0,239392.0,375,300,89090,14,-75,2014
541127,4.5,7034.0,12950,13000,81400,1,50,2015
263326,3.8,37289.0,19800,17800,59100,3,-2000,2015
26473,3.7,29862.0,13600,14800,77030,3,1200,2015
301233,3.5,44763.0,35700,35600,59100,3,-100,2015
106580,2.7,53405.0,11150,11200,68360,2,50,2015
314108,4.9,5993.0,146000,152000,59100,1,6000,2015
177298,4.0,16412.0,16700,14400,83200,1,-2300,2015
424438,4.1,23231.0,20700,20200,61450,2,-500,2015
337452,3.4,37660.0,14600,15500,82750,2,900,2015
113374,2.5,36709.0,11450,12000,68360,3,550,2015
208115,3.9,36157.0,29200,27300,57290,1,-1900,2015
368689,4.2,90000.0,14200,14800,64520,6,600,2015
321122,2.4,77790.0,10750,11600,82750,3,850,2015
278664,4.9,12632.0,14950,14200,59100,2,-750,2015
542360,3.8,65768.0,11650,12200,81400,2,550,2015
76663,3.5,20279.0,20500,20500,68360,1,0,2015
2353,2.9,31000.0,36400,36000,77030,3,-400,2014
196259,1.9,117920.0,3150,3700,67090,11,550,2015
193476,3.4,87442.0,8675,8800,67090,5,125,2015
323289,3.5,57965.0,16500,14900,82750,4,-1600,2015
326542,3.3,127011.0,3375,4400,82750,12,1025,2015
138145,4.0,20144.0,19400,19200,73100,1,-200,2015
335605,3.2,22045.0,21800,20400,82750,2,-1400,2015
375272,4.2,86967.0,8200,9800,64520,4,1600,2015
377267,3.2,111317.0,5450,5800,64520,7,350,2015
245322,4.5,68406.0,31400,30500,59100,5,-900,2015
342388,4.4,32094.0,30900,29500,82750,3,-1400,2015
153461,4.7,95694.0,21900,21800,73100,7,-100,2015
443555,3.8,87666.0,11600,11700,74430,3,100,2015
418477,1.0,99308.0,1350,1300,61450,14,-50,2015
378912,2.4,97930.0,7625,5600,64520,9,-2025,2015
298339,2.1,160695.0,4050,3700,59100,10,-350,2015
80067,1.9,123367.0,13600,9600,68360,7,-4000,2015
64858,1.9,101804.0,6525,6000,77030,4,-525,2015
148011,4.8,14573.0,18800,19300,73100,1,500,2015
442357,4.0,29173.0,18500,17800,74430,1,-700,2015
369847,3.6,89563.0,8775,9400,64520,5,625,2015
409463,3.4,55966.0,10950,10800,61450,2,-150,2015
212560,3.6,7876.0,23000,21200,57290,1,-1800,2015
491647,4.0,16486.0,12400,12100,73130,1,-300,2015
161776,3.6,35161.0,10000,10200,73100,3,200,2015
14907,3.3,78575.0,9325,9700,77030,5,375,2015
337259,3.0,24786.0,11900,11000,82750,1,-900,2015
327303,4.1,18586.0,22400,21500,82750,2,-900,2015
67575,3.7,34385.0,12300,13000,77030,5,700,2015
473392,4.5,46424.0,10750,10500,62930,2,-250,2015
445471,2.7,70499.0,10050,9600,56120,5,-450,2015
56415,3.7,58653.0,13950,15250,77030,8,1300,2015
105304,3.7,86870.0,9575,9400,68360,2,-175,2015
338916,2.0,133658.0,1400,1050,82750,11,-350,2015
410489,3.7,42423.0,13150,12400,61450,5,-750,2015
410429,3.7,22776.0,19700,18800,61450,3,-900,2015
391162,2.7,71666.0,17000,14400,65610,3,-2600,2015
466989,4.5,13544.0,13150,13100,61490,1,-50,2015
524220,,120658.0,5475,5100,70210,7,-375,2014
431363,1.9,91082.0,5225,4400,61450,7,-825,2015
87533,3.6,68176.0,6450,7200,68360,7,750,2015
510043,4.2,63937.0,8925,9700,71660,4,775,2015
250919,2.6,78984.0,2825,2600,59100,10,-225,2015
221088,2.6,34436.0,22000,21600,57290,1,-400,2015
209515,3.6,43129.0,12800,13200,57290,2,400,2015
442657,2.6,70122.0,7125,6700,74430,8,-425,2015
275771,4.4,28452.0,16400,18100,59100,4,1700,2015
270281,2.7,28494.0,17150,16600,59100,4,-550,2015
190593,3.1,110558.0,6675,7600,63250,8,925,2015
472027,3.9,96624.0,7525,8500,62930,3,975,2015
26103,2.9,63259.0,9850,9500,77030,8,-350,2015
132793,2.3,38519.0,18700,15500,73100,4,-3200,2015
259069,2.8,58156.0,13000,11700,59100,4,-1300,2015
46784,3.7,46960.0,11150,12400,77030,2,1250,2015
205718,4.0,25036.0,25900,27000,57290,2,1100,2015
30140,2.9,97996.0,5700,4500,77030,6,-1200,2015
139770,3.6,110004.0,3075,4100,73100,11,1025,2015
446401,2.4,127178.0,1550,2800,56120,12,1250,2015
117799,4.7,90671.0,13400,14200,68360,2,800,2015
98880,1.9,76349.0,8025,5300,68360,3,-2725,2015
474723,3.7,51519.0,12300,11900,62930,2,-400,2015
382056,4.1,35865.0,20900,20400,65610,3,-500,2015
370408,4.5,29172.0,18150,19400,64520,3,1250,2015
322094,2.9,110562.0,3125,3000,82750,13,-125,2014
207309,4.6,114359.0,15800,17300,57290,8,1500,2015
246072,3.3,144653.0,1000,1500,59100,16,500,2015
364249,4.2,74288.0,8400,6200,64520,3,-2200,2015
519399,1.0,192658.0,800,700,71660,20,-100,2015
511898,3.9,114919.0,4600,5200,71660,6,600,2015
215335,4.8,19969.0,16700,17400,57290,2,700,2015
399233,3.4,16543.0,23700,22600,61450,1,-1100,2015
347216,2.8,114561.0,11750,9100,82750,9,-2650,2015
466840,2.5,132143.0,2025,2900,61490,10,875,2015
127460,3.7,11211.0,15100,14600,73100,2,-500,2015
460300,2.0,168557.0,4225,4000,61490,9,-225,2015
498325,3.0,68798.0,9450,10000,80610,4,550,2014
93060,2.1,25638.0,11600,11900,68360,2,300,2015
355184,2.0,220611.0,3250,2300,62960,14,-950,2015
433945,2.4,67305.0,7825,6100,74430,3,-1725,2014
135601,3.5,62808.0,6825,7000,73100,10,175,2015
298754,3.6,52565.0,12950,12000,59100,5,-950,2015
297763,2.7,51214.0,14000,13500,59100,3,-500,2015
522732,2.5,221166.0,2825,3200,71660,8,375,2015
147207,2.8,115901.0,9325,8400,73100,6,-925,2015
174847,4.0,19445.0,24300,23100,83200,1,-1200,2015
319032,3.5,32346.0,8350,9800,73200,3,1450,2015
498916,2.7,73104.0,11300,12100,80610,2,800,2014
344219,4.1,44041.0,11300,10700,82750,3,-600,2015
196099,3.5,26438.0,23800,23600,67090,3,-200,2015
526139,4.2,52420.0,22500,23000,70210,3,500,2015
416993,2.7,76394.0,4875,6600,61450,10,1725,2015
271968,4.6,26461.0,26500,26000,59100,2,-500,2015
203622,1.9,32350.0,19050,15200,57290,3,-3850,2015
382486,,104447.0,8975,8700,65610,6,-275,2014
74907,,196709.0,1375,1200,68360,12,-175,2014
203726,2.0,186488.0,1200,400,57290,9,-800,2015
267323,4.8,20894.0,32800,32800,59100,2,0,2015
456763,4.2,17534.0,16400,15900,61490,1,-500,2015
23239,2.4,57311.0,9325,10100,77030,2,775,2015
437139,3.3,104160.0,8925,9600,74430,6,675,2015
542217,4.2,129708.0,6700,7000,81400,7,300,2015
386972,3.7,25600.0,24200,21000,65610,3,-3200,2015
298053,4.3,32198.0,17550,17400,59100,1,-150,2015
112887,3.9,35174.0,14100,13600,68360,3,-500,2015
431008,3.3,34147.0,15200,12700,61450,2,-2500,2015
61386,2.6,71973.0,32000,31750,77030,6,-250,2015
460496,3.5,57120.0,13200,12800,61490,3,-400,2015
395854,3.9,87851.0,11800,12000,65610,6,200,2015
220888,1.9,114673.0,2325,550,57290,10,-1775,2015
385555,4.9,41306.0,15850,15600,65610,5,-250,2015
539570,3.7,167997.0,2025,1300,55590,8,-725,2015
274573,1.9,168441.0,850,700,59100,11,-150,2015
197854,1.9,90967.0,6275,4300,67090,4,-1975,2015
184226,3.6,69855.0,9350,10000,63250,3,650,2015
28275,3.0,16293.0,18800,20300,77030,1,1500,2015
14389,3.0,93854.0,5675,8000,77030,9,2325,2015
363390,4.6,11148.0,12900,12700,64520,1,-200,2015
100964,4.0,18315.0,19700,18800,68360,1,-900,2015
192066,2.1,222078.0,975,800,67090,13,-175,2014
37904,2.3,84028.0,40300,42000,77030,15,1700,2015
310584,3.7,75771.0,13200,13700,59100,5,500,2015
221048,3.7,34131.0,31000,30800,57290,1,-200,2015
387496,3.6,114753.0,5100,5200,65610,10,100,2015
432713,1.9,84649.0,13400,11200,74430,6,-2200,2014
406211,4.2,12809.0,15800,16500,61450,2,700,2015
257496,4.3,31842.0,10500,10500,59100,1,0,2015
523342,4.2,21695.0,18450,18200,71660,0,-250,2015
182883,2.7,192428.0,4850,4100,63250,8,-750,2014
99437,4.3,26150.0,11700,12800,68360,2,1100,2015
180693,3.1,39808.0,24500,24500,83200,1,0,2015
389521,2.6,99081.0,9675,8000,65610,5,-1675,2015
81444,4.8,16972.0,22700,23000,68360,1,300,2015
511724,3.7,54028.0,9275,9900,71660,7,625,2015
199409,2.0,58728.0,18950,18000,67090,3,-950,2015
364563,2.6,22047.0,22100,21500,64520,3,-600,2015
364907,4.3,28606.0,14800,14800,64520,1,0,2015
311951,4.9,64446.0,35900,37800,59100,2,1900,2015
24977,3.9,51269.0,13400,14500,77030,4,1100,2015
407909,3.7,35728.0,16600,16700,61450,1,100,2015
168599,4.1,24612.0,21500,21500,73100,3,0,2015
527394,4.2,36194.0,23800,21300,70210,2,-2500,2015
143205,1.9,209961.0,4200,3200,73100,5,-1000,2015
250992,5.0,13231.0,14650,14200,59100,1,-450,2015
199259,2.8,96808.0,7250,8000,67090,4,750,2015
380464,4.4,7612.0,12400,13000,64520,2,600,2015
514289,3.6,34570.0,18350,18000,71660,1,-350,2015
485683,4.3,22741.0,10600,9400,73130,1,-1200,2015
49622,3.9,126695.0,15400,17600,77030,4,2200,2015
141327,1.9,121724.0,1425,700,73100,12,-725,2015
93880,4.4,29961.0,22000,22500,68360,2,500,2015
73725,,107296.0,12750,12200,68360,6,-550,2014
234560,,142304.0,7575,7900,59100,8,325,2014
103303,4.4,68878.0,7750,9600,68360,3,1850,2015
17553,4.3,19232.0,17050,15600,77030,2,-1450,2015
155571,4.0,7178.0,22000,21000,73100,0,-1000,2015
196024,4.4,4233.0,39500,39000,67090,1,-500,2015
307280,1.7,192316.0,1225,700,59100,14,-525,2015
534350,3.4,25555.0,16550,14100,82150,1,-2450,2015
206730,3.4,49546.0,12650,12700,57290,2,50,2015
200668,3.9,100178.0,27200,27000,67090,3,-200,2015
263166,3.6,64853.0,10500,10100,59100,3,-400,2015
533965,3.7,53287.0,10950,11500,82150,3,550,2015
471997,1.0,160353.0,1525,525,62930,13,-1000,2015
389924,4.2,26164.0,10650,11300,65610,3,650,2015
307749,3.4,115946.0,8675,7600,59100,7,-1075,2015
86974,1.9,131604.0,2575,2100,68360,10,-475,2015
394957,3.6,40597.0,26300,26200,65610,2,-100,2015
243146,4.5,12009.0,15850,15900,59100,1,50,2015
84215,2.8,69543.0,5675,7100,68360,7,1425,2015
189494,1.9,89987.0,1375,1450,63250,11,75,2015
466531,3.6,115490.0,3500,7300,61490,10,3800,2015
438785,2.6,92387.0,3425,1500,74430,12,-1925,2015
260363,3.6,59974.0,6275,6500,59100,4,225,2015
501973,2.7,71567.0,9825,9700,80610,3,-125,2015
549595,4.9,21382.0,19350,20000,48460,0,650,2015
260721,2.1,141173.0,15100,11500,59100,12,-3600,2015
184468,4.2,10330.0,22900,20500,63250,1,-2400,2015
277394,4.4,127172.0,5600,7800,59100,7,2200,2015
16568,2.3,35325.0,12050,12500,77030,3,450,2015
268047,2.3,105191.0,5375,4300,59100,9,-1075,2015
35140,4.2,29550.0,27800,26300,77030,2,-1500,2015
165809,4.5,86711.0,13300,12800,73100,4,-500,2015
106412,4.3,24248.0,12450,12900,68360,3,450,2015
434300,4.0,19815.0,15100,16000,74430,0,900,2015
108627,1.9,60130.0,27000,16000,68360,4,-11000,2015
209501,3.0,146675.0,19000,10600,57290,1,-8400,2015
324698,4.7,6933.0,32000,36200,82750,2,4200,2015
204553,2.9,40981.0,11200,10400,57290,2,-800,2015
432437,3.7,78921.0,23700,23000,74430,3,-700,2014
477864,2.7,88304.0,17650,19000,73130,7,1350,2015
28461,3.9,41712.0,13000,13600,77030,2,600,2015
417163,3.7,149403.0,4975,5800,61450,8,825,2015
355632,2.6,165747.0,1825,1800,62960,16,-25,2015
235884,,135084.0,600,400,59100,14,-200,2014
492170,4.0,22677.0,16200,16100,73130,1,-100,2015
461869,4.3,124764.0,4875,7800,61490,9,2925,2015
481657,3.6,69818.0,14300,15000,73130,2,700,2015
409873,4.2,76230.0,20200,22400,61450,4,2200,2015
166579,3.7,32888.0,24400,26000,73100,2,1600,2015
357634,4.3,49279.0,15300,14800,62960,1,-500,2015
536062,3.4,51427.0,14450,14700,82150,2,250,2015
438878,4.0,17089.0,18050,17200,74430,1,-850,2015
409286,4.9,6764.0,14700,15000,61450,1,300,2015
528386,2.5,23122.0,16750,15600,70210,3,-1150,2015
335464,3.6,14301.0,12550,12100,82750,2,-450,2015
437364,3.2,155143.0,3000,3200,74430,9,200,2015
19136,2.1,16247.0,21200,19000,77030,4,-2200,2015
320102,3.7,36439.0,16000,16100,82750,3,100,2014
210327,4.2,37806.0,22700,22300,57290,1,-400,2015
142285,3.6,97471.0,8725,7600,73100,9,-1125,2015
90975,2.6,68730.0,10050,10300,68360,5,250,2015
501935,4.7,32276.0,16050,17600,80610,1,1550,2015
109503,3.6,31629.0,17850,17800,68360,3,-50,2015
40151,3.2,83868.0,9500,10600,77030,5,1100,2015
440248,2.5,196337.0,1725,1700,74430,14,-25,2015
549916,1.9,54027.0,6100,4900,48460,6,-1200,2015
227274,3.6,86111.0,6850,5500,89090,11,-1350,2015
418230,2.1,39345.0,12000,9800,61450,3,-2200,2015
154837,2.6,26908.0,23600,19800,73100,3,-3800,2015
223464,3.8,36679.0,9200,8100,89090,4,-1100,2015
307387,4.8,76211.0,10200,10400,59100,3,200,2015
403983,4.9,14820.0,16700,16800,61450,2,100,2015
403737,3.7,35663.0,12850,12500,61450,3,-350,2015
346961,2.7,34263.0,15750,14800,82750,3,-950,2015
411402,2.9,24386.0,22100,21250,61450,3,-850,2015
3622,4.5,33980.0,17650,22000,77030,7,4350,2014
245341,2.4,101490.0,9000,9000,59100,5,0,2015
43642,4.1,101242.0,11250,12750,77030,7,1500,2015
441950,3.8,93048.0,7800,9500,74430,10,1700,2015
111329,2.3,80196.0,11800,9800,68360,7,-2000,2015
64746,2.1,43618.0,22400,17750,77030,4,-4650,2015
453617,1.9,115168.0,6325,5600,61490,6,-725,2015
146871,4.5,45452.0,18700,17600,73100,1,-1100,2015
446153,2.9,165684.0,6925,5800,56120,8,-1125,2015
359902,4.6,28976.0,15800,16500,62960,1,700,2015
137155,4.9,11946.0,18050,18750,73100,1,700,2015
289038,2.0,137209.0,3000,2600,59100,10,-400,2015
338810,3.1,72217.0,12950,11800,82750,6,-1150,2015
321614,2.0,109217.0,2000,450,82750,13,-1550,2015
160832,3.7,44405.0,23000,23100,73100,3,100,2015
44091,2.0,30370.0,21600,18500,77030,3,-3100,2015
444184,3.6,36424.0,10600,11100,74430,2,500,2015
46440,3.8,27193.0,16350,20000,77030,1,3650,2015
438323,3.1,114923.0,5800,6400,74430,8,600,2015
544630,4.6,36744.0,18000,18900,81400,1,900,2015
434892,2.0,141301.0,825,800,74430,19,-25,2015
301333,3.9,31516.0,11750,12600,59100,3,850,2015
107360,4.8,45255.0,7550,9000,68360,3,1450,2015
373035,4.2,41958.0,20400,20500,64520,3,100,2015
19916,4.2,59715.0,9600,9600,77030,2,0,2015
91334,2.4,160183.0,3125,2800,68360,8,-325,2015
159028,2.8,40009.0,8150,7700,73100,3,-450,2015
148729,4.9,8559.0,47000,48000,73100,1,1000,2015
544781,4.2,63247.0,14800,16200,81400,2,1400,2015
90361,4.4,20729.0,25700,25900,68360,1,200,2015
81211,2.0,90638.0,6450,2300,68360,11,-4150,2015
36257,3.6,19024.0,17400,19700,77030,2,2300,2015
89353,3.7,52384.0,11400,10500,68360,4,-900,2015
286869,1.9,266617.0,625,1100,59100,18,475,2015
507580,3.5,47134.0,12700,12700,80200,3,0,2015
213954,4.8,20939.0,15750,20600,57290,1,4850,2015
391341,4.4,21085.0,11900,12000,65610,2,100,2015
53967,4.2,17100.0,19450,20750,77030,3,1300,2015
204550,4.2,34885.0,11500,11500,57290,2,0,2015
455564,1.9,83623.0,5925,4200,61490,10,-1725,2015
272052,4.5,5055.0,23800,23000,59100,2,-800,2015
194257,2.7,113032.0,8925,8500,67090,2,-425,2015
367420,3.4,25391.0,15250,15300,64520,4,50,2015
191622,3.4,35930.0,14700,13700,67090,2,-1000,2014
453430,1.9,71672.0,7025,5500,61490,8,-1525,2015
65409,4.8,19806.0,30500,25500,77030,2,-5000,2015
347799,1.9,60166.0,22500,20000,62960,3,-2500,2014
318794,3.7,29613.0,17200,18200,73200,3,1000,2015
18018,3.3,130061.0,6500,6800,77030,5,300,2015
77735,1.9,142264.0,1475,800,68360,10,-675,2015
339278,4.8,6837.0,34200,34750,82750,0,550,2015
242864,2.8,58924.0,9375,9500,59100,6,125,2015
74560,1.9,133866.0,2725,2200,68360,10,-525,2015
304112,4.4,32370.0,24300,25200,59100,1,900,2015
486932,4.0,12119.0,15400,15200,73130,1,-200,2015
183663,3.3,88141.0,5100,5400,63250,7,300,2015
534096,3.4,119488.0,10850,11100,82150,5,250,2015
80915,1.9,160877.0,3250,2100,68360,8,-1150,2015
395997,4.8,37170.0,14500,14800,65610,4,300,2015
434448,1.0,130028.0,2600,1700,74430,13,-900,2015
159315,3.6,56464.0,21200,22600,73100,5,1400,2015
245502,2.5,77215.0,6975,6500,59100,7,-475,2015
124749,4.3,12161.0,17850,18000,73100,2,150,2015
72729,2.9,77916.0,4925,4500,77030,9,-425,2015
192848,2.0,155794.0,1500,650,67090,8,-850,2015
450614,2.7,207553.0,4150,4500,61490,13,350,2015
430305,3.1,96484.0,7700,7700,61450,4,0,2015
34488,4.1,13980.0,16050,17200,77030,11,1150,2015
52544,4.8,6512.0,18250,16250,77030,1,-2000,2015
405632,3.9,20326.0,32800,32200,61450,2,-600,2015
64721,5.0,41567.0,12850,14500,77030,2,1650,2015
349604,2.4,110285.0,6775,7800,62960,6,1025,2014
179456,2.8,44046.0,13750,13700,83200,9,-50,2015
437531,3.6,29070.0,21300,22500,74430,1,1200,2015
282973,1.9,140682.0,3575,2800,59100,12,-775,2015
533295,2.9,80928.0,5300,4500,82150,7,-800,2015
375018,3.2,51708.0,17400,17000,64520,2,-400,2015
15804,1.0,338721.0,375,700,77030,18,325,2015
548128,4.6,33041.0,10500,9250,78090,3,-1250,2015
576,2.4,46283.0,15800,10600,77030,1,-5200,2014
25823,2.5,137985.0,4450,6100,77030,12,1650,2015
33593,2.7,96776.0,14400,12650,77030,4,-1750,2015
81602,4.3,65497.0,22500,23500,68360,4,1000,2015
77436,3.7,50855.0,12450,13000,68360,1,550,2014
429990,4.7,45932.0,12550,13000,61450,2,450,2015
404305,3.4,75853.0,5425,5800,61450,6,375,2015
197756,1.0,122173.0,5125,3200,67090,5,-1925,2015
28267,1.9,119491.0,5950,5600,77030,11,-350,2015
90919,1.9,69180.0,11550,11400,68360,5,-150,2015
169451,3.3,98010.0,9400,8900,73100,7,-500,2015
353041,4.3,20005.0,15900,16300,62960,2,400,2015
36403,1.9,63485.0,13150,11700,77030,9,-1450,2015
71452,4.6,22177.0,20700,21500,77030,2,800,2015
433992,3.4,168639.0,2975,3700,74430,10,725,2014
531649,2.4,84333.0,6425,6200,82150,9,-225,2015
109415,4.3,72125.0,8725,8700,68360,3,-25,2015
87306,2.6,96981.0,5250,6000,68360,9,750,2015
189926,4.6,15572.0,15500,14500,63250,1,-1000,2015
129514,3.0,29335.0,12400,10800,73100,3,-1600,2015
222478,1.9,161412.0,5300,4400,89090,10,-900,2014
330149,3.5,32996.0,13500,16600,82750,2,3100,2015
352218,4.6,23598.0,15050,15600,62960,1,550,2015
69140,1.9,59390.0,9100,8900,77030,2,-200,2015
500674,4.3,70424.0,13700,15200,80610,3,1500,2015
485507,3.8,50134.0,12450,12400,73130,3,-50,2015
260428,3.3,65800.0,17200,17600,59100,6,400,2015
377109,1.9,166791.0,150,350,64520,12,200,2015
257286,2.0,141434.0,2575,3300,59100,16,725,2015
497035,2.0,23264.0,20500,18600,73130,3,-1900,2015
228483,2.4,59326.0,8225,7200,89090,3,-1025,2015
301938,4.7,24025.0,28100,29800,59100,1,1700,2015
432942,2.4,93628.0,6225,5100,74430,8,-1125,2014
466255,3.3,72023.0,14600,15500,61490,4,900,2015
271507,3.7,64772.0,8000,8100,59100,3,100,2015
492686,3.7,44489.0,11900,11550,73130,2,-350,2015
450642,1.9,74718.0,3350,2400,61490,15,-950,2014
447411,5.0,37804.0,16950,18000,56120,2,1050,2015
128850,4.4,117777.0,7475,8000,73100,10,525,2015
350624,1.9,99727.0,625,1450,62960,18,825,2015
404940,3.5,53851.0,13600,16100,61450,5,2500,2015
441961,2.8,117046.0,2600,2800,74430,10,200,2015
519604,1.9,129576.0,4925,5400,71660,3,475,2015
218793,4.2,36265.0,11500,14200,57290,3,2700,2015
310182,4.5,34470.0,26800,29200,59100,3,2400,2015
425328,4.3,53582.0,7475,7400,61450,2,-75,2015
186858,1.0,101720.0,7700,3900,63250,10,-3800,2015
160755,3.5,24133.0,11200,10400,73100,2,-800,2015
232138,3.6,34349.0,15750,13200,89090,1,-2550,2015
279026,4.0,97240.0,12950,12600,59100,7,-350,2015
210253,1.0,237159.0,650,400,57290,19,-250,2015
103603,1.9,89558.0,8475,8900,68360,7,425,2015
242888,4.0,50272.0,22400,25500,59100,7,3100,2015
397546,2.5,104878.0,5775,4450,65610,10,-1325,2015
51261,2.0,110387.0,5700,7100,77030,9,1400,2015
233353,4.1,24104.0,24400,22000,59100,3,-2400,2014
535613,2.8,190272.0,675,600,82150,11,-75,2015
527847,4.8,26738.0,21300,21800,70210,2,500,2015
103942,4.2,35496.0,24000,23600,68360,3,-400,2015
467030,3.0,129902.0,4500,3600,61490,7,-900,2015
421319,1.9,279068.0,2325,3100,61450,12,775,2015
175376,4.1,60931.0,24000,24500,83200,2,500,2015
263714,2.8,19750.0,18150,19900,59100,3,1750,2015
205986,4.3,38558.0,16450,16400,57290,1,-50,2015
40091,3.7,26032.0,21100,19250,77030,4,-1850,2015
294663,2.9,28643.0,13300,12400,59100,3,-900,2015
395450,3.2,53534.0,8925,8700,65610,2,-225,2015
242702,2.4,75888.0,18700,13950,59100,4,-4750,2015
173445,,223138.0,1175,1250,83200,9,75,2014
53684,2.0,25965.0,15200,12900,77030,1,-2300,2015
538803,3.5,197838.0,1600,3800,55590,9,2200,2015
346645,2.9,28054.0,22600,22400,82750,2,-200,2015
124180,2.3,151014.0,4775,4550,73100,9,-225,2015
463828,4.4,67536.0,12600,14600,61490,2,2000,2015
381507,2.9,71312.0,11950,14200,64520,10,2250,2015
158253,4.6,21640.0,17700,17800,73100,3,100,2015
23227,4.0,10366.0,11600,12100,77030,1,500,2015
200175,2.4,68360.0,10050,7800,67090,11,-2250,2015
385596,2.5,151675.0,2875,2600,65610,7,-275,2015
186008,3.5,49110.0,9100,9900,63250,3,800,2015
178982,3.7,78227.0,8250,9000,83200,4,750,2015
59506,1.9,61052.0,8350,7800,77030,3,-550,2015
283859,4.9,2930.0,22900,25200,59100,1,2300,2015
533821,2.7,130419.0,1850,2500,82150,16,650,2015
418886,2.0,28547.0,18150,12200,61450,2,-5950,2015
356018,4.8,24555.0,24600,25800,62960,1,1200,2015
84433,4.3,5952.0,11650,12100,68360,1,450,2015
386855,4.9,134104.0,4175,6000,65610,8,1825,2015
267786,4.2,11586.0,53500,51500,59100,0,-2000,2015
6399,2.9,25765.0,28500,18750,77030,2,-9750,2015
239531,4.1,17348.0,25500,25200,59100,1,-300,2014
518904,3.9,124174.0,4850,7100,71660,8,2250,2015
490268,3.6,43214.0,12150,12300,73130,2,150,2015
235803,,177607.0,850,500,59100,14,-350,2014
112235,2.2,173359.0,2025,2100,68360,8,75,2015
502841,3.9,55574.0,8875,9700,80610,3,825,2015
293822,3.5,42375.0,16450,16300,59100,2,-150,2015
319459,4.3,105131.0,9225,9500,73200,8,275,2015
548174,4.4,10576.0,10800,10250,78090,2,-550,2015
29203,5.0,3917.0,22000,22000,77030,1,0,2015
351572,4.4,18893.0,32700,34500,62960,2,1800,2015
301189,4.6,20442.0,17550,18000,59100,3,450,2015
200384,2.9,67058.0,7950,7000,67090,3,-950,2015
371375,5.0,2959.0,31200,31000,64520,1,-200,2015
451768,3.6,22133.0,16100,15400,61490,1,-700,2015
137378,2.8,57545.0,9600,8800,73100,3,-800,2015
32401,1.9,209150.0,11350,12400,77030,12,1050,2015
171641,3.8,42651.0,26000,24400,73100,4,-1600,2015
268083,2.1,164160.0,8250,7700,59100,10,-550,2015
199083,3.7,7127.0,19950,19800,67090,1,-150,2015
498535,4.8,14587.0,27300,29300,80610,1,2000,2014
23280,4.0,36820.0,45200,43750,77030,3,-1450,2015
518860,4.2,33601.0,12400,13000,71660,3,600,2015
152132,4.8,14268.0,25900,26000,73100,3,100,2015
46625,2.0,154699.0,1025,1300,77030,20,275,2015
331566,3.9,24764.0,17000,18300,82750,2,1300,2015
522397,4.4,33963.0,11400,12000,71660,1,600,2015
114547,4.7,16560.0,24100,23500,68360,3,-600,2015
464102,3.1,98745.0,7975,7800,61490,9,-175,2015
215709,3.4,110238.0,14600,15300,57290,7,700,2015
240308,4.6,14368.0,13400,12600,59100,0,-800,2014
522056,4.4,20734.0,45800,47100,71660,0,1300,2015
424786,3.7,35962.0,18650,18800,61450,3,150,2015
34658,4.9,20430.0,42400,41250,77030,0,-1150,2015
420910,3.4,25586.0,11500,11200,61450,3,-300,2015
35983,2.9,55014.0,9825,9400,77030,2,-425,2015
292843,4.4,62179.0,12750,13600,59100,3,850,2015
428464,1.9,258203.0,325,550,61450,16,225,2015
8202,2.8,51972.0,4075,7200,77030,9,3125,2014
220474,1.9,88789.0,10050,7200,57290,3,-2850,2015
415871,2.6,176025.0,3500,3500,61450,8,0,2015
175346,2.4,86750.0,4700,5000,83200,9,300,2015
413294,2.0,14906.0,29800,20200,61450,1,-9600,2015
336484,3.7,20482.0,18500,17400,82750,3,-1100,2015
251215,4.2,30094.0,13750,14000,59100,3,250,2015
263927,3.5,40446.0,19350,18800,59100,4,-550,2015
296066,4.1,29074.0,25100,22700,59100,3,-2400,2015
1775,3.8,17332.0,21900,22250,77030,3,350,2014
366543,3.1,28362.0,16200,15400,64520,2,-800,2015
451629,2.4,75355.0,7875,6600,61490,5,-1275,2015
441424,1.9,159100.0,2575,3050,74430,10,475,2015
206252,3.9,57631.0,20900,20900,57290,3,0,2015
143335,3.8,52785.0,16900,16300,73100,2,-600,2015
75607,3.9,49276.0,19800,19800,68360,2,0,2014
496902,2.6,56631.0,10300,10100,73130,4,-200,2015
216183,4.7,33815.0,17850,19800,57290,1,1950,2015
499263,3.6,37764.0,14200,14200,80610,1,0,2015
283687,4.9,27480.0,23800,24400,59100,1,600,2015
105334,4.3,38623.0,21000,20800,68360,3,-200,2015
362632,4.6,5733.0,40100,37500,64520,0,-2600,2014
383047,3.9,36187.0,10900,10300,65610,1,-600,2014
215284,4.3,38073.0,17050,17900,57290,1,850,2015
251671,2.8,41914.0,15900,15800,59100,7,-100,2015
206874,3.2,87514.0,16600,17500,57290,5,900,2015
457716,3.3,37016.0,13150,12800,61490,2,-350,2015
180947,3.6,31338.0,14450,15100,83200,3,650,2015
272025,4.1,14330.0,13200,13100,59100,2,-100,2015
133486,3.4,114131.0,5025,5700,73100,11,675,2015
337928,2.7,33506.0,15950,14200,82750,3,-1750,2015
520582,3.7,50015.0,17700,18300,71660,3,600,2015
109926,2.0,119232.0,4875,4600,68360,11,-275,2015
432498,3.4,99464.0,4900,5000,74430,4,100,2014
316759,2.0,49571.0,12800,7000,73200,2,-5800,2015
466964,1.9,150127.0,4650,4200,61490,9,-450,2015
194410,2.0,44891.0,11300,8600,67090,2,-2700,2015
340286,3.9,7055.0,19950,20500,82750,1,550,2015
221143,4.3,34790.0,10050,10700,57290,2,650,2015
478935,4.7,15625.0,29800,30700,73130,1,900,2015
328727,1.9,100820.0,3100,2100,82750,8,-1000,2015
61189,1.0,12199.0,15500,8300,77030,0,-7200,2015
332958,4.3,35439.0,19400,21200,82750,4,1800,2015
225327,2.0,161025.0,1125,300,89090,14,-825,2015
110966,3.5,82774.0,6350,5000,68360,3,-1350,2015
432038,1.9,54081.0,7750,6200,61450,3,-1550,2015
494325,5.0,34268.0,22900,24000,73130,1,1100,2015
202357,2.7,113554.0,5750,5900,57290,12,150,2014
22127,2.2,59164.0,18800,18000,77030,5,-800,2015
367830,4.2,4706.0,41800,45750,64520,1,3950,2015
142730,3.8,88483.0,15450,14100,73100,5,-1350,2015
502293,4.9,26048.0,15150,16900,80610,2,1750,2015
302966,4.2,13162.0,13550,13400,59100,1,-150,2015
480866,2.1,73963.0,7900,5800,73130,4,-2100,2015
305511,2.8,102518.0,4000,3000,59100,9,-1000,2015
58199,3.7,37655.0,12350,12600,77030,2,250,2015
268079,2.9,33392.0,50500,47400,59100,10,-3100,2015
44034,2.8,157332.0,2125,2700,77030,13,575,2015
144867,5.0,3169.0,21200,21000,73100,2,-200,2015
512620,3.8,45328.0,11100,10900,71660,2,-200,2015
438038,2.8,36703.0,12450,11000,74430,4,-1450,2015
239510,4.3,28693.0,17550,22500,59100,1,4950,2014
5004,,157765.0,1350,700,77030,13,-650,2014
390929,4.5,92488.0,3275,5100,65610,9,1825,2015
486590,4.0,44958.0,23600,25100,73130,3,1500,2015
518305,3.1,32888.0,11800,11800,71660,1,0,2015
137982,4.0,17716.0,14850,15200,73100,1,350,2015
95675,1.9,50585.0,13850,7800,68360,2,-6050,2015
150379,3.4,49222.0,11400,10200,73100,3,-1200,2015
349560,2.0,160840.0,1050,450,62960,19,-600,2015
6499,3.6,32051.0,38600,41250,77030,2,2650,2014
371475,4.3,15878.0,23600,25300,64520,2,1700,2015
512598,4.1,58489.0,12600,12900,71660,2,300,2015
274061,4.3,71658.0,32400,31000,59100,3,-1400,2015
536849,2.0,60278.0,375,250,73640,21,-125,2015
517497,4.2,39570.0,9975,10100,71660,1,125,2015
52633,2.0,29680.0,22300,17800,77030,1,-4500,2015
402638,3.6,99821.0,21500,20800,61450,6,-700,2015
184945,1.0,25456.0,13100,8800,63250,1,-4300,2015
203395,1.0,199781.0,1450,700,57290,12,-750,2015
507812,3.6,72533.0,22100,18000,80200,3,-4100,2015
514486,3.7,35473.0,8800,8700,71660,3,-100,2015
210613,3.8,41658.0,10700,10400,57290,2,-300,2015
103022,4.0,115410.0,3700,3600,68360,8,-100,2015
224447,3.5,150805.0,8025,7600,89090,7,-425,2015
368360,2.0,165055.0,1425,1400,64520,10,-25,2015
277921,2.1,81096.0,7050,7500,59100,8,450,2015
324725,5.0,4460.0,51100,35750,82750,1,-15350,2015
273247,4.9,1726.0,17900,18600,59100,1,700,2015
328188,2.0,95928.0,4500,6200,82750,8,1700,2015
401246,4.5,22055.0,11700,11000,61450,1,-700,2015
309992,3.5,21967.0,19500,18200,59100,3,-1300,2015
343839,3.5,63531.0,11200,12100,82750,2,900,2015
25237,3.9,34305.0,14250,13600,77030,2,-650,2015
410335,4.3,19637.0,11950,11500,61450,2,-450,2015
459186,4.8,31166.0,21300,21800,61490,2,500,2015
151850,2.7,47401.0,26800,25400,73100,4,-1400,2015
190455,4.9,10541.0,18250,17900,63250,0,-350,2015
332601,2.8,46439.0,10500,9500,82750,3,-1000,2015
241957,1.9,136644.0,1075,450,59100,10,-625,2014
533178,1.9,320693.0,225,300,82150,17,75,2015
358615,3.3,63192.0,11250,11000,62960,2,-250,2015
331953,4.5,14784.0,14250,10250,82750,3,-4000,2015
259996,2.9,101748.0,6275,6100,59100,7,-175,2015
314878,4.6,29709.0,13250,13100,59100,2,-150,2015
247247,2.5,134973.0,5325,6100,59100,10,775,2015
168993,2.7,50216.0,9350,9400,73100,4,50,2015
170995,4.9,42087.0,27400,26400,73100,3,-1000,2015
284834,4.8,29499.0,16700,17800,59100,4,1100,2015
492459,4.0,31305.0,21600,22600,73130,3,1000,2015
304109,3.9,35107.0,15850,15800,59100,1,-50,2015
151919,4.4,68102.0,11800,12100,73100,6,300,2015
292711,1.9,160978.0,1750,600,59100,12,-1150,2015
387814,4.9,83667.0,7850,10200,65610,7,2350,2015
467624,3.6,98484.0,6950,8500,61490,6,1550,2015
169938,3.7,32143.0,13150,12500,73100,1,-650,2015
300118,2.1,196469.0,4400,5400,59100,11,1000,2015
501822,3.6,52902.0,10350,10300,80610,2,-50,2015
455348,2.7,154799.0,3300,2900,61490,7,-400,2015
127063,4.0,29799.0,16350,16400,73100,1,50,2015
136575,3.8,123649.0,1575,2350,73100,13,775,2015
276518,3.4,43382.0,9875,9800,59100,4,-75,2015
153892,3.5,35204.0,18600,10600,73100,3,-8000,2015
204038,4.1,45998.0,14800,17100,57290,3,2300,2015
202809,4.3,102375.0,7700,8800,57290,3,1100,2014
59793,3.6,33313.0,12350,12100,77030,2,-250,2015
395785,2.8,174369.0,3375,3200,65610,13,-175,2015
501033,5.0,11260.0,14200,14000,80610,1,-200,2015
36235,5.0,14.0,30900,35500,77030,0,4600,2015
67265,2.5,61087.0,14350,14200,77030,8,-150,2015
368532,2.8,130218.0,975,2150,64520,13,1175,2015
359583,3.7,22733.0,64000,64000,62960,2,0,2015
317796,3.5,82680.0,16400,17000,73200,3,600,2015
106152,4.3,28523.0,11550,11100,68360,1,-450,2015
461125,3.9,133246.0,4700,6000,61490,11,1300,2015
244644,4.8,18414.0,22100,21700,59100,1,-400,2015
88934,3.7,10567.0,17450,18700,68360,2,1250,2015
321201,1.9,46315.0,10050,7400,82750,3,-2650,2015
183862,1.9,162080.0,8050,6100,63250,9,-1950,2015
23345,3.6,101259.0,16650,15750,77030,5,-900,2015
100643,3.9,41317.0,13600,13400,68360,2,-200,2015
187102,4.4,6462.0,18450,18500,63250,1,50,2015
410083,1.9,69627.0,8075,5900,61450,7,-2175,2015
442789,4.2,50917.0,12350,11800,74430,3,-550,2015
21390,3.7,151725.0,3150,3700,77030,11,550,2015
395606,3.4,107162.0,7425,7500,65610,6,75,2015
50532,4.3,59358.0,11400,11300,77030,6,-100,2015
378609,3.1,70160.0,7400,8500,64520,7,1100,2015
542401,4.5,91624.0,17950,19700,81400,5,1750,2015
106962,4.1,35581.0,16750,17300,68360,1,550,2015
260464,2.4,83894.0,6625,6200,59100,7,-425,2015
94474,1.9,118095.0,3000,3200,68360,7,200,2015
526169,2.5,48708.0,11300,9300,70210,4,-2000,2015
46213,1.9,162482.0,7575,6400,77030,8,-1175,2015
62522,2.6,62474.0,7700,8750,77030,5,1050,2015
416414,4.3,5861.0,18500,17800,61450,1,-700,2015
424546,2.7,130070.0,4050,3800,61450,11,-250,2015
381628,4.2,22612.0,26200,25250,64520,1,-950,2015
497892,3.5,69226.0,8350,9200,73130,3,850,2015
311442,4.3,13749.0,11800,11900,59100,1,100,2015
98990,3.5,23599.0,18450,18200,68360,3,-250,2015
98384,3.2,103276.0,5900,5200,68360,8,-700,2015
210714,3.7,49996.0,10800,10700,57290,2,-100,2015
23814,4.1,59344.0,15050,16000,77030,6,950,2015
375439,4.5,89825.0,8775,10000,64520,6,1225,2015
246999,4.4,21777.0,16600,15500,59100,2,-1100,2015
375741,4.4,30594.0,18150,18100,64520,1,-50,2015
410717,2.2,161977.0,7725,7600,61450,13,-125,2015
269706,4.8,3930.0,17300,20700,59100,1,3400,2015
181748,4.0,19382.0,17000,18400,83200,1,1400,2015
401018,2.9,133975.0,6075,6100,61450,9,25,2015
77040,4.6,77466.0,25200,26600,68360,3,1400,2015
94141,2.7,124744.0,3125,2800,68360,10,-325,2015
160953,3.5,33083.0,9200,13500,73100,1,4300,2015
265301,4.4,41718.0,14050,13900,59100,1,-150,2015
528304,3.8,17674.0,16650,17000,70210,1,350,2015
461654,2.0,110139.0,8600,8500,61490,9,-100,2015
32241,2.8,115072.0,6125,6000,77030,9,-125,2015
255359,3.1,42458.0,43300,39800,59100,2,-3500,2015
357467,2.5,43257.0,12750,11300,62960,2,-1450,2015
167413,4.1,39679.0,18400,17000,73100,3,-1400,2015
181993,3.1,25613.0,15950,13600,83200,2,-2350,2015
157575,3.4,21008.0,11000,10700,73100,2,-300,2015
57128,4.0,23143.0,28800,29750,77030,2,950,2015
67151,4.1,30301.0,18950,21500,77030,3,2550,2015
336548,3.3,38793.0,11950,11500,82750,3,-450,2015
110326,3.5,34421.0,21300,21600,68360,1,300,2015
183340,4.1,38671.0,19100,18500,63250,1,-600,2014
102879,4.2,98574.0,10850,10100,68360,4,-750,2015
283640,1.9,168352.0,1450,800,59100,12,-650,2015
153435,3.5,78541.0,11250,12200,73100,4,950,2015
124378,2.9,28191.0,15400,14300,73100,1,-1100,2015
290400,5.0,31603.0,19000,19400,59100,3,400,2015
234380,2.5,164777.0,4100,2600,59100,7,-1500,2014
528990,4.6,41172.0,12750,14200,70210,3,1450,2015
213054,4.4,110254.0,9750,10500,57290,8,750,2015
479663,4.3,35062.0,21800,22600,73130,3,800,2015
291166,1.9,153642.0,3000,2650,59100,14,-350,2015
334939,3.2,26870.0,12600,13300,82750,3,700,2015
306642,4.3,52885.0,12150,14000,59100,3,1850,2015
79909,4.5,10423.0,52100,53500,68360,0,1400,2015
360835,1.0,113573.0,1750,200,64520,10,-1550,2015
492022,4.5,30490.0,18150,18500,73130,2,350,2015
25644,3.7,88299.0,9950,11700,77030,6,1750,2015
459512,3.5,119610.0,2375,2000,61490,14,-375,2015
456174,2.8,97721.0,5775,5800,61490,8,25,2015
185308,1.9,76815.0,4025,3400,63250,8,-625,2015
80278,2.9,94155.0,4475,4300,68360,10,-175,2015
493058,1.9,70179.0,8500,7600,73130,3,-900,2015
257760,2.7,17512.0,13000,11800,59100,3,-1200,2015
149215,4.7,47438.0,27400,28700,73100,4,1300,2015
495791,2.9,49630.0,11300,11100,73130,2,-200,2015
378023,2.6,25995.0,9450,7500,64520,2,-1950,2015
301719,2.2,73878.0,5275,5500,59100,8,225,2015
29323,4.8,24322.0,13100,13900,77030,2,800,2015
296597,4.3,31723.0,31600,34500,59100,2,2900,2015
338979,4.4,21489.0,15300,15200,82750,1,-100,2015
132749,4.4,38727.0,24300,24700,73100,4,400,2015
389888,5.0,15087.0,23600,23200,65610,2,-400,2015
284388,4.2,17111.0,11500,11600,59100,3,100,2015
368667,4.2,48751.0,17550,18250,64520,4,700,2015
113609,4.6,6856.0,24100,25000,68360,1,900,2015
515713,4.0,50549.0,9050,8000,71660,3,-1050,2015
117348,3.6,10770.0,19250,19200,68360,1,-50,2015
384603,5.0,31783.0,23700,25100,65610,3,1400,2015
355084,4.9,12509.0,23900,23700,62960,2,-200,2015
4232,1.9,170875.0,5050,2300,77030,9,-2750,2014
326186,2.6,14571.0,11500,10600,82750,2,-900,2015
371508,2.5,51595.0,11000,11000,64520,3,0,2015
373090,1.9,156334.0,1675,400,64520,10,-1275,2015
523189,4.9,21335.0,34600,35000,71660,2,400,2015
4260,3.5,91539.0,4950,6400,77030,10,1450,2014
499520,2.5,41920.0,12550,12600,80610,2,50,2015
517977,2.9,34718.0,20300,18600,71660,1,-1700,2015
445574,3.7,160877.0,3975,4900,56120,13,925,2015
279190,4.3,54216.0,22700,20800,59100,11,-1900,2015
463977,4.4,121798.0,8450,8300,61490,4,-150,2015
299112,2.3,22141.0,19350,17000,59100,1,-2350,2015
196989,3.5,133800.0,7550,5600,67090,6,-1950,2015
197404,1.0,114714.0,4725,2200,67090,9,-2525,2015
447337,2.8,63058.0,13400,14000,56120,2,600,2015
115778,1.9,128606.0,5000,3900,68360,11,-1100,2015
196811,3.1,64045.0,22800,21900,67090,4,-900,2015
22760,4.8,10887.0,21500,21100,77030,1,-400,2015
238246,3.1,61536.0,3675,4700,59100,7,1025,2014
256620,2.4,115601.0,950,350,59100,15,-600,2015
189201,3.5,53371.0,12350,13200,63250,4,850,2015
344959,4.5,22700.0,11250,11600,82750,2,350,2015
55445,2.0,136826.0,2500,1100,77030,11,-1400,2015
195558,4.4,64025.0,9350,9600,67090,2,250,2015
444976,2.7,188781.0,2200,1500,56120,12,-700,2015
301489,4.2,33397.0,14400,14200,59100,3,-200,2015
419901,2.5,60175.0,11650,11400,61450,2,-250,2015
429364,3.1,45582.0,22300,20100,61450,1,-2200,2015
72089,3.8,44491.0,26700,26750,77030,2,50,2015
141461,3.4,29389.0,16650,16000,73100,3,-650,2015
389370,4.3,51093.0,10400,10400,65610,2,0,2015
522479,3.7,17759.0,17350,17000,71660,12,-350,2015
347165,3.5,58394.0,7200,8300,82750,8,1100,2015
363083,4.3,13608.0,12750,12300,64520,1,-450,2015
185992,4.0,33205.0,13400,14200,63250,1,800,2015
271294,3.9,24784.0,10000,9900,59100,2,-100,2015
30277,3.2,114925.0,6875,6200,77030,9,-675,2015
220968,2.0,40232.0,23500,20800,57290,3,-2700,2015
410482,2.7,67219.0,21900,24800,61450,5,2900,2015
130428,4.4,79216.0,12250,13800,73100,6,1550,2015
500074,4.9,9645.0,12450,12700,80610,2,250,2015
334509,4.2,43916.0,17350,18200,82750,3,850,2015
268453,4.1,37191.0,16450,17400,59100,2,950,2015
176976,3.7,44387.0,32600,31000,83200,2,-1600,2015
75083,,109235.0,625,600,68360,15,-25,2014
410587,4.1,154585.0,6075,7500,61450,8,1425,2015
477893,3.2,36101.0,13750,13600,73130,2,-150,2015
325263,4.0,17663.0,23000,23500,82750,2,500,2015
300837,3.1,61434.0,13450,13200,59100,13,-250,2015
390631,4.6,24996.0,26900,25900,65610,3,-1000,2015
24162,4.5,28193.0,31600,31000,77030,2,-600,2015
71180,5.0,13598.0,19000,20000,77030,1,1000,2015
229436,4.8,61116.0,31200,30700,89090,2,-500,2015
217781,3.4,29441.0,12850,12400,57290,1,-450,2015
194706,2.7,111654.0,6775,7200,67090,8,425,2015
454148,2.9,81456.0,12050,11500,61490,2,-550,2015
372005,4.2,52261.0,25200,24750,64520,3,-450,2015
465698,4.9,91003.0,8600,8900,61490,2,300,2015
324970,4.1,37572.0,11900,11400,82750,3,-500,2015
131060,4.9,24869.0,28100,27750,73100,4,-350,2015
11051,2.6,107580.0,3425,4000,77030,11,575,2014
490050,4.0,12470.0,13650,13400,73130,1,-250,2015
40882,3.9,42041.0,10350,11100,77030,2,750,2015
221431,2.2,94777.0,3925,5000,57290,9,1075,2015
11549,2.8,109781.0,15450,15100,77030,3,-350,2014
332459,3.5,36276.0,19050,19600,82750,3,550,2015
391945,4.1,74086.0,22000,21500,65610,3,-500,2015
508657,2.7,58665.0,8450,8200,71660,6,-250,2014
32572,4.3,5434.0,22000,24250,77030,1,2250,2015
22550,2.1,189097.0,1850,1350,77030,12,-500,2015
243213,4.4,20013.0,19000,19500,59100,2,500,2015
458083,2.4,174158.0,5425,4100,61490,5,-1325,2015
488082,2.9,30100.0,13800,13800,73130,2,0,2015
508009,4.6,2426.0,34500,35200,71660,0,700,2014
453422,1.9,157713.0,6550,5400,61490,6,-1150,2015
504091,1.9,105679.0,9175,9600,80610,8,425,2015
375726,5.0,27325.0,26000,25500,64520,1,-500,2015
550312,4.0,73688.0,10550,11000,54620,7,450,2015
496229,2.5,29136.0,10950,10500,73130,3,-450,2015
19407,3.3,72094.0,19850,21000,77030,9,1150,2015
193119,3.4,28948.0,20200,18000,67090,4,-2200,2015
489466,1.9,97081.0,4225,3600,73130,8,-625,2015
120662,,118418.0,5600,3400,73100,10,-2200,2014
421230,2.0,230834.0,875,1200,61450,21,325,2015
97678,4.6,35753.0,10250,10900,68360,1,650,2015
257109,3.4,109154.0,11500,12900,59100,7,1400,2015
81629,3.5,42393.0,18000,19000,68360,4,1000,2015
134529,1.9,128464.0,925,300,73100,16,-625,2015
420618,3.7,182615.0,12950,15500,61450,9,2550,2015
446813,1.9,148723.0,1675,2100,56120,14,425,2015
419737,2.8,141219.0,10400,10200,61450,8,-200,2015
28887,4.1,51130.0,20400,22400,77030,4,2000,2015
215752,3.4,69469.0,10200,10800,57290,6,600,2015
377074,4.3,11296.0,16950,16900,64520,2,-50,2015
311069,3.5,101661.0,5650,4600,59100,10,-1050,2015
3232,3.4,135515.0,9800,11700,77030,7,1900,2014
460357,4.8,7106.0,14300,14100,61490,1,-200,2015
481991,3.7,44894.0,21400,21000,73130,3,-400,2015
503723,2.6,52276.0,12300,11600,80610,2,-700,2015
78160,3.1,38531.0,7150,6500,68360,3,-650,2014
114962,2.5,77303.0,35800,35000,68360,5,-800,2015
158949,4.4,23494.0,24300,23900,73100,2,-400,2015
127442,3.0,29109.0,17350,15200,73100,2,-2150,2015
543167,4.9,20115.0,11800,12700,81400,2,900,2015
521954,4.3,96208.0,12900,12100,71660,12,-800,2015
115992,1.6,154816.0,2350,1400,68360,6,-950,2015
298061,4.3,11695.0,20000,19000,59100,1,-1000,2015
262188,4.3,20926.0,10850,11600,59100,1,750,2015
506970,3.9,45416.0,11550,12000,80200,2,450,2015
143198,4.3,29965.0,17750,19100,73100,4,1350,2015
180660,2.6,150634.0,6050,7200,83200,8,1150,2015
400098,2.8,13962.0,24400,22250,61450,1,-2150,2014
92143,1.0,49324.0,8875,3900,68360,2,-4975,2015
465159,3.5,146348.0,5100,5500,61490,12,400,2015
346771,4.3,43523.0,19600,19900,82750,3,300,2015
156341,1.9,126839.0,3575,1700,73100,11,-1875,2015
390900,4.9,24866.0,26700,26900,65610,2,200,2015
114013,2.4,121551.0,7825,8400,68360,7,575,2015
274658,2.0,216279.0,1500,2000,59100,17,500,2015
77405,3.6,29889.0,10600,9500,68360,1,-1100,2015
398604,2.8,142848.0,2725,3800,61450,11,1075,2014
477984,4.0,5.0,13300,13700,73130,0,400,2015
3350,2.5,64992.0,16350,15600,77030,7,-750,2014
357333,3.5,66577.0,12600,11900,62960,2,-700,2015
301669,2.2,148378.0,4475,5600,59100,6,1125,2015
245512,3.4,140176.0,3000,3300,59100,7,300,2015
368698,3.2,111492.0,6275,6000,64520,7,-275,2015
473205,4.6,59384.0,10300,10700,62930,3,400,2015
500066,3.4,34243.0,21800,21900,80610,2,100,2015
334924,3.6,21594.0,12900,11900,82750,3,-1000,2015
18469,3.4,83955.0,6450,7100,77030,7,650,2015
373423,2.3,223975.0,1750,1200,64520,16,-550,2015
238788,2.0,161522.0,775,450,59100,13,-325,2015
503663,4.6,33394.0,16700,17300,80610,1,600,2015
108647,4.1,15348.0,16150,17200,68360,6,1050,2015
466908,1.9,241980.0,275,400,61490,18,125,2015
396876,5.0,25690.0,21700,22800,65610,2,1100,2015
37143,3.5,29287.0,11300,13100,77030,10,1800,2015
352998,2.0,120004.0,4075,3150,62960,14,-925,2015
158592,3.5,49974.0,11200,11200,73100,2,0,2015
418566,3.0,92168.0,8575,8100,61450,2,-475,2015
321720,3.9,19759.0,23300,22500,82750,2,-800,2014
249503,3.0,79978.0,7925,8400,59100,10,475,2015
507965,4.3,24170.0,28900,30100,71660,1,1200,2015
301259,3.8,29478.0,40000,43500,59100,3,3500,2015
490182,4.9,11530.0,11800,11900,73130,1,100,2015
527366,2.5,22679.0,3975,5800,70210,11,1825,2015
537777,,26062.0,14400,7600,55590,0,-6800,2014
502199,3.7,41291.0,39500,39500,80610,1,0,2015
257973,5.0,40711.0,13350,13900,59100,4,550,2015
160328,4.0,51802.0,16800,17000,73100,4,200,2015
78960,2.2,79880.0,16650,12100,68360,4,-4550,2015
451643,2.9,113159.0,14400,14300,61490,6,-100,2015
28628,4.1,31173.0,18850,20100,77030,3,1250,2015
137958,3.6,41972.0,14900,13800,73100,3,-1100,2015
487062,5.0,5256.0,32000,31300,73130,1,-700,2015
271936,2.5,97096.0,22500,23600,59100,4,1100,2015
39632,3.9,30394.0,36200,38250,77030,2,2050,2015
14997,2.4,90183.0,17750,18250,77030,6,500,2015
253129,3.7,22873.0,11500,11500,59100,1,0,2015
18304,4.1,22951.0,21400,21000,77030,3,-400,2015
59926,4.1,13282.0,19250,19750,77030,2,500,2015
258343,4.4,41973.0,23600,25800,59100,3,2200,2015
129076,4.7,28354.0,21800,22000,73100,2,200,2015
61120,1.9,122634.0,5725,5900,77030,11,175,2015
458311,2.9,111653.0,4625,5200,61490,8,575,2015
168788,3.5,25981.0,10350,10400,73100,3,50,2015
134931,2.9,84195.0,10800,9600,73100,7,-1200,2015
210368,4.4,14981.0,12550,12100,57290,1,-450,2015
280887,3.1,34073.0,29200,29500,59100,2,300,2015
253863,1.0,103950.0,11250,8600,59100,7,-2650,2015
332425,3.1,33808.0,13600,12200,82750,2,-1400,2015
82334,4.4,24890.0,12400,12000,68360,1,-400,2015
402909,1.9,174884.0,1500,800,61450,12,-700,2015
465686,4.5,52092.0,16950,17100,61490,2,150,2015
271747,3.8,92056.0,9775,10300,59100,11,525,2015
419692,3.5,29137.0,11100,11500,61450,4,400,2015
499035,4.7,11872.0,16950,17100,80610,0,150,2014
203883,4.9,22854.0,22000,24500,57290,3,2500,2015
520324,3.7,38999.0,17900,16500,71660,1,-1400,2015
219484,4.8,109243.0,4075,6600,57290,12,2525,2015
503929,2.3,88321.0,8025,8800,80610,6,775,2015
302230,4.1,48498.0,21900,19600,59100,5,-2300,2015
2010,4.3,53639.0,34200,35000,77030,3,800,2014
206824,2.8,136252.0,17950,17600,57290,7,-350,2015
463885,4.6,68618.0,15050,20300,61490,8,5250,2015
173662,,192050.0,650,700,83200,13,50,2014
217102,3.1,27511.0,14800,14400,57290,2,-400,2015
203326,4.4,36975.0,19550,19800,57290,2,250,2015
433044,,52561.0,7050,6800,74430,9,-250,2014
483735,1.9,137211.0,4025,2700,73130,12,-1325,2015
227000,2.8,65263.0,10250,10200,89090,3,-50,2015
251303,2.9,100093.0,7550,8000,59100,6,450,2015
1840,3.9,17456.0,28500,28500,77030,3,0,2014
168138,2.1,30299.0,10550,7400,73100,3,-3150,2015
171063,4.2,35515.0,14100,14400,73100,3,300,2015
430702,2.1,142391.0,7400,5700,61450,10,-1700,2015
480643,4.0,20359.0,14700,13900,73130,1,-800,2015
80223,2.0,90235.0,5375,1100,68360,10,-4275,2015
124281,4.1,41472.0,9275,9700,73100,2,425,2015
451233,2.9,91976.0,3950,4000,61490,8,50,2015
509561,3.7,17956.0,9950,10300,71660,2,350,2015
147170,4.5,47721.0,15850,16500,73100,4,650,2015
351284,3.2,55394.0,17750,17700,62960,3,-50,2015
531761,2.9,71119.0,9150,7900,82150,3,-1250,2015
166563,3.9,33313.0,12550,12600,73100,1,50,2015
233717,4.1,98011.0,20400,20800,59100,5,400,2014
201509,2.9,23841.0,21800,19800,57290,2,-2000,2015
415696,2.9,98285.0,4575,6400,61450,10,1825,2015
441844,4.1,91337.0,7925,7600,74430,4,-325,2015
267707,2.9,113276.0,4100,3900,59100,4,-200,2015
59711,3.3,66337.0,11050,11200,77030,2,150,2015
484844,4.2,25020.0,20500,20900,73130,1,400,2015
121841,,51220.0,16500,17200,73100,2,700,2014
255696,2.0,38255.0,25500,19600,59100,4,-5900,2015
164652,1.9,144371.0,8900,6300,73100,10,-2600,2015
383489,4.8,40678.0,29400,31000,65610,2,1600,2014
196739,1.9,118287.0,2475,2600,67090,8,125,2015
252245,3.0,54840.0,9475,9200,59100,3,-275,2015
544490,3.4,36252.0,13100,13300,81400,2,200,2015
35115,3.8,58205.0,14350,14100,77030,2,-250,2015
53861,2.0,55846.0,17100,13250,77030,2,-3850,2015
176642,3.5,58759.0,11750,11400,83200,2,-350,2015
54070,3.7,20642.0,38500,39000,77030,4,500,2015
69483,3.2,58232.0,9100,9600,77030,2,500,2015
93605,4.8,129715.0,24800,25600,68360,7,800,2015
297393,4.3,40051.0,12050,11400,59100,4,-650,2015
410743,1.9,193115.0,1150,1100,61450,17,-50,2015
203960,3.5,27281.0,27200,30600,57290,3,3400,2015
181432,3.9,78489.0,10700,10900,83200,5,200,2015
253292,4.1,6326.0,31400,31000,59100,1,-400,2015
140259,1.9,36805.0,13200,10900,73100,2,-2300,2015
77396,2.0,16907.0,18050,10900,68360,0,-7150,2014
99164,2.0,90430.0,3300,850,68360,10,-2450,2015
456624,2.3,139275.0,3375,3600,61490,8,225,2015
68200,2.0,195312.0,6050,4000,77030,13,-2050,2015
141919,1.9,250521.0,5200,6300,73100,9,1100,2015
27942,3.3,65524.0,14250,13500,77030,3,-750,2015
399969,3.9,41049.0,11250,11100,61450,0,-150,2014
242115,4.3,23434.0,32200,32000,59100,2,-200,2014
462542,4.4,34966.0,13750,13800,61490,2,50,2015
246320,4.7,31824.0,11300,12100,59100,2,800,2015
461427,2.6,106759.0,3125,2700,61490,9,-425,2015
448489,3.6,73379.0,9900,8900,56120,5,-1000,2015
373854,2.3,120087.0,3350,2550,64520,6,-800,2015
428340,3.6,103128.0,5950,5200,61450,4,-750,2015
507686,4.9,52039.0,9675,10100,80200,2,425,2015
74918,,252643.0,7950,5300,68360,12,-2650,2014
250986,1.9,166170.0,1175,850,59100,17,-325,2015
180640,2.8,71279.0,8700,9600,83200,7,900,2015
402172,2.4,46557.0,7025,8900,61450,9,1875,2015
235933,,,650,350,59100,16,-300,2014
122901,,17271.0,22700,22200,73100,2,-500,2014
485838,3.4,35122.0,9450,10000,73130,4,550,2015
465414,2.5,153816.0,4350,3800,61490,8,-550,2015
105970,3.4,66914.0,11800,12000,68360,3,200,2015
43309,3.5,44792.0,9050,10900,77030,8,1850,2015
490475,4.2,121502.0,9800,11200,73130,6,1400,2015
467727,4.7,686.0,13900,15400,61490,0,1500,2015
295492,2.7,62437.0,11250,10500,59100,2,-750,2015
428246,4.9,15700.0,13400,16500,61450,1,3100,2015
211572,4.9,18848.0,17600,17800,57290,3,200,2015
546144,4.6,32086.0,23300,23800,81400,1,500,2015
99662,2.5,88996.0,4850,4800,68360,7,-50,2015
407155,2.7,32838.0,11800,9700,61450,2,-2100,2015
214959,3.8,15099.0,30900,30500,57290,2,-400,2015
539110,1.0,145224.0,2100,3100,55590,13,1000,2015
200728,2.8,133784.0,9225,10900,67090,6,1675,2015
402262,4.0,154914.0,1225,2100,61450,13,875,2015
334475,4.1,30322.0,21700,20700,82750,3,-1000,2015
240717,1.9,135613.0,3050,2700,59100,9,-350,2014
476330,,188648.0,1200,1500,73130,15,300,2014
438580,3.4,50530.0,8300,8000,74430,4,-300,2015
303354,3.6,38377.0,12300,12000,59100,1,-300,2015
254188,2.3,156454.0,7050,7000,59100,6,-50,2015
166002,3.5,115447.0,17950,17300,73100,7,-650,2015
236979,,127086.0,7675,7400,59100,7,-275,2014
356585,1.0,134650.0,2550,1050,62960,10,-1500,2015
440424,4.3,6693.0,18800,19450,74430,1,650,2015
356325,3.7,36875.0,10950,11500,62960,2,550,2015
43604,3.7,40321.0,13950,14000,77030,1,50,2015
155414,3.6,12811.0,19950,13100,73100,3,-6850,2015
331912,2.7,33428.0,16950,15800,82750,3,-1150,2015
290740,1.0,207844.0,675,400,59100,14,-275,2015
512739,3.9,75396.0,8075,7900,71660,7,-175,2015
198487,3.5,46316.0,25400,25000,67090,4,-400,2015
181310,3.5,33658.0,8675,9600,83200,4,925,2015
403867,4.4,126972.0,4575,5200,61450,9,625,2015
167046,3.4,63408.0,4675,7000,73100,7,2325,2015
395730,2.1,129179.0,2950,2900,65610,9,-50,2015
328123,2.4,104527.0,6850,5300,82750,11,-1550,2015
316776,3.6,179718.0,3575,3400,73200,5,-175,2015
367086,2.9,51237.0,19100,19250,64520,4,150,2015
7859,4.7,7715.0,24000,24500,77030,-1,500,2014
110957,4.4,41518.0,20200,22100,68360,2,1900,2015
387436,4.5,51455.0,9525,10600,65610,2,1075,2015
364427,1.0,107207.0,3650,3450,64520,8,-200,2015
422535,2.1,80623.0,1575,1300,61450,15,-275,2015
221124,4.7,23932.0,34600,38100,57290,2,3500,2015
11863,4.0,19383.0,19350,19500,77030,1,150,2015
217178,3.5,127080.0,8400,8500,57290,12,100,2015
196823,2.9,78192.0,17550,18200,67090,7,650,2015
48129,4.3,54380.0,26400,26500,77030,4,100,2015
375392,3.6,49221.0,8700,9200,64520,3,500,2015
422084,1.9,94296.0,5350,4900,61450,6,-450,2015
400029,2.0,35154.0,18650,16000,61450,2,-2650,2015
93884,3.7,38889.0,17350,17100,68360,2,-250,2015
471278,2.8,113389.0,4750,7800,62930,9,3050,2015
488368,4.0,28943.0,10950,10400,73130,2,-550,2015
224971,3.7,71629.0,9000,7700,89090,4,-1300,2015
253988,4.9,14161.0,25500,24800,59100,1,-700,2015
72833,4.8,12024.0,13050,13800,77030,1,750,2015
211706,2.4,12544.0,11850,11200,57290,3,-650,2015
442851,1.9,198891.0,875,900,74430,13,25,2015
424725,3.9,25240.0,9000,8900,61450,2,-100,2015
322809,3.9,46326.0,35300,33000,82750,2,-2300,2015
300499,4.2,60681.0,13300,14000,59100,3,700,2015
455686,1.9,1.0,3025,2200,61490,14,-825,2015
458908,2.6,63694.0,11100,10500,61490,2,-600,2015
427157,4.3,67685.0,12900,12600,61450,4,-300,2015
438448,2.8,110060.0,3000,2300,74430,11,-700,2015
172492,4.7,30147.0,12100,13300,73100,2,1200,2015
387305,4.4,89285.0,19700,17000,65610,5,-2700,2015
140161,3.7,40915.0,12200,11700,73100,2,-500,2015
332498,3.5,66378.0,8700,8500,82750,3,-200,2015
44909,3.7,106424.0,17800,17000,77030,5,-800,2015
487320,2.8,49497.0,15250,14900,73130,4,-350,2015
330092,1.9,99048.0,12850,15000,82750,9,2150,2015
518217,3.9,36710.0,14250,14100,71660,1,-150,2015
424896,4.2,40304.0,13050,12000,61450,3,-1050,2015
228920,2.0,113450.0,1050,1450,89090,14,400,2015
266950,3.7,96922.0,8825,11000,59100,10,2175,2015
133684,3.0,24853.0,43300,43800,73100,1,500,2015
208401,4.3,36738.0,9200,10000,57290,1,800,2015
33441,4.5,20105.0,12750,13000,77030,3,250,2015
307679,3.6,58694.0,4875,3500,59100,5,-1375,2015
546135,2.7,194310.0,475,500,81400,14,25,2015
527000,3.9,94462.0,15300,13600,70210,4,-1700,2015
55652,4.3,41077.0,13000,12200,77030,2,-800,2015
406573,2.2,228105.0,2000,2100,61450,13,100,2015
275379,2.6,34468.0,10300,10000,59100,1,-300,2015
64718,3.1,20743.0,8950,8900,77030,2,-50,2015
480214,4.7,21608.0,26900,27000,73130,1,100,2015
232660,4.5,24611.0,17750,17100,89090,2,-650,2015
190887,2.9,23369.0,14450,14200,63250,1,-250,2015
509400,2.5,128685.0,1675,1500,71660,10,-175,2014
417837,4.0,116575.0,7175,6500,61450,8,-675,2015
323887,4.2,71901.0,23400,23500,82750,6,100,2015
273411,2.5,17440.0,15450,14200,59100,1,-1250,2015
391664,4.7,145156.0,5425,6700,65610,7,1275,2015
332864,4.4,24182.0,14750,15700,82750,3,950,2015
534086,3.7,100614.0,2450,3300,82150,13,850,2015
188774,3.4,30593.0,29900,29400,63250,1,-500,2015
524275,4.2,90490.0,10900,9900,70210,7,-1000,2014
513891,3.8,17712.0,14250,14600,71660,1,350,2015
316132,,115515.0,13350,13400,73200,7,50,2014
495834,2.3,38741.0,8250,7600,73130,7,-650,2015
271989,3.9,70456.0,11750,11500,59100,2,-250,2015
23592,3.5,52865.0,5225,5700,77030,6,475,2015
5975,3.5,16503.0,15750,16500,77030,0,750,2014
52607,3.8,38800.0,20300,20600,77030,2,300,2015
58451,4.4,23354.0,21100,21300,77030,0,200,2015
425983,4.4,43552.0,17000,18600,61450,2,1600,2015
493182,2.5,51860.0,12050,11000,73130,2,-1050,2015
206560,4.4,25622.0,15700,15800,57290,1,100,2015
260552,4.1,110483.0,8650,8500,59100,9,-150,2015
473940,1.9,134329.0,2575,2300,62930,9,-275,2015
373396,2.7,110981.0,4225,4900,64520,7,675,2015
546189,4.3,24581.0,10700,11200,81400,2,500,2015
35540,4.2,114788.0,7250,9000,77030,4,1750,2015
17546,4.9,17152.0,12150,11750,77030,2,-400,2015
304825,4.3,30160.0,23500,23600,59100,1,100,2015
5619,4.8,19008.0,12450,13300,77030,0,850,2014
38319,4.6,29585.0,45500,45000,77030,3,-500,2015
131906,2.6,32428.0,22600,21300,73100,3,-1300,2015
429167,3.4,88236.0,8100,9000,61450,3,900,2015
344496,4.3,25907.0,38200,37000,82750,3,-1200,2015
96425,2.8,118295.0,5400,4300,68360,12,-1100,2015
386689,3.1,102214.0,2725,3300,65610,10,575,2015
270470,4.4,143530.0,7925,9800,59100,8,1875,2015
2087,4.3,30140.0,28400,28000,77030,3,-400,2014
205236,3.5,74259.0,22600,21200,57290,5,-1400,2015
70396,4.3,5713.0,15500,16000,77030,2,500,2015
529705,3.2,98522.0,3475,3300,82150,12,-175,2015
448670,2.8,34205.0,11650,9200,61490,4,-2450,2015
284400,4.8,20137.0,11350,12200,59100,3,850,2015
353265,4.3,36729.0,39600,39500,62960,1,-100,2015
122315,3.6,47672.0,12050,11400,73100,2,-650,2014
514826,1.9,177661.0,6550,6900,71660,12,350,2015
84120,4.1,47256.0,24000,25750,68360,3,1750,2015
114237,1.3,141026.0,2175,2000,68360,9,-175,2015
79300,2.0,25103.0,12850,10200,68360,3,-2650,2015
345481,2.8,92697.0,8800,8000,82750,5,-800,2015
359785,3.4,82754.0,8525,8000,62960,8,-525,2015
192254,1.0,259.0,2950,800,67090,11,-2150,2014
454330,3.4,98145.0,12900,12500,61490,8,-400,2015
444030,3.9,84702.0,1800,4200,74430,12,2400,2015
382647,,158494.0,2075,1350,65610,7,-725,2014
308085,3.9,25017.0,18300,19900,59100,1,1600,2015
319809,2.6,110144.0,11400,11100,73200,5,-300,2015
16352,3.7,20385.0,22100,20000,77030,3,-2100,2015
442142,4.0,16381.0,16700,16500,74430,1,-200,2015
268865,1.9,87459.0,6050,5400,59100,7,-650,2015
465817,1.9,113870.0,3825,3700,61490,12,-125,2015
425524,2.0,9714.0,19150,14200,61450,0,-4950,2015
355704,3.8,58159.0,13100,13100,62960,2,0,2015
400154,3.4,36661.0,21700,19700,61450,3,-2000,2015
195636,3.5,29572.0,29300,28800,67090,3,-500,2015
547101,2.3,79635.0,6825,2800,78090,6,-4025,2015
445082,1.9,105443.0,5025,2800,56120,8,-2225,2015
518006,3.4,56311.0,17400,17200,71660,2,-200,2015
231163,3.3,99093.0,12750,12100,89090,6,-650,2015
202415,4.2,46688.0,10050,9800,57290,1,-250,2014
463674,2.3,111714.0,4300,5200,61490,8,900,2015
392984,4.8,94895.0,1425,4000,65610,14,2575,2015
301544,4.8,29643.0,9475,11600,59100,3,2125,2015
345659,1.0,56842.0,10800,7700,82750,2,-3100,2015
349886,2.9,36788.0,12150,11000,62960,2,-1150,2014
18981,4.7,20108.0,12950,12750,77030,3,-200,2015
300560,3.9,106698.0,24500,24200,59100,4,-300,2015
195388,2.6,72338.0,5325,5300,67090,7,-25,2015
230744,2.8,200157.0,5350,2800,89090,11,-2550,2015
117664,2.0,127059.0,3050,2000,68360,11,-1050,2015
236514,2.8,27685.0,24000,23000,59100,3,-1000,2015
504061,3.1,47971.0,15300,15100,80610,3,-200,2015
39159,4.9,16807.0,33100,33000,77030,2,-100,2015
341124,3.1,1442.0,20900,20800,82750,1,-100,2015
316043,3.9,55033.0,8250,8100,73200,4,-150,2014
506843,2.1,155593.0,4525,4400,80200,11,-125,2015
198479,3.3,21044.0,16900,17200,67090,3,300,2015
232246,2.7,115533.0,3525,5500,89090,12,1975,2015
379946,3.3,102601.0,17850,17800,64520,6,-50,2015
544644,2.5,15495.0,14500,13700,81400,1,-800,2015
300895,4.3,20571.0,24500,23000,59100,2,-1500,2015
532766,3.5,93341.0,6475,6700,82150,7,225,2015
292413,4.0,23346.0,10850,11100,59100,1,250,2015
363413,3.9,41153.0,12100,12000,64520,2,-100,2015
50896,2.4,31117.0,14850,14400,77030,3,-450,2015
186755,2.8,72340.0,6175,7400,63250,5,1225,2015
169360,3.5,48619.0,8550,8800,73100,6,250,2015
224032,1.9,70733.0,8375,7400,89090,7,-975,2015
72640,4.5,109513.0,11950,12400,77030,5,450,2015
489856,4.0,13020.0,19800,14000,73130,1,-5800,2015
139673,3.3,99077.0,7075,6300,73100,7,-775,2015
268051,3.2,84169.0,11700,11200,59100,9,-500,2015
45987,3.5,40747.0,11900,12000,77030,3,100,2015
380962,3.3,130819.0,4450,5600,64520,9,1150,2015
360809,1.9,102402.0,2725,1200,64520,9,-1525,2014
529440,1.9,106857.0,1475,1100,70210,11,-375,2015
496649,2.9,45369.0,16300,15500,73130,3,-800,2015
89861,2.8,19750.0,19800,18500,68360,1,-1300,2015
110565,2.8,142817.0,10850,9000,68360,8,-1850,2015
203466,2.7,52653.0,9825,9400,57290,3,-425,2015
170628,4.7,29162.0,8250,9100,73100,2,850,2015
14196,2.0,21956.0,23600,20500,77030,2,-3100,2015
65569,2.8,44838.0,19650,18801,77030,3,-849,2015
546520,4.9,8109.0,39700,42750,81400,0,3050,2015
384625,3.4,67824.0,21200,20100,65610,4,-1100,2015
482870,2.6,109967.0,2300,2250,73130,11,-50,2015
74751,,84469.0,12850,8600,68360,10,-4250,2014
180259,4.4,20922.0,22200,22500,83200,2,300,2015
338066,3.8,31507.0,23400,24000,82750,2,600,2015
438567,3.8,76480.0,7950,8700,74430,4,750,2015
249428,2.8,88559.0,4650,5600,59100,9,950,2015
479401,1.9,31710.0,9800,9400,73130,4,-400,2015
431717,2.2,212000.0,900,1000,61450,16,100,2015
526751,4.8,30321.0,12450,13100,70210,2,650,2015
196341,3.8,12726.0,17300,16000,67090,1,-1300,2015
459535,1.9,173309.0,1625,1750,61490,16,125,2015
504767,3.9,14557.0,17500,16900,80610,1,-600,2015
519643,2.9,68571.0,11050,11100,71660,4,50,2015
520562,4.2,26444.0,18400,17900,71660,1,-500,2015
213105,2.7,123864.0,1500,1200,57290,13,-300,2015
207577,4.2,7936.0,10950,11000,57290,1,50,2015
280008,4.7,10827.0,20700,19700,59100,1,-1000,2015
309949,1.9,18882.0,19150,17000,59100,3,-2150,2015
506382,3.6,70770.0,8750,10900,80200,8,2150,2015
455573,2.4,185446.0,1825,3500,61490,11,1675,2015
129504,1.9,55371.0,10850,8500,73100,3,-2350,2015
290143,4.4,47978.0,25900,25000,59100,1,-900,2015
53476,3.5,150300.0,1600,1750,77030,8,150,2015
334537,4.1,44516.0,28600,28500,82750,3,-100,2015
526838,3.7,35875.0,10800,10100,70210,3,-700,2015
99230,4.7,10186.0,12600,13100,68360,1,500,2015
62485,3.4,57414.0,10350,11100,77030,4,750,2015
40962,3.1,37159.0,20100,19800,77030,2,-300,2015
254166,3.5,43675.0,13300,13900,59100,5,600,2015
480256,4.7,18883.0,32400,30000,73130,1,-2400,2015
88072,4.4,26277.0,21700,23700,68360,3,2000,2015
125116,4.2,34331.0,12300,11400,73100,3,-900,2015
27282,1.9,118934.0,3800,3400,77030,12,-400,2015
355551,3.3,81564.0,30900,29000,62960,4,-1900,2015
464150,3.8,110424.0,1575,3200,61490,11,1625,2015
360740,3.6,107259.0,5950,5300,64520,7,-650,2014
442009,1.9,53626.0,3000,4100,74430,13,1100,2015
218490,3.3,158511.0,1875,2500,57290,10,625,2015
200777,2.7,18571.0,12350,11000,67090,1,-1350,2015
287053,1.9,28899.0,29200,26600,59100,2,-2600,2015
330557,4.8,11270.0,15400,16400,82750,3,1000,2015
71511,4.4,25679.0,20300,21250,77030,2,950,2015
224217,4.2,16045.0,18600,18000,89090,2,-600,2015
112228,3.4,110137.0,22100,22000,68360,7,-100,2015
369739,4.2,31231.0,12200,12300,64520,3,100,2015
418426,2.1,154217.0,4350,5000,61450,8,650,2015
188809,4.3,29939.0,18850,18500,63250,1,-350,2015
87367,2.7,37223.0,10150,10000,68360,1,-150,2015
452833,3.6,99872.0,3100,4800,61490,7,1700,2015
253402,4.1,43874.0,24200,25800,59100,2,1600,2015
43716,2.7,141881.0,4025,4400,77030,9,375,2015
329164,2.9,9546.0,12600,10700,82750,3,-1900,2015
443832,4.2,110647.0,12950,13700,74430,8,750,2015
288773,2.2,56691.0,21400,22200,59100,5,800,2015
525631,2.6,27161.0,11650,9500,70210,2,-2150,2015
289354,2.6,47564.0,17900,15800,59100,4,-2100,2015
224733,3.7,131902.0,3000,1000,89090,11,-2000,2015
121489,4.3,29366.0,14000,14400,73100,1,400,2014
233667,4.8,30909.0,18150,18800,59100,0,650,2014
134828,3.4,40415.0,13050,13000,73100,3,-50,2015
116797,3.3,29947.0,14400,16600,68360,3,2200,2015
542845,3.7,8014.0,12850,13000,81400,1,150,2015
230885,3.9,30802.0,13100,13400,89090,3,300,2015
127520,4.1,35434.0,11550,9000,73100,2,-2550,2015
460965,3.2,206221.0,2525,4200,61490,12,1675,2015
375236,4.9,51821.0,11050,11600,64520,3,550,2015
95419,3.7,36489.0,9550,8900,68360,4,-650,2015
246538,2.8,122011.0,14100,15500,59100,5,1400,2015
491770,2.7,37747.0,12600,10300,73130,3,-2300,2015
435164,2.8,113874.0,6300,6000,74430,7,-300,2015
33096,4.7,25625.0,26600,32500,77030,3,5900,2015
246093,2.7,165591.0,850,1700,59100,18,850,2015
106808,4.1,34808.0,31000,31200,68360,1,200,2015
159840,3.9,82161.0,5425,8700,73100,11,3275,2015
168603,4.7,36703.0,40900,42600,73100,3,1700,2015
502814,4.2,24061.0,15400,14500,80610,2,-900,2015
129337,4.2,39953.0,12600,13500,73100,3,900,2015
196046,3.7,14087.0,31000,31000,67090,2,0,2015
504384,2.5,74249.0,13950,13800,80610,3,-150,2015
106898,4.9,23505.0,20600,18500,68360,1,-2100,2015
140037,3.8,22356.0,17900,17800,73100,2,-100,2015
343879,4.0,40057.0,24200,26100,82750,2,1900,2015
504758,3.5,72296.0,10350,10900,80610,4,550,2015
477017,,80236.0,17000,18400,73130,6,1400,2014
347303,5.0,14487.0,24100,24000,82750,1,-100,2015
256274,2.3,189921.0,1450,1400,59100,11,-50,2015
1601,3.1,58768.0,7525,8400,77030,2,875,2014
436017,2.5,154411.0,3625,3800,74430,12,175,2015
272183,4.2,32388.0,20700,21200,59100,3,500,2015
137627,2.6,51858.0,9400,9600,73100,6,200,2015
103077,1.9,87659.0,4625,3400,68360,10,-1225,2015
382420,4.7,90870.0,9875,9500,65610,6,-375,2014
541325,4.0,35043.0,13450,13400,81400,2,-50,2015
86664,2.8,103121.0,13050,10000,68360,4,-3050,2015
277094,4.1,58720.0,9650,10300,59100,2,650,2015
92630,3.4,143606.0,7600,4600,68360,7,-3000,2015
503940,1.0,177719.0,5450,6500,80610,10,1050,2015
28482,3.9,81599.0,9475,11300,77030,2,1825,2015
359303,3.5,80745.0,13650,16600,62960,8,2950,2015
510704,2.3,76882.0,10650,9800,71660,10,-850,2015
172347,4.9,25898.0,42100,41000,73100,2,-1100,2015
520434,4.8,14584.0,56700,54500,71660,0,-2200,2015
290585,3.6,35666.0,18250,18700,59100,5,450,2015
197652,2.4,56665.0,9175,11100,67090,7,1925,2015
520114,4.6,37185.0,17650,17700,71660,1,50,2015
269507,5.0,26845.0,17500,18200,59100,4,700,2015
449267,1.9,213551.0,6700,4500,61490,10,-2200,2014
400278,1.9,92051.0,8575,10500,61450,10,1925,2014
336412,2.5,11276.0,11900,9900,82750,3,-2000,2015
442204,4.0,15420.0,12200,11600,74430,1,-600,2015
510458,4.2,52526.0,23500,24500,71660,3,1000,2015
409398,4.2,18632.0,24000,23500,61450,1,-500,2015
514597,4.2,138291.0,4500,3600,71660,4,-900,2015
283366,4.4,76334.0,16750,17900,59100,5,1150,2015
453838,3.7,78096.0,21000,20800,61490,3,-200,2015
474327,4.7,36095.0,18900,19500,62930,2,600,2015
395877,1.9,134515.0,1350,600,65610,12,-750,2015
229782,3.9,136597.0,14900,14600,89090,8,-300,2015
291831,2.8,72365.0,9100,9400,59100,10,300,2015
383950,3.6,69827.0,8025,7200,65610,4,-825,2015
143608,3.0,74805.0,4800,2300,73100,9,-2500,2015
390457,4.8,25637.0,25300,25600,65610,2,300,2015
475010,2.9,31445.0,19950,19400,73130,4,-550,2014
320343,2.6,108036.0,23700,21400,82750,8,-2300,2015
341433,4.1,54540.0,10000,9500,82750,3,-500,2015
266861,3.4,83683.0,5750,7200,59100,9,1450,2015
478558,2.1,42158.0,25700,24000,73130,3,-1700,2015
183149,,212039.0,1625,1800,63250,11,175,2014
319128,2.8,47781.0,8175,8100,73200,2,-75,2015
466040,3.5,42507.0,10150,9200,61490,2,-950,2015
84060,3.3,31692.0,24700,28900,68360,2,4200,2015
534018,4.7,84378.0,5475,4800,82150,4,-675,2015
213386,2.3,91964.0,13050,13000,57290,4,-50,2015
303420,3.5,58923.0,21100,20300,59100,2,-800,2015
14439,3.5,30423.0,30500,28500,77030,4,-2000,2015
109279,3.3,20114.0,11450,11800,68360,2,350,2015
527731,2.9,33489.0,11150,10500,70210,2,-650,2015
499142,4.4,13189.0,15100,15800,80610,1,700,2015
49772,3.5,116502.0,15750,16500,77030,7,750,2015
334814,4.0,58157.0,10100,10100,82750,2,0,2015
158330,4.4,104602.0,13200,13500,73100,7,300,2015
414911,3.8,140260.0,5950,6300,61450,11,350,2015
428188,2.9,128409.0,2000,2400,61450,11,400,2015
527677,2.5,143108.0,16300,13700,70210,9,-2600,2015
164858,2.9,33649.0,20300,20400,73100,3,100,2015
345575,4.7,20771.0,33700,33500,82750,2,-200,2015
204709,3.7,12729.0,16400,16700,57290,2,300,2015
430243,2.6,32160.0,17700,17800,61450,3,100,2015
480803,4.6,12682.0,22700,23200,73130,3,500,2015
538882,4.8,20524.0,44900,46400,55590,3,1500,2015
511829,4.4,48631.0,14900,15600,71660,3,700,2015
463361,2.8,123423.0,1600,2000,61490,16,400,2015
533292,2.9,71771.0,14400,12300,82150,6,-2100,2015
466068,3.6,15984.0,10600,9700,61490,3,-900,2015
114752,3.1,115920.0,8750,10000,68360,8,1250,2015
269250,4.4,27387.0,29300,28800,59100,2,-500,2015
173408,2.5,85747.0,4125,3450,83200,9,-675,2015
536840,1.9,145923.0,1925,700,73640,13,-1225,2015
40018,3.8,23190.0,20800,20000,77030,4,-800,2015
242013,4.9,14791.0,29500,28200,59100,0,-1300,2014
200735,2.2,127188.0,4325,4100,67090,7,-225,2015
69938,1.9,22009.0,11500,9750,77030,3,-1750,2015
528952,1.9,17248.0,27000,19800,70210,2,-7200,2015
55468,2.0,216540.0,2500,3350,77030,11,850,2015
17363,4.8,10020.0,17350,17500,77030,1,150,2015
81969,1.5,115356.0,5825,3000,68360,8,-2825,2015
509608,4.4,44813.0,22300,20800,71660,3,-1500,2015
234077,,154780.0,6050,5800,59100,6,-250,2014
76936,4.2,32595.0,30900,32500,68360,2,1600,2015
214785,2.4,137107.0,5925,4700,57290,6,-1225,2015
449106,3.7,114061.0,8175,8100,61490,8,-75,2014
511245,2.3,77466.0,8300,9700,71660,5,1400,2015
302536,4.2,9933.0,29700,29000,59100,0,-700,2015
368056,4.4,11548.0,31100,43500,64520,0,12400,2015
219182,3.0,88194.0,10000,10200,57290,6,200,2015
444201,2.9,99569.0,12200,12700,74430,2,500,2015
431139,4.3,17071.0,9225,8500,61450,2,-725,2015
60813,3.4,73451.0,18950,20500,77030,5,1550,2015
413262,4.6,35928.0,21400,21500,61450,1,100,2015
374051,3.1,48604.0,21600,17700,64520,4,-3900,2015
66959,4.1,60746.0,8125,14900,77030,11,6775,2015
188606,3.7,32757.0,11450,11600,63250,1,150,2015
416795,3.4,129568.0,9950,8100,61450,9,-1850,2015
31279,2.9,166154.0,3150,4400,77030,11,1250,2015
325294,4.3,51280.0,21300,21100,82750,3,-200,2015
333438,2.7,98188.0,13850,13400,82750,8,-450,2015
159905,4.1,27635.0,27000,26500,73100,2,-500,2015
155349,4.1,18638.0,24600,24000,73100,2,-600,2015
490892,4.8,45800.0,16400,16600,73130,2,200,2015
25247,3.9,62474.0,10600,10400,77030,2,-200,2015
379489,4.9,10286.0,20600,20700,64520,0,100,2015
539728,3.5,144491.0,1925,4000,81400,6,2075,2014
311899,4.7,19610.0,27500,27600,59100,2,100,2015
300104,2.1,199565.0,3500,2900,59100,10,-600,2015
160958,3.6,27980.0,18600,17000,73100,1,-1600,2015
210260,5.0,25645.0,22400,22300,57290,1,-100,2015
411074,3.6,25577.0,29100,28750,61450,2,-350,2015
416443,4.5,22175.0,13600,14500,61450,1,900,2015
104535,2.7,34844.0,13900,13800,68360,2,-100,2015
225898,4.2,21836.0,24800,23400,89090,3,-1400,2015
215026,1.0,225798.0,875,1025,57290,18,150,2015
92133,4.9,4179.0,34900,35000,68360,2,100,2015
429967,3.6,221447.0,475,800,61450,16,325,2015
538809,2.2,193466.0,4200,5500,55590,9,1300,2015
401430,3.1,76340.0,9425,10600,61450,5,1175,2015
295371,1.9,95057.0,14750,12100,59100,4,-2650,2015
193688,3.6,25458.0,20700,21000,67090,2,300,2015
395239,5.0,32811.0,24400,25500,65610,3,1100,2015
236234,,43183.0,10550,10200,59100,1,-350,2014
537914,3.9,50891.0,9800,9200,55590,3,-600,2014
505275,5.0,8137.0,15150,15300,80610,1,150,2015
147051,3.1,21706.0,12900,11100,73100,3,-1800,2015
5653,5.0,8399.0,11800,12500,77030,0,700,2014
496236,2.1,45046.0,11250,10300,73130,3,-950,2015
75853,3.1,97274.0,3725,3300,68360,5,-425,2014
263136,3.0,13300.0,17700,17900,59100,1,200,2015
68177,2.8,98253.0,5175,5600,77030,10,425,2015
395051,3.6,47464.0,13000,11600,65610,4,-1400,2015
74418,2.5,94912.0,5400,5200,68360,8,-200,2014
103251,3.5,34256.0,12950,13400,68360,2,450,2015
397844,2.2,103063.0,6550,5000,61450,4,-1550,2014
515477,1.9,228641.0,325,350,71660,15,25,2015
427103,2.7,58392.0,8675,9400,61450,3,725,2015
161513,2.9,99968.0,3475,6600,73100,8,3125,2015
55990,2.4,63440.0,8900,10600,77030,9,1700,2015
261381,3.5,66080.0,12900,12500,59100,3,-400,2015
302422,2.7,24764.0,29700,27500,59100,1,-2200,2015
2128,2.9,58395.0,11950,13000,77030,3,1050,2014
273185,4.4,9397.0,27800,30000,59100,1,2200,2015
295466,1.9,145908.0,1725,1000,59100,18,-725,2015
477459,1.0,176564.0,675,500,73130,12,-175,2014
147760,2.5,85709.0,14000,11800,73100,3,-2200,2015
316556,3.8,88003.0,11550,12500,73200,5,950,2015
440612,3.6,28467.0,10600,12500,74430,3,1900,2015
549119,1.9,10849.0,16750,10500,48460,0,-6250,2015
200819,4.8,37091.0,16250,16600,67090,2,350,2015
15038,3.5,74922.0,7600,11000,77030,7,3400,2015
530603,2.9,71047.0,7925,7000,82150,9,-925,2015
332499,2.7,59159.0,11150,9800,82750,3,-1350,2015
218743,4.3,20234.0,11450,11700,57290,2,250,2015
278227,4.2,35184.0,29500,29300,59100,2,-200,2015
447803,3.6,69506.0,14450,15500,56120,5,1050,2015
469596,2.3,155811.0,2225,1900,61490,11,-325,2015
174388,3.7,154152.0,6050,7200,83200,9,1150,2015
376842,2.0,41134.0,10050,8500,64520,1,-1550,2015
193503,1.9,88026.0,16500,12200,67090,7,-4300,2015
49334,3.5,24523.0,26000,26250,77030,4,250,2015
503343,4.0,31238.0,10850,10300,80610,1,-550,2015
106514,4.3,37770.0,9650,9800,68360,1,150,2015
267474,4.0,53615.0,13550,13900,59100,2,350,2015
77062,3.5,30830.0,16300,16400,68360,2,100,2014
358523,4.0,31757.0,13600,13700,62960,1,100,2015
513485,2.6,54153.0,9900,7000,71660,2,-2900,2015
386554,4.6,13841.0,30500,27900,65610,2,-2600,2015
45024,3.6,151543.0,6575,7250,77030,7,675,2015
478659,1.9,40193.0,11000,9300,73130,3,-1700,2015
370402,4.7,24683.0,13600,14400,64520,3,800,2015
1540,3.9,48311.0,12550,13000,77030,2,450,2014
184000,1.9,49932.0,9675,9400,63250,3,-275,2014
308813,4.5,12141.0,23400,23500,59100,1,100,2015
134972,2.5,98665.0,5950,5200,73100,10,-750,2015
407976,3.8,76542.0,9650,10100,61450,3,450,2015
497413,5.0,8136.0,23100,24500,73130,1,1400,2015
92264,4.2,89817.0,15850,15600,68360,2,-250,2015
522016,4.6,34314.0,28600,28100,71660,1,-500,2015
216865,1.9,105656.0,9625,8200,57290,6,-1425,2015
6606,3.6,48637.0,17600,17500,77030,3,-100,2014
6755,3.3,85414.0,8825,9400,77030,4,575,2014
480759,4.7,14359.0,11850,12200,73130,2,350,2015
515845,4.6,21574.0,12000,12600,71660,1,600,2015
114080,2.4,236021.0,2875,2800,68360,12,-75,2015
408728,3.9,50548.0,9375,9000,61450,3,-375,2015
204989,2.2,205626.0,1200,1000,57290,15,-200,2015
11475,2.7,33910.0,12150,12500,77030,2,350,2014
284940,3.7,48754.0,9275,9200,59100,5,-75,2015
242722,2.8,85361.0,7200,6500,59100,4,-700,2015
35569,4.4,89470.0,6925,8500,77030,5,1575,2015
448900,2.8,136545.0,3675,3000,61490,6,-675,2014
278129,3.8,40349.0,12450,12300,59100,2,-150,2015
441612,2.7,205192.0,1600,950,74430,13,-650,2015
146823,4.4,70940.0,6200,7700,73100,9,1500,2015
457120,2.9,19797.0,18100,16300,61490,2,-1800,2015
425769,4.6,22597.0,16050,16900,61450,2,850,2015
276188,3.7,30558.0,12300,11600,59100,3,-700,2015
337753,3.7,70864.0,16000,15700,82750,5,-300,2015
437268,3.7,24877.0,11800,12300,74430,3,500,2015
361235,,163722.0,1550,850,64520,13,-700,2014
184813,4.4,12691.0,13650,13600,63250,2,-50,2015
119885,4.1,2980.0,22900,23800,73100,0,900,2014
26604,2.4,42096.0,22100,23000,77030,3,900,2015
323975,3.7,141689.0,9475,9200,82750,8,-275,2015
346220,4.5,32955.0,16550,17400,82750,3,850,2015
51209,1.9,188080.0,3250,3300,77030,8,50,2015
57507,4.2,65811.0,19700,18500,77030,3,-1200,2015
13989,3.8,81094.0,7050,9600,77030,10,2550,2015
364544,3.8,29660.0,13950,14000,64520,2,50,2015
325271,3.0,28193.0,22100,21600,82750,2,-500,2015
356438,2.0,170009.0,925,800,62960,16,-125,2015
79926,3.8,146380.0,14500,15000,68360,6,500,2015
353159,4.9,23508.0,18250,18100,62960,1,-150,2015
193622,5.0,11241.0,21300,21000,67090,0,-300,2015
148662,3.6,64738.0,19150,18000,73100,4,-1150,2015
186973,4.9,14908.0,39800,40300,63250,1,500,2015
314970,1.9,71648.0,7900,6400,59100,8,-1500,2015
77883,3.8,52444.0,18500,19500,68360,1,1000,2014
521897,3.7,39218.0,17500,18400,71660,3,900,2015
87319,1.9,208494.0,3075,3900,68360,10,825,2015
538596,4.7,2746.0,12550,13500,55590,1,950,2015
233171,2.4,71608.0,13800,14000,59100,4,200,2015
540253,4.4,2307.0,66000,66001,81400,0,1,2014
362322,4.2,111162.0,6300,7600,64520,8,1300,2014
456688,2.1,1.0,6925,2400,61490,10,-4525,2015
402056,4.4,44316.0,23800,27000,61450,4,3200,2015
355901,3.7,129254.0,8000,7900,62960,13,-100,2015
228479,3.5,57828.0,10250,9800,89090,3,-450,2015
420345,5.0,21750.0,25100,25100,61450,1,0,2015
461827,4.2,88805.0,13950,14600,61490,5,650,2015
318172,3.3,77048.0,10600,11600,73200,9,1000,2015
249510,4.0,22308.0,11750,10500,59100,1,-1250,2015
333310,3.8,39050.0,20900,22400,82750,3,1500,2015
456285,1.9,220851.0,600,500,61490,15,-100,2015
134168,4.6,48223.0,20700,18800,73100,5,-1900,2015
281489,4.2,28533.0,30100,31400,59100,3,1300,2015
289389,2.4,72532.0,13250,12800,59100,6,-450,2015
180422,3.1,167794.0,8100,7500,83200,7,-600,2015
370218,1.9,138851.0,6750,5700,64520,10,-1050,2015
340943,1.9,20119.0,15450,12000,82750,3,-3450,2015
468287,2.5,166755.0,4525,5000,61490,8,475,2015
466332,4.2,13471.0,20600,19900,61490,2,-700,2015
498162,4.3,36220.0,18650,19300,73130,4,650,2015
539474,2.7,172651.0,2700,3200,55590,10,500,2015
182889,,180195.0,1675,2000,63250,8,325,2014
433526,2.0,158388.0,950,300,74430,16,-650,2015
426430,3.8,120595.0,2250,2500,61450,14,250,2015
517176,3.4,94676.0,8425,8100,71660,3,-325,2015
84052,3.6,38929.0,9950,10300,68360,1,350,2015
207485,4.6,14681.0,15850,21200,57290,1,5350,2015
237385,3.4,40265.0,13400,13400,59100,1,0,2014
82505,4.0,38905.0,9175,9500,68360,2,325,2015
33445,3.5,35837.0,13350,14750,77030,3,1400,2015
541122,3.6,5753.0,13000,13000,81400,1,0,2015
484079,3.4,22929.0,12550,12300,73130,3,-250,2015
313018,2.7,207983.0,1775,2700,59100,10,925,2015
421112,3.6,152500.0,6175,6500,61450,9,325,2015
113316,4.2,8634.0,35400,36250,68360,0,850,2015
132959,3.0,93281.0,17650,17000,73100,5,-650,2015
480746,4.2,29847.0,22000,21200,73130,2,-800,2015
203262,4.5,37356.0,17250,18200,57290,3,950,2015
82337,4.2,24053.0,12550,11700,68360,1,-850,2015
53305,2.9,47798.0,8550,8400,77030,3,-150,2015
248023,3.1,84948.0,7975,7400,59100,9,-575,2015
479284,4.3,17605.0,13000,12200,73130,3,-800,2015
489389,2.3,45829.0,7425,7500,73130,4,75,2015
267724,2.6,78388.0,8675,9100,59100,4,425,2015
284784,3.6,57679.0,12600,13300,59100,4,700,2015
29524,3.6,45638.0,20100,19500,77030,3,-600,2015
205697,4.3,36236.0,13100,12000,57290,2,-1100,2015
72805,1.9,212888.0,5150,4200,77030,14,-950,2015
311886,3.5,46086.0,7950,8900,59100,2,950,2015
401533,4.3,15182.0,34500,33100,61450,1,-1400,2015
484952,4.6,13268.0,12400,12400,73130,1,0,2015
325601,4.6,45974.0,16650,16000,82750,3,-650,2015
547331,4.4,25119.0,14100,13400,78090,3,-700,2015
269483,4.3,22955.0,18550,18900,59100,3,350,2015
313347,4.8,18878.0,10850,10500,59100,1,-350,2015
317015,4.2,3651.0,15500,15400,73200,0,-100,2015
400583,4.5,15565.0,29500,29300,61450,1,-200,2015
324175,3.7,85576.0,11200,9700,82750,3,-1500,2015
546107,2.9,153807.0,3425,6900,81400,8,3475,2015
404452,1.9,197588.0,3050,3500,61450,12,450,2015
9135,2.9,147550.0,3175,2500,77030,6,-675,2014
391963,3.7,41529.0,27000,26100,65610,5,-900,2015
324573,3.5,2888.0,23100,23800,82750,1,700,2015
19753,4.4,13079.0,11250,11750,77030,1,500,2015
7554,2.0,146801.0,3000,2800,77030,12,-200,2014
455324,3.5,89242.0,8725,8100,61490,3,-625,2015
65415,3.8,19191.0,18150,17500,77030,2,-650,2015
501850,3.5,65132.0,13350,13600,80610,3,250,2015
331535,4.9,5527.0,23900,25000,82750,2,1100,2015
17824,4.1,25706.0,21500,22500,77030,3,1000,2015
111274,3.5,103904.0,7225,6600,68360,3,-625,2015
508903,1.9,132798.0,3400,2900,71660,9,-500,2014
129710,1.9,40780.0,18150,15200,73100,4,-2950,2015
84177,3.5,46765.0,16700,17300,68360,5,600,2015
33389,3.7,17812.0,27500,27500,77030,3,0,2015
50861,3.9,50962.0,23500,21500,77030,3,-2000,2015
248960,3.4,106699.0,7625,7700,59100,4,75,2015
199005,2.8,61747.0,17950,15500,67090,4,-2450,2015
237614,4.2,55668.0,18150,20600,59100,4,2450,2015
326565,2.9,11973.0,13900,11500,82750,0,-2400,2015
524557,2.7,88122.0,5375,6900,70210,11,1525,2015
539630,1.9,175565.0,8450,6000,55590,7,-2450,2015
91796,3.1,21107.0,16600,16500,68360,1,-100,2015
188806,2.8,37740.0,14800,14500,63250,1,-300,2015
451771,3.9,21662.0,16250,16300,61490,1,50,2015
412361,3.9,37025.0,15450,15400,61450,1,-50,2015
262835,4.9,14783.0,12200,12000,59100,2,-200,2015
509049,3.9,23766.0,22500,20300,71660,2,-2200,2014
54332,3.7,115334.0,4125,6000,77030,10,1875,2015
501894,4.2,48865.0,26000,29400,80610,3,3400,2015
344193,3.5,34914.0,20800,21500,82750,2,700,2015
41000,3.2,43892.0,12700,12900,77030,2,200,2015
97963,2.0,280724.0,775,300,68360,16,-475,2015
514311,3.2,28098.0,13850,13200,71660,2,-650,2015
330746,1.9,75473.0,5600,4600,82750,4,-1000,2015
415413,4.1,19328.0,22500,21300,61450,3,-1200,2015
280076,3.9,15525.0,12800,12400,59100,2,-400,2015
346191,4.2,12552.0,12900,14600,82750,3,1700,2015
306000,3.7,50245.0,11250,11300,59100,2,50,2015
364250,5.0,52341.0,9575,12000,64520,3,2425,2015
1686,3.6,25635.0,16300,15250,77030,2,-1050,2014
116734,3.7,57496.0,9725,11100,68360,3,1375,2015
112434,3.6,20538.0,45400,45000,68360,3,-400,2015
392517,4.8,23209.0,26400,27100,65610,1,700,2015
89518,3.3,101627.0,18300,18000,68360,7,-300,2015
42110,3.3,19277.0,12250,13000,77030,1,750,2015
427327,4.8,17561.0,25000,26800,61450,1,1800,2015
138974,2.4,27950.0,21300,20800,73100,3,-500,2015
318350,3.5,56474.0,12950,13400,73200,2,450,2015
510145,2.8,109149.0,21000,18000,71660,10,-3000,2015
227396,2.4,126043.0,2425,2600,89090,15,175,2015
171337,4.1,52368.0,33900,31500,73100,3,-2400,2015
235283,,133641.0,2450,3300,59100,10,850,2014
534216,4.3,61564.0,10900,9700,82150,3,-1200,2015
127603,4.1,31269.0,27700,26750,73100,3,-950,2015
159427,4.1,22442.0,19500,19100,73100,1,-400,2015
119699,2.9,58444.0,12550,12000,73100,3,-550,2014
404376,4.0,125808.0,5625,5800,61450,8,175,2015
395359,2.9,62280.0,4200,5700,65610,9,1500,2015
377842,4.9,8051.0,18750,15600,64520,1,-3150,2015
535466,1.9,181065.0,2125,2000,82150,8,-125,2015
243762,3.5,28511.0,18050,17200,59100,3,-850,2015
137307,3.3,109592.0,6875,6000,73100,7,-875,2015
363866,2.1,112908.0,3875,2600,64520,10,-1275,2015
201895,2.5,115018.0,2850,3000,57290,8,150,2014
260261,3.5,30864.0,17800,17000,59100,3,-800,2015
338139,2.7,27327.0,9550,9300,82750,4,-250,2015
549229,4.9,5387.0,28500,28700,48460,1,200,2015
218228,4.7,18815.0,13900,14600,57290,1,700,2015
339979,1.9,148693.0,2125,1300,82750,13,-825,2015
219298,4.3,23763.0,17900,18700,57290,1,800,2015
480695,4.0,23364.0,17300,17900,73130,1,600,2015
372084,2.9,34587.0,15500,12900,64520,3,-2600,2015
377113,3.3,63087.0,13650,14100,64520,3,450,2015
196250,3.7,77528.0,6400,8700,67090,10,2300,2015
395455,3.8,53488.0,12600,11400,65610,2,-1200,2015
310636,4.9,5198.0,24000,23400,59100,0,-600,2015
78774,3.9,6279.0,53600,55000,68360,1,1400,2015
357420,3.3,59229.0,17800,17400,62960,3,-400,2015
458957,4.3,46804.0,13450,12500,61490,2,-950,2015
179624,2.8,155406.0,2850,2000,83200,17,-850,2015
91593,2.7,172090.0,4950,5500,68360,12,550,2015
513155,4.4,39451.0,13050,13000,71660,2,-50,2015
135307,3.4,98650.0,8175,9500,73100,8,1325,2015
30875,4.6,25774.0,21500,22000,77030,2,500,2015
456821,4.1,8891.0,16950,17000,61490,1,50,2015
397186,4.4,42763.0,13150,13000,65610,2,-150,2015
174543,3.6,125368.0,10300,10700,83200,6,400,2015
502469,3.2,135790.0,9050,7000,80610,10,-2050,2015
373806,4.6,18038.0,32000,34500,64520,3,2500,2015
400256,4.3,85848.0,20500,18500,61450,6,-2000,2014
441437,5.0,13610.0,17300,17100,74430,1,-200,2015
52473,3.6,112612.0,7225,7900,77030,13,675,2015
268302,4.5,3124.0,18650,19100,59100,1,450,2015
440544,1.9,138838.0,4150,3900,74430,12,-250,2015
11123,2.3,138188.0,2000,2300,77030,14,300,2014
315722,3.0,85873.0,6400,6500,59100,10,100,2015
350253,2.7,102830.0,4500,4500,62960,8,0,2014
479984,3.7,22146.0,14200,14600,73130,4,400,2015
25059,2.5,104809.0,7975,6500,77030,8,-1475,2015
214156,5.0,17823.0,24300,27000,57290,2,2700,2015
301704,2.2,71490.0,5325,6000,59100,7,675,2015
46619,2.0,129132.0,700,300,77030,18,-400,2015
518431,4.2,35222.0,10200,10400,71660,1,200,2015
40800,3.9,72598.0,11400,11250,77030,2,-150,2015
539524,2.9,113359.0,15750,17500,55590,4,1750,2015
332212,4.5,11316.0,15600,14700,82750,1,-900,2015
404260,2.8,114896.0,16500,13800,61450,4,-2700,2015
399340,,162765.0,9675,6100,61450,8,-3575,2014
279901,1.9,131006.0,3550,3200,59100,10,-350,2015
385289,3.5,100067.0,5025,5100,65610,10,75,2015
7799,4.2,24120.0,17150,18800,77030,1,1650,2014
24595,3.6,126839.0,3775,5000,77030,12,1225,2015
379757,3.6,41400.0,50900,46500,64520,3,-4400,2015
52628,3.6,39708.0,16900,20250,77030,2,3350,2015
239363,3.6,22147.0,12700,12400,59100,1,-300,2014
648,4.2,21896.0,14500,14500,77030,1,0,2014
4843,2.0,131270.0,1825,1400,77030,12,-425,2014
292178,3.4,45407.0,15100,14700,59100,1,-400,2015
349428,5.0,13799.0,23500,21500,62960,1,-2000,2015
112774,2.6,38353.0,18650,17500,68360,1,-1150,2015
195165,4.1,24816.0,20300,20000,67090,4,-300,2015
467533,2.7,154687.0,1425,2100,61490,11,675,2015
454231,2.7,193346.0,5675,4900,61490,14,-775,2015
11440,2.3,50829.0,8975,9700,77030,2,725,2014
456834,4.3,14659.0,15500,15800,61490,1,300,2015
466365,4.1,52499.0,8500,9500,61490,2,1000,2015
102084,3.8,27941.0,21100,22200,68360,1,1100,2015
282200,4.1,58202.0,25100,25700,59100,3,600,2015
75958,,124915.0,2350,1800,68360,8,-550,2014
169875,4.0,32703.0,19600,22200,73100,1,2600,2015
291940,2.0,116114.0,2275,1400,59100,13,-875,2015
180221,3.4,25029.0,27200,24700,83200,2,-2500,2015
250495,2.4,118479.0,7200,8400,59100,9,1200,2015
414845,4.6,27626.0,20700,21200,61450,3,500,2015
90614,4.2,29119.0,12750,13200,68360,3,450,2015
34457,2.6,105981.0,4000,4000,77030,11,0,2015
144126,3.6,16419.0,16450,16900,73100,1,450,2015
201393,3.3,26447.0,16050,13600,57290,0,-2450,2014
431397,1.9,212831.0,350,1500,61450,8,1150,2015
504865,4.0,38011.0,22500,23100,80610,3,600,2015
192236,3.2,86224.0,8900,8500,67090,7,-400,2014
549485,4.2,15837.0,15100,13500,48460,0,-1600,2015
264396,2.8,79763.0,6375,5200,59100,7,-1175,2015
457284,3.2,195988.0,2175,1800,61490,7,-375,2015
17712,4.4,31644.0,21200,22750,77030,2,1550,2015
311616,3.8,40864.0,38000,37500,59100,2,-500,2015
501982,4.4,31080.0,27400,26600,80610,1,-800,2015
534500,2.7,98346.0,7500,7500,82150,3,0,2015
436091,2.0,142690.0,9075,8300,74430,4,-775,2015
279380,3.1,48524.0,12350,12300,59100,2,-50,2015
61871,3.6,37012.0,18000,15750,77030,2,-2250,2015
66830,3.2,37894.0,16450,16700,77030,5,250,2015
385066,5.0,23761.0,12100,16000,65610,2,3900,2015
431920,2.9,88021.0,13600,13600,61450,6,0,2015
507269,1.9,188079.0,1825,1200,80200,13,-625,2015
69114,3.7,61293.0,14850,14500,77030,1,-350,2015
370065,1.9,77170.0,1375,650,64520,11,-725,2015
372017,4.1,38926.0,33400,31000,64520,3,-2400,2015
5546,3.6,11961.0,18600,18500,77030,0,-100,2014
126086,5.0,37708.0,28100,28800,73100,3,700,2015
452973,2.8,127220.0,3050,2300,61490,10,-750,2015
306506,4.3,26466.0,14950,15300,59100,1,350,2015
478140,3.3,40811.0,13250,12500,73130,2,-750,2015
194037,3.6,109403.0,6400,4800,67090,6,-1600,2015
353516,1.9,100584.0,2450,1950,62960,13,-500,2015
22234,2.5,49193.0,10050,11000,77030,7,950,2015
64961,2.7,134044.0,4425,5500,77030,11,1075,2015
150555,3.0,64563.0,9550,9900,73100,2,350,2015
87973,2.5,60020.0,19550,18500,68360,5,-1050,2015
227659,2.5,63895.0,7875,7900,89090,4,25,2015
549738,1.9,93743.0,9775,8300,48460,8,-1475,2015
207160,3.2,37046.0,14950,14300,57290,4,-650,2015
31101,4.3,19308.0,12500,12600,77030,2,100,2015
180205,4.1,35084.0,10750,11400,83200,5,650,2015
271434,3.6,64602.0,10500,10200,59100,3,-300,2015
313711,4.5,42605.0,11250,11300,59100,2,50,2015
376013,4.6,37816.0,17450,17800,64520,3,350,2015
303269,2.6,116926.0,21100,23800,59100,7,2700,2015
148837,4.1,73317.0,20900,21000,73100,4,100,2015
548420,4.3,45024.0,8975,8700,48460,1,-275,2015
349649,2.7,89599.0,3325,4100,62960,9,775,2014
216601,3.0,29500.0,26000,23600,57290,2,-2400,2015
349902,4.3,41255.0,10850,11600,62960,2,750,2014
201543,4.3,20941.0,55600,58400,57290,2,2800,2015
386394,1.9,121047.0,3575,2500,65610,9,-1075,2015
503103,3.3,78031.0,7825,9100,80610,7,1275,2015
120863,,80684.0,2100,1600,73100,16,-500,2014
229460,3.4,53620.0,9625,9500,89090,4,-125,2015
393518,3.1,15779.0,11250,10300,65610,2,-950,2015
215421,3.5,43789.0,10750,10400,57290,2,-350,2015
286315,3.8,111426.0,23700,20500,59100,11,-3200,2015
226325,4.3,7499.0,31300,30600,89090,1,-700,2015
356902,4.3,49972.0,12450,12800,62960,1,350,2015
523668,2.1,108633.0,5100,5500,71660,9,400,2015
338684,1.0,24592.0,15300,8750,82750,2,-6550,2015
126965,4.0,16834.0,35800,38200,73100,1,2400,2015
385837,4.1,68985.0,25500,24600,65610,5,-900,2015
172213,3.7,84479.0,9775,10500,73100,4,725,2015
224913,4.6,23647.0,18100,16400,89090,1,-1700,2015
147971,1.9,210070.0,875,900,73100,10,25,2015
81189,2.0,210916.0,6575,3600,68360,9,-2975,2015
432681,2.0,102207.0,10400,5000,74430,6,-5400,2014
549557,4.0,13224.0,12750,13600,48460,1,850,2015
435881,4.4,15232.0,12750,13200,74430,4,450,2015
56596,4.4,39781.0,47700,47000,77030,2,-700,2015
235455,1.9,147041.0,2450,2500,59100,11,50,2014
517095,1.9,114048.0,1700,1400,71660,12,-300,2015
250324,2.7,66289.0,11200,13300,59100,5,2100,2015
389172,4.1,89910.0,19200,18400,65610,4,-800,2015
92731,4.4,82068.0,5975,7600,68360,8,1625,2015
281934,2.6,52344.0,16800,16800,59100,6,0,2015
126544,2.7,34551.0,17200,15700,73100,4,-1500,2015
459864,2.9,150710.0,2700,2400,61490,9,-300,2015
127254,4.4,31809.0,17450,17700,73100,1,250,2015
387596,4.1,55242.0,12400,13300,65610,5,900,2015
433461,2.7,155615.0,1675,3500,74430,14,1825,2015
317496,4.4,40063.0,11200,11100,73200,2,-100,2015
374629,4.0,25890.0,19800,18300,64520,3,-1500,2015
391496,3.8,110946.0,4850,4100,65610,8,-750,2015
440903,2.8,104987.0,6125,5800,74430,6,-325,2015
146035,4.7,27528.0,21600,20600,73100,3,-1000,2015
467902,3.4,102971.0,3800,5000,61490,12,1200,2015
15951,3.6,47850.0,10850,11500,77030,2,650,2015
164045,4.0,20616.0,9150,9100,73100,3,-50,2015
14957,3.6,144450.0,9750,9500,77030,6,-250,2015
542786,3.7,153069.0,4650,6900,81400,11,2250,2015
493983,1.9,108474.0,4400,5000,73130,6,600,2015
39499,4.4,21488.0,17850,18500,77030,2,650,2015
863,3.5,62345.0,26000,24750,77030,2,-1250,2014
113456,4.1,18364.0,5800,6750,68360,3,950,2015
383023,4.3,73322.0,14250,15400,65610,1,1150,2014
222398,3.1,40208.0,11100,10500,89090,5,-600,2015
385340,4.4,38125.0,13200,12700,65610,2,-500,2015
113954,2.5,34555.0,24500,25100,68360,4,600,2015
37464,3.4,60345.0,16900,17000,77030,2,100,2015
474984,4.5,29848.0,16300,18200,73130,3,1900,2014
254939,4.1,16858.0,23600,23800,59100,1,200,2015
213597,3.0,61273.0,9900,9900,57290,3,0,2015
9410,3.4,132208.0,2875,3800,77030,9,925,2014
538695,3.9,18324.0,11300,11300,55590,1,0,2015
167095,1.9,152886.0,2475,2350,73100,10,-125,2015
34411,2.4,70186.0,6925,6900,77030,11,-25,2015
460268,2.4,79887.0,5275,4600,61490,6,-675,2015
370031,1.9,155141.0,1375,1800,64520,10,425,2015
61909,4.4,11097.0,10350,9750,77030,2,-600,2015
315348,2.0,214623.0,1275,700,59100,19,-575,2015
355413,4.2,28973.0,31300,34000,62960,5,2700,2015
211283,4.6,49007.0,15150,16300,57290,2,1150,2015
323036,2.7,61641.0,13350,12000,82750,3,-1350,2015
153518,3.6,24514.0,12250,12200,73100,2,-50,2015
69213,3.7,59534.0,13150,14900,77030,2,1750,2015
273750,1.9,159358.0,4350,3400,59100,10,-950,2015
380013,2.0,63531.0,13200,11300,64520,13,-1900,2015
266316,2.8,62813.0,12250,11400,59100,3,-850,2015
233028,2.5,39347.0,18900,16000,89090,4,-2900,2015
176630,3.6,55380.0,10300,10301,83200,2,1,2015
427136,4.3,25253.0,23900,24400,61450,3,500,2015
439432,2.8,64952.0,9600,8600,74430,4,-1000,2015
74673,,129680.0,7050,8600,68360,10,1550,2014
253143,3.9,88381.0,6325,9400,59100,8,3075,2015
109568,4.2,23111.0,10450,10400,68360,3,-50,2015
539521,2.0,89367.0,14850,13000,55590,4,-1850,2015
159992,3.9,52457.0,24000,23750,73100,3,-250,2015
403216,3.7,44661.0,17350,18500,61450,4,1150,2015
80765,3.0,63216.0,20900,21400,68360,4,500,2015
346629,2.8,49157.0,9200,8200,82750,2,-1000,2015
83302,2.9,112872.0,6475,6800,68360,10,325,2015
288334,3.9,54125.0,1775,4700,59100,14,2925,2015
437348,2.1,155183.0,2950,1700,74430,8,-1250,2015
545202,3.5,80253.0,22400,23500,81400,5,1100,2015
469000,2.0,211652.0,2075,1900,61490,11,-175,2015
156626,3.7,31620.0,13200,12900,73100,1,-300,2015
90164,4.2,51105.0,16250,16300,68360,2,50,2015
447283,4.3,85845.0,3550,4500,56120,12,950,2015
427422,2.9,141300.0,9900,11000,61450,8,1100,2015
94487,2.0,71210.0,12100,10700,68360,7,-1400,2015
138597,3.1,15527.0,14800,13500,73100,4,-1300,2015
129454,3.9,35734.0,14550,14800,73100,3,250,2015
19375,1.9,128187.0,3075,2000,77030,8,-1075,2015
23546,4.2,54669.0,24200,26700,77030,3,2500,2015
192421,3.4,32833.0,10900,11100,67090,5,200,2015
251065,3.5,144102.0,6575,7500,59100,6,925,2015
207085,4.4,48445.0,18500,20600,57290,3,2100,2015
254438,3.4,138030.0,1325,2200,59100,13,875,2015
169164,4.3,60242.0,42100,42500,73100,4,400,2015
52341,2.7,118998.0,5650,7250,77030,10,1600,2015
343156,3.4,11832.0,12850,13000,82750,2,150,2015
374636,4.3,32008.0,25200,27100,64520,3,1900,2015
332789,3.1,19963.0,12900,12600,82750,3,-300,2015
136715,3.5,25664.0,10800,10500,73100,1,-300,2015
340341,1.9,79609.0,5475,2800,82750,8,-2675,2015
228313,3.4,136056.0,5475,4800,89090,8,-675,2015
388206,4.9,12163.0,18100,18000,65610,1,-100,2015
335316,1.9,140404.0,2100,1800,82750,16,-300,2015
482446,4.2,25929.0,14750,16000,73130,2,1250,2015
185105,2.7,141688.0,2250,1800,63250,9,-450,2015
360671,4.0,62912.0,7350,8200,64520,5,850,2014
42647,4.4,80121.0,8200,11000,77030,6,2800,2015
181221,3.9,34606.0,14350,14600,83200,3,250,2015
507396,3.7,97091.0,18100,17000,80200,4,-1100,2015
472840,4.6,44920.0,20900,21750,62930,2,850,2015
385576,3.4,78770.0,7975,5400,65610,6,-2575,2015
291301,1.9,77268.0,26400,28400,59100,7,2000,2015
294660,4.7,9196.0,14700,14800,59100,3,100,2015
76681,2.2,126029.0,4650,4000,68360,11,-650,2014
303511,3.7,8424.0,12450,12650,59100,2,200,2015
163759,4.1,66929.0,11100,14200,73100,7,3100,2015
509308,3.1,44961.0,15000,14500,71660,1,-500,2015
527666,2.8,78741.0,18800,17700,70210,5,-1100,2015
92261,2.4,44196.0,30600,27000,68360,2,-3600,2015
382654,1.9,103324.0,6975,4100,65610,7,-2875,2014
49276,3.6,21871.0,22300,22750,77030,3,450,2015
167348,2.4,33802.0,13550,11600,73100,2,-1950,2015
76849,4.3,22266.0,21000,22700,68360,1,1700,2014
17265,1.9,133989.0,6900,8300,77030,17,1400,2015
67312,4.0,16129.0,21700,20250,77030,2,-1450,2015
63449,3.9,30659.0,13450,13300,77030,1,-150,2015
294697,3.3,62244.0,4975,5000,59100,9,25,2015
48988,1.9,158114.0,2175,2200,77030,11,25,2015
380450,4.9,17975.0,26900,26800,64520,2,-100,2015
549749,1.9,106555.0,4575,2300,48460,9,-2275,2015
116129,2.3,49981.0,14900,13400,68360,3,-1500,2015
76520,2.7,91200.0,3825,3000,68360,6,-825,2014
541825,4.4,24314.0,23800,23700,81400,3,-100,2015
35816,2.7,113779.0,2800,2600,77030,10,-200,2015
313753,4.2,20413.0,15750,17000,59100,2,1250,2015
424507,2.5,173283.0,10300,12200,61450,7,1900,2015
461015,3.7,117127.0,8600,9600,61490,6,1000,2015
420509,4.3,45391.0,17450,18100,61450,4,650,2015
1720,1.9,64548.0,25600,23500,77030,2,-2100,2014
146668,4.1,33177.0,18400,17800,73100,3,-600,2015
90944,2.4,96777.0,7050,4300,68360,5,-2750,2015
26458,5.0,25981.0,15750,17500,77030,3,1750,2015
207266,4.0,74940.0,12350,13750,57290,6,1400,2015
235963,2.7,333537.0,600,1200,59100,16,600,2014
315776,4.4,57640.0,7250,8200,59100,2,950,2015
401871,1.9,345597.0,1775,1500,61450,18,-275,2015
399514,3.5,145452.0,9200,10000,61450,7,800,2014
419361,3.1,84125.0,12150,13200,61450,9,1050,2015
304754,3.5,115320.0,6850,7000,59100,10,150,2015
154750,4.6,35296.0,35500,37900,73100,2,2400,2015
442365,4.0,31011.0,18250,18200,74430,1,-50,2015
99238,4.9,6191.0,12800,13600,68360,1,800,2015
499923,4.2,26373.0,36200,36500,80610,0,300,2015
6588,3.5,33284.0,28300,28250,77030,2,-50,2014
1852,1.0,28750.0,13500,11200,77030,3,-2300,2015
426684,2.9,135487.0,5775,6800,61450,7,1025,2015
448631,2.8,69087.0,11950,9500,61490,3,-2450,2014
500280,3.9,20449.0,22600,22600,80610,1,0,2015
326099,2.1,190372.0,2250,700,82750,13,-1550,2015
203733,1.0,268448.0,575,400,57290,14,-175,2015
62710,1.9,123482.0,2325,1450,77030,10,-875,2015
27152,1.9,113298.0,1975,2050,77030,10,75,2015
75640,2.9,26570.0,21200,14500,68360,0,-6700,2014
119176,2.7,45125.0,36100,34750,73100,3,-1350,2014
548566,2.3,48719.0,9850,7100,48460,1,-2750,2015
211154,4.3,37833.0,24800,26000,57290,3,1200,2015
285812,3.1,130946.0,5000,3500,59100,9,-1500,2015
70573,4.2,26664.0,15650,17000,77030,2,1350,2015
316354,,110368.0,1075,1000,73200,13,-75,2014
523979,,36815.0,17250,20700,70210,4,3450,2014
302073,1.0,145315.0,7350,3100,59100,8,-4250,2015
426571,3.2,58422.0,16350,15400,61450,3,-950,2015
154024,4.2,126074.0,3125,3700,73100,10,575,2015
221789,3.2,42484.0,41900,42400,57290,3,500,2015
342021,3.9,114373.0,8775,7800,82750,4,-975,2015
309681,3.1,115738.0,5325,4400,59100,7,-925,2015
370620,2.5,174898.0,3025,2400,64520,8,-625,2015
447495,3.6,48452.0,20800,20300,56120,2,-500,2015
356769,3.8,29203.0,11100,11600,62960,1,500,2015
201255,2.0,29461.0,10900,7600,57290,1,-3300,2015
518365,3.4,37997.0,8950,7500,71660,4,-1450,2015
186383,2.1,152753.0,3800,4500,63250,13,700,2015
187600,3.8,59178.0,14450,15000,63250,2,550,2015
119604,4.1,34902.0,17000,16400,73100,3,-600,2014
290103,1.9,110743.0,1100,1000,59100,16,-100,2015
530410,3.7,93262.0,4925,5500,82150,9,575,2015
232780,3.1,121645.0,3575,3400,89090,8,-175,2015
485237,4.4,9534.0,13950,13800,73130,2,-150,2015
219001,4.0,34463.0,11700,11200,57290,3,-500,2015
504771,4.6,11117.0,12150,12600,80610,1,450,2015
425499,3.7,54562.0,10500,13200,61450,3,2700,2015
170630,3.4,55486.0,14100,14300,73100,2,200,2015
257315,5.0,15675.0,20500,19700,59100,0,-800,2015
437828,3.9,101237.0,9975,9100,74430,8,-875,2015
444301,4.0,24017.0,20800,20500,74430,1,-300,2015
185440,2.5,73354.0,7550,7400,63250,4,-150,2015
411114,4.8,13700.0,34000,35250,61450,2,1250,2015
86882,3.6,26525.0,27500,26500,68360,1,-1000,2015
129770,3.7,47219.0,16100,15200,73100,4,-900,2015
279855,1.9,1.0,7350,1200,59100,8,-6150,2015
458004,4.2,41985.0,25400,24300,61490,4,-1100,2015
436578,4.0,60836.0,12100,10200,74430,5,-1900,2015
101640,2.0,195298.0,1650,900,68360,13,-750,2015
215240,2.7,126450.0,2775,3600,57290,9,825,2015
97495,4.0,41619.0,54400,57500,68360,4,3100,2015
222214,,196286.0,1675,1000,89090,12,-675,2014
3086,,76167.0,13000,13100,77030,6,100,2014
400063,4.7,14503.0,19200,17200,61450,2,-2000,2015
20873,3.6,103303.0,10050,9900,77030,7,-150,2015
157034,2.8,44229.0,14000,13800,73100,2,-200,2015
243950,4.3,93201.0,26100,25000,59100,4,-1100,2015
368687,5.0,61678.0,6925,7300,64520,6,375,2015
355289,4.4,16414.0,17550,18500,62960,1,950,2015
542836,3.6,11640.0,40200,40000,81400,0,-200,2015
275844,3.5,119558.0,1875,2600,59100,16,725,2015
93996,4.3,20672.0,9150,9700,68360,1,550,2015
428047,4.3,9335.0,12500,12700,61450,0,200,2015
185402,4.3,56292.0,13700,14500,63250,2,800,2015
6995,3.4,91469.0,4150,5300,77030,7,1150,2014
135676,4.2,11967.0,40400,45750,73100,3,5350,2015
130364,4.1,46480.0,17200,18400,73100,5,1200,2015
464945,3.7,163116.0,5075,5200,61490,11,125,2015
36389,4.2,98219.0,17200,16100,77030,8,-1100,2015
119890,4.8,2768.0,22900,24300,73100,0,1400,2014
270669,5.0,14757.0,11400,10300,59100,1,-1100,2015
441848,4.7,38472.0,25400,26800,74430,4,1400,2015
4760,3.2,113104.0,4900,5100,77030,12,200,2014
263234,2.5,11887.0,13500,12400,59100,1,-1100,2015
505255,4.6,15906.0,23700,23800,80610,0,100,2015
315365,4.7,13111.0,16200,15500,59100,1,-700,2015
160386,4.1,58703.0,19350,21500,73100,5,2150,2015
397441,4.0,62265.0,8625,9100,65610,3,475,2015
50597,4.6,11818.0,24600,26000,77030,2,1400,2015
96691,2.2,30535.0,20400,20000,68360,3,-400,2015
118069,4.1,33582.0,24100,22800,68360,0,-1300,2015
154362,4.3,62377.0,22200,23750,73100,4,1550,2015
549076,2.0,132853.0,2725,2300,48460,9,-425,2015
401657,2.9,19480.0,22600,21250,61450,3,-1350,2015
437317,4.2,11445.0,15950,15000,74430,5,-950,2015
387536,3.3,58467.0,10150,9200,65610,3,-950,2015
110938,2.9,43117.0,21800,22900,68360,2,1100,2015
74706,,136521.0,1725,1800,68360,10,75,2014
262761,2.0,36340.0,14950,12500,59100,1,-2450,2015
282472,1.2,149479.0,2750,2500,59100,13,-250,2015
402233,2.1,164664.0,2875,2900,61450,12,25,2015
120701,1.9,92807.0,3875,2300,73100,10,-1575,2014
93087,3.1,41203.0,10700,11600,68360,3,900,2015
49419,3.7,23321.0,23300,23750,77030,2,450,2015
296835,4.5,21684.0,24100,23500,59100,1,-600,2015
234255,3.3,180204.0,4650,4400,59100,7,-250,2014
265957,5.0,27176.0,33000,36000,59100,2,3000,2015
445239,1.9,176542.0,4100,4000,56120,12,-100,2015
517900,3.9,61835.0,5650,4500,71660,6,-1150,2015
301727,1.9,165539.0,2325,1300,59100,8,-1025,2015
380102,4.2,42462.0,15350,15200,64520,3,-150,2015
161292,4.8,42690.0,9575,11300,73100,4,1725,2015
189483,2.7,51482.0,12750,11500,63250,5,-1250,2015
481148,3.0,50308.0,10000,9500,73130,3,-500,2015
173399,2.2,90806.0,4775,5300,83200,8,525,2014
48819,4.1,9199.0,26000,24500,77030,0,-1500,2015
283302,3.0,68349.0,11750,12000,59100,4,250,2015
368649,3.7,77215.0,8050,8300,64520,4,250,2015
393200,2.6,86117.0,17350,14600,65610,4,-2750,2015
281048,4.8,13545.0,13550,14200,59100,3,650,2015
142101,3.5,36093.0,17100,16800,73100,2,-300,2015
326701,2.4,179517.0,4175,3200,82750,10,-975,2015
392730,4.4,31970.0,18300,18300,65610,1,0,2015
128665,2.8,87116.0,14800,15900,73100,7,1100,2015
181476,4.8,40349.0,18400,20200,83200,3,1800,2015
399682,1.9,81340.0,5800,6600,61450,9,800,2014
68321,4.7,49032.0,27900,28250,77030,7,350,2015
11731,2.1,38376.0,25100,26250,77030,3,1150,2014
411344,3.4,36911.0,19850,17200,61450,3,-2650,2015
56022,1.9,201300.0,2000,3300,77030,10,1300,2015
115587,4.1,50117.0,10700,10800,68360,3,100,2015
4936,2.0,129016.0,1575,1500,77030,13,-75,2014
324409,2.3,91364.0,3475,3100,82750,7,-375,2015
408235,4.9,16293.0,31000,31800,61450,1,800,2015
451123,1.9,115674.0,7625,5900,61490,5,-1725,2015
43201,4.3,14379.0,15250,13700,77030,1,-1550,2015
211069,3.6,46419.0,9525,9000,57290,5,-525,2015
491995,3.5,32608.0,10900,10200,73130,1,-700,2015
133376,4.0,13065.0,17200,17000,73100,1,-200,2015
427402,3.6,87104.0,8525,7600,61450,6,-925,2015
164547,3.9,26098.0,14000,14500,73100,3,500,2015
499249,4.2,26843.0,35700,34800,80610,1,-900,2015
30763,3.7,57912.0,12250,12300,77030,2,50,2015
100562,3.1,93477.0,7000,8100,68360,9,1100,2015
515276,3.5,59868.0,13500,13600,71660,4,100,2015
70915,3.0,94597.0,6950,6800,77030,4,-150,2015
284656,4.5,34466.0,12350,12400,59100,3,50,2015
165311,3.3,39848.0,13400,12600,73100,2,-800,2015
533094,2.1,77040.0,11200,9900,82150,6,-1300,2015
226584,2.0,182530.0,1200,500,89090,16,-700,2015
506026,4.2,49353.0,8275,9100,80200,4,825,2015
493278,3.0,22929.0,34400,33250,73130,1,-1150,2015
159457,4.3,27849.0,28000,27500,73100,1,-500,2015
183202,2.0,140121.0,3050,3100,63250,13,50,2014
77911,2.0,46565.0,12200,11100,68360,1,-1100,2014
374684,2.6,118650.0,7775,5600,64520,6,-2175,2015
384483,4.4,30588.0,18900,20900,65610,1,2000,2015
454861,1.9,115016.0,5425,3400,61490,9,-2025,2015
259500,3.1,87712.0,8800,9200,59100,2,400,2015
329983,4.9,3361.0,45600,42500,82750,1,-3100,2015
68754,4.0,58562.0,8825,8800,77030,2,-25,2015
433411,,100249.0,1950,1800,74430,12,-150,2014
145590,2.5,175987.0,1575,1700,73100,13,125,2015
285712,3.9,62644.0,25700,24800,59100,7,-900,2015
138308,3.0,11331.0,17350,17700,73100,1,350,2015
406318,2.9,78544.0,3425,3000,61450,8,-425,2015
54692,3.4,110815.0,12600,13200,77030,5,600,2015
467339,5.0,8935.0,40800,41000,61490,0,200,2015
10566,4.2,58690.0,11100,12750,77030,3,1650,2014
293363,1.9,69898.0,13000,10800,59100,7,-2200,2015
144362,1.9,92346.0,7975,6900,73100,6,-1075,2015
365403,4.8,23260.0,15400,16300,64520,4,900,2015
379400,5.0,10344.0,20600,20300,64520,0,-300,2015
356915,2.0,114864.0,6425,7500,62960,9,1075,2015
35405,3.0,142454.0,1450,1700,77030,12,250,2015
238396,2.6,77180.0,12300,11900,59100,8,-400,2014
355588,3.6,113074.0,9100,8400,62960,8,-700,2015
507770,2.1,127361.0,3475,2200,80200,9,-1275,2015
273047,3.1,112212.0,1500,2600,59100,12,1100,2015
37089,1.9,98310.0,9475,9000,77030,9,-475,2015
491682,4.0,29150.0,12700,12000,73130,3,-700,2015
185137,1.9,191305.0,1325,1000,63250,13,-325,2015
166120,4.8,34245.0,19350,21400,73100,3,2050,2015
48084,4.2,28002.0,24400,27500,77030,4,3100,2015
176119,3.6,125689.0,2975,4700,83200,12,1725,2015
453732,2.0,171447.0,2025,1150,61490,15,-875,2015
284755,4.4,22051.0,11250,11400,59100,3,150,2015
427407,2.8,126295.0,6275,6800,61450,7,525,2015
154425,4.3,107910.0,19650,19800,73100,5,150,2015
24120,4.2,40943.0,11000,11400,77030,2,400,2015
281013,2.5,52103.0,11650,10000,59100,3,-1650,2015
128411,5.0,9986.0,13550,14600,73100,1,1050,2015
63073,2.0,56719.0,11650,9500,77030,2,-2150,2015
40982,3.8,19692.0,13950,13250,77030,2,-700,2015
113529,2.0,74803.0,6600,5800,68360,8,-800,2015
299940,2.0,40850.0,20200,18000,59100,2,-2200,2015
196519,2.8,83561.0,17350,16600,67090,3,-750,2015
88888,4.0,45483.0,11800,11800,68360,2,0,2015
34559,2.7,178479.0,4675,3900,77030,13,-775,2015
346845,3.5,33384.0,12650,12500,82750,3,-150,2015
459227,3.7,124052.0,9250,8900,61490,3,-350,2015
263470,4.4,35348.0,26700,24300,59100,3,-2400,2015
69604,1.9,9358.0,22100,21000,77030,3,-1100,2015
279729,3.6,67661.0,10300,11000,59100,4,700,2015
111411,2.0,110728.0,5625,5100,68360,11,-525,2015
484893,4.4,25174.0,20000,19800,73130,1,-200,2015
394304,3.7,50618.0,17450,15100,65610,7,-2350,2015
120689,,64833.0,7675,7100,73100,10,-575,2014
200834,4.8,25831.0,24000,27000,67090,2,3000,2015
426248,4.8,17158.0,12400,13600,61450,2,1200,2015
442426,4.0,14663.0,15350,15000,74430,0,-350,2015
504150,4.3,28680.0,20700,20800,80610,2,100,2015
68401,4.1,113398.0,6450,7750,77030,9,1300,2015
270686,2.9,25455.0,14250,14000,59100,1,-250,2015
324330,4.6,48911.0,9875,11000,82750,3,1125,2015
80746,3.4,56288.0,10200,9500,68360,4,-700,2015
521892,4.2,40739.0,18050,19800,71660,3,1750,2015
131400,3.6,75260.0,20100,19500,73100,6,-600,2015
302820,3.3,47768.0,13700,13100,59100,2,-600,2015
533427,2.5,132784.0,1750,1400,82150,10,-350,2015
512980,3.5,47094.0,6600,6900,71660,6,300,2015
390009,4.3,48672.0,12800,13700,65610,5,900,2015
283375,4.0,28947.0,19200,19600,59100,1,400,2015
86353,1.9,104714.0,2550,2600,68360,10,50,2015
433522,2.4,238173.0,1525,500,74430,14,-1025,2014
151742,4.7,27213.0,22000,22000,73100,2,0,2015
16790,4.1,63355.0,16150,17300,77030,4,1150,2015
308340,4.6,43940.0,3850,5900,59100,11,2050,2015
251611,3.2,37393.0,11150,11300,59100,4,150,2015
233036,2.5,182202.0,4500,2900,89090,11,-1600,2015
374443,3.8,32565.0,14850,14500,64520,3,-350,2015
312448,4.0,38784.0,13300,14000,59100,3,700,2015
81552,3.6,24260.0,13850,12600,68360,3,-1250,2015
252839,4.0,15699.0,19150,19100,59100,1,-50,2015
521749,4.4,8741.0,17650,19000,71660,1,1350,2015
50599,4.2,11486.0,22500,23000,77030,2,500,2015
522676,2.3,63941.0,7550,7000,71660,4,-550,2015
320081,3.4,67076.0,19300,16500,82750,3,-2800,2014
482660,3.9,31746.0,17550,17300,73130,3,-250,2015
275812,2.2,85317.0,5125,4500,59100,8,-625,2015
515109,4.0,29656.0,15950,15800,71660,2,-150,2015
305357,4.2,4373.0,21700,19800,59100,0,-1900,2015
21295,2.1,153329.0,6100,6000,77030,10,-100,2015
315247,4.0,105798.0,3750,3600,59100,8,-150,2015
486463,2.7,50638.0,12950,11000,73130,2,-1950,2015
36759,4.1,74947.0,21500,22000,77030,4,500,2015
358861,3.2,83418.0,10900,9700,62960,4,-1200,2015
530132,3.8,187468.0,9750,8100,82150,2,-1650,2014
21740,4.6,8047.0,73000,75000,77030,1,2000,2015
10585,2.9,37735.0,8050,7900,77030,3,-150,2014
403495,3.3,34298.0,11550,11800,61450,1,250,2015
47652,4.4,31324.0,15500,15900,77030,2,400,2015
410442,2.5,42581.0,20900,19500,61450,4,-1400,2015
395496,3.7,107680.0,21600,21000,65610,4,-600,2015
424068,3.3,70358.0,13750,12900,61450,2,-850,2015
313368,3.7,5753.0,15650,15000,59100,1,-650,2015
473678,3.0,117881.0,6500,7000,62930,8,500,2015
517487,3.4,37065.0,21700,21900,71660,1,200,2015
376898,2.4,21371.0,17150,14700,64520,3,-2450,2015
471244,2.0,17555.0,11200,8400,62930,1,-2800,2015
180523,4.1,18626.0,23800,24300,83200,2,500,2015
239593,3.6,25514.0,14200,16000,59100,1,1800,2014
397114,4.1,50690.0,11900,12800,65610,2,900,2015
217998,1.0,5638.0,16600,7900,57290,0,-8700,2015
307416,3.5,259680.0,12100,10700,59100,6,-1400,2015
178804,4.0,13046.0,18550,18100,83200,1,-450,2015
428456,2.2,216028.0,600,1800,61450,9,1200,2015
394454,3.3,161396.0,1575,2500,65610,11,925,2015
347555,1.9,176678.0,2125,1950,82750,9,-175,2015
252923,2.5,31069.0,9300,7600,59100,4,-1700,2015
382378,2.9,44396.0,8050,7700,65610,5,-350,2014
46922,4.9,95265.0,14550,13700,77030,3,-850,2015
384046,5.0,22474.0,16700,17400,65610,1,700,2015
223049,3.7,51714.0,7600,8000,89090,3,400,2015
148893,4.4,79504.0,24200,24700,73100,5,500,2015
141692,3.5,17864.0,18300,15800,73100,5,-2500,2015
107695,3.9,33337.0,13400,13500,68360,1,100,2015
470050,3.8,36687.0,17650,17700,61490,1,50,2015
257099,3.5,49567.0,27000,27200,59100,7,200,2015
77971,3.0,39560.0,12500,12500,68360,3,0,2015
444069,2.3,231335.0,1150,1550,74430,13,400,2015
478072,4.8,34316.0,23300,26100,73130,3,2800,2015
252044,1.9,86005.0,8025,6000,59100,12,-2025,2015
136704,4.5,23468.0,18850,19600,73100,3,750,2015
133199,3.0,31755.0,18100,17000,73100,1,-1100,2015
43959,4.6,44753.0,81000,79000,77030,2,-2000,2015
198689,3.4,131736.0,37800,29000,67090,3,-8800,2015
292963,1.9,52365.0,12000,6100,59100,3,-5900,2015
32422,2.4,77142.0,3875,800,77030,12,-3075,2015
549429,4.3,52145.0,11100,12400,48460,2,1300,2015
236223,3.3,30509.0,17700,17500,59100,1,-200,2014
522083,4.2,14796.0,16650,17600,71660,2,950,2015
348745,4.4,21485.0,9775,10500,62960,2,725,2014
488744,4.0,17851.0,15950,17100,73130,1,1150,2015
445930,3.3,96227.0,4550,5500,56120,13,950,2015
388340,4.9,6245.0,15600,16000,65610,2,400,2015
471916,3.9,62838.0,9275,8800,62930,4,-475,2015
415959,4.0,60504.0,11650,11800,61450,2,150,2015
544769,3.9,7503.0,27300,28750,81400,1,1450,2015
62892,2.6,36876.0,10700,10500,77030,2,-200,2015
511787,4.2,9427.0,13450,13300,71660,3,-150,2015
108175,2.1,33029.0,11550,8700,68360,2,-2850,2015
16675,3.5,41461.0,17700,18700,77030,4,1000,2015
15129,3.4,133178.0,7825,9300,77030,8,1475,2015
359733,4.1,58705.0,25000,26250,62960,5,1250,2015
264065,4.4,32801.0,10400,10200,59100,4,-200,2015
304525,2.7,72888.0,20900,18300,59100,2,-2600,2015
445524,3.1,32879.0,19550,18000,56120,4,-1550,2015
355300,4.3,6752.0,14200,15300,62960,1,1100,2015
113756,5.0,64225.0,32500,34400,68360,4,1900,2015
298504,4.2,31652.0,27800,29200,59100,2,1400,2015
428725,4.1,42796.0,10250,10900,61450,3,650,2015
472805,2.8,106584.0,13050,12000,62930,7,-1050,2015
440112,4.4,40811.0,13200,13300,74430,2,100,2015
187527,3.6,63633.0,8975,10200,63250,7,1225,2015
499851,2.2,112658.0,3450,3300,80610,9,-150,2015
425959,4.0,62589.0,11450,10700,61450,2,-750,2015
172722,4.0,51144.0,24400,23000,73100,4,-1400,2015
499638,3.0,40461.0,12750,12800,80610,1,50,2015
55953,3.8,92872.0,14600,17900,77030,8,3300,2015
413971,3.5,27778.0,19800,17300,61450,1,-2500,2015
183903,3.6,47775.0,9875,10700,63250,2,825,2015
164731,3.9,23812.0,11200,10800,73100,2,-400,2015
316825,2.6,65091.0,14000,12900,73200,2,-1100,2015
211280,4.8,50247.0,25400,25500,57290,2,100,2015
356806,3.9,37003.0,9900,10100,62960,2,200,2015
358281,2.7,134760.0,16450,16200,62960,8,-250,2015
39715,2.2,40287.0,10950,11500,77030,3,550,2015
436323,2.9,94865.0,1225,2300,74430,14,1075,2015
77641,1.0,122696.0,3800,2200,68360,8,-1600,2015
201103,1.9,69667.0,22400,20500,57290,4,-1900,2015
12556,3.6,104185.0,9875,9000,77030,7,-875,2015
326819,4.9,5691.0,28000,26200,82750,1,-1800,2015
447004,4.8,41750.0,17100,17300,56120,2,200,2015
175786,4.3,54859.0,14300,15300,83200,3,1000,2015
378864,4.2,85386.0,15000,17200,64520,6,2200,2015
6754,4.5,64200.0,30500,30000,77030,4,-500,2014
268973,1.9,100763.0,10000,8500,59100,9,-1500,2015
423306,3.2,96765.0,9050,7200,61450,3,-1850,2015
259118,2.9,116002.0,5800,5400,59100,5,-400,2015
192854,1.9,129553.0,1550,900,67090,9,-650,2015
187624,3.2,70381.0,17850,18300,63250,4,450,2015
182730,,94522.0,5575,5800,63250,7,225,2014
500860,4.7,13394.0,16500,17300,80610,1,800,2015
298909,2.1,145863.0,3150,1200,59100,9,-1950,2015
309797,3.7,25875.0,23100,23400,59100,3,300,2015
325764,1.9,64610.0,9125,7800,82750,5,-1325,2015
545091,3.5,34744.0,10550,10500,81400,2,-50,2015
110518,4.1,69811.0,13050,10800,68360,6,-2250,2015
301420,4.2,36836.0,16800,16800,59100,3,0,2015
418339,3.9,103658.0,12450,11500,61450,5,-950,2015
311109,1.9,109258.0,6050,3100,59100,11,-2950,2015
180740,3.5,47762.0,9600,10800,83200,2,1200,2015
258733,4.8,20904.0,10850,11000,59100,3,150,2015
477487,3.7,43576.0,16850,16400,73130,3,-450,2015
177452,5.0,13188.0,24100,23800,83200,1,-300,2015
233011,3.3,80031.0,12350,13000,89090,7,650,2015
369111,4.4,36918.0,20000,19300,64520,4,-700,2015
30536,2.7,135883.0,1100,500,77030,15,-600,2015
15145,2.6,160836.0,9725,8900,77030,8,-825,2015
76541,3.6,103467.0,14250,15400,68360,7,1150,2014
76876,3.5,29294.0,35100,35600,68360,2,500,2015
257192,1.9,144185.0,3050,2900,59100,10,-150,2015
346490,2.8,222068.0,200,200,82750,13,0,2015
371236,4.8,12632.0,14150,13600,64520,1,-550,2015
87,4.1,37938.0,12950,13700,77030,0,750,2014
448064,4.3,38006.0,10450,8900,56120,6,-1550,2015
33193,3.5,75518.0,9800,11200,77030,3,1400,2015
32981,3.8,25659.0,11800,15250,77030,2,3450,2015
195459,1.9,124180.0,3525,1500,67090,10,-2025,2015
121146,4.7,11787.0,12050,12000,73100,1,-50,2014
534242,3.9,91746.0,6850,6300,82150,8,-550,2015
417956,4.4,11455.0,15450,16000,61450,1,550,2015
328733,2.6,116397.0,5550,5950,82750,8,400,2015
139559,2.6,49345.0,15500,13500,73100,4,-2000,2015
114771,4.3,124605.0,11750,10000,68360,9,-1750,2015
69339,2.0,232298.0,1375,1000,77030,12,-375,2015
1704,3.1,60981.0,27000,26250,77030,2,-750,2014
233585,3.0,60171.0,10100,10500,59100,5,400,2015
342041,2.3,183698.0,4625,2100,82750,11,-2525,2015
342638,4.1,8664.0,25400,25000,82750,2,-400,2015
262142,4.7,33902.0,16200,17700,59100,1,1500,2015
283527,2.7,84117.0,7825,8100,59100,8,275,2015
259688,4.4,23439.0,28100,26700,59100,2,-1400,2015
295801,4.1,45311.0,26700,28800,59100,3,2100,2015
343681,2.5,145381.0,6250,5800,82750,9,-450,2015
458800,2.4,222100.0,2225,2400,61490,16,175,2015
179586,4.9,8405.0,21100,21000,83200,0,-100,2015
315856,4.4,78738.0,29500,30200,59100,4,700,2015
94267,4.0,48293.0,9900,11500,68360,3,1600,2015
191546,4.2,18315.0,38800,36700,67090,1,-2100,2014
443517,4.6,41183.0,11000,10800,74430,1,-200,2015
319978,4.1,62466.0,18900,23500,73200,8,4600,2015
338532,2.5,36802.0,17950,17000,82750,4,-950,2015
130650,4.7,78108.0,25900,23000,73100,2,-2900,2015
279318,4.2,14285.0,15600,14200,59100,1,-1400,2015
3726,2.9,125336.0,3225,2500,77030,9,-725,2015
172419,4.3,32710.0,50800,51750,73100,3,950,2015
268677,3.8,22027.0,15950,16300,59100,4,350,2015
514639,2.1,123072.0,12500,6000,71660,5,-6500,2015
349343,3.7,65243.0,12250,12600,62960,0,350,2014
5003,,209631.0,1050,1700,77030,12,650,2014
154278,4.7,31092.0,18750,19800,73100,3,1050,2015
165479,3.1,55109.0,15850,15500,73100,2,-350,2015
325763,4.6,27986.0,23400,22800,82750,1,-600,2015
358259,3.5,44440.0,22500,23000,62960,5,500,2015
375893,2.6,122248.0,3025,3800,64520,8,775,2015
518338,4.1,29708.0,12650,13000,71660,3,350,2015
280695,2.0,132362.0,1600,2000,59100,11,400,2015
216644,4.5,15122.0,23000,25700,57290,2,2700,2015
127876,3.7,33279.0,12850,13200,73100,3,350,2015
31825,4.8,26179.0,20100,24250,77030,4,4150,2015
486685,2.8,73557.0,15100,14700,73130,6,-400,2015
276926,4.0,20889.0,19700,19200,59100,1,-500,2015
45533,1.0,36484.0,11250,1800,77030,2,-9450,2015
106833,1.9,37215.0,9625,7000,68360,5,-2625,2015
325158,4.3,34233.0,9150,9800,82750,4,650,2015
166694,3.6,72955.0,27000,27000,73100,4,0,2015
296790,3.2,96369.0,2400,2600,59100,10,200,2015
90785,4.0,105420.0,24600,20600,68360,4,-4000,2015
285092,2.5,116548.0,4125,3000,59100,9,-1125,2015
304703,4.6,13982.0,15200,15200,59100,1,0,2015
384551,5.0,71727.0,15200,15200,65610,3,0,2015
425162,2.1,38221.0,11500,10200,61450,3,-1300,2015
66717,3.1,62114.0,13000,12800,77030,2,-200,2015
465313,2.6,83393.0,15500,14000,61490,6,-1500,2015
232805,1.0,104598.0,7225,2400,89090,10,-4825,2015
157164,3.5,22588.0,22400,21400,73100,3,-1000,2015
315771,4.2,60446.0,8850,8900,59100,2,50,2015
208160,3.7,21359.0,27300,28500,57290,2,1200,2015
266149,3.4,37581.0,18850,19700,59100,2,850,2015
534538,4.8,24252.0,13800,13400,82150,1,-400,2015
95942,1.9,83236.0,26300,18250,68360,3,-8050,2015
246535,3.0,6346.0,13100,12800,59100,1,-300,2015
116925,3.6,145513.0,15400,16800,68360,4,1400,2015
441269,2.0,128618.0,4700,4600,74430,11,-100,2015
21878,2.8,42997.0,10450,10600,77030,2,150,2015
328420,3.9,32031.0,26100,25250,82750,3,-850,2015
383897,4.3,52806.0,14500,17100,65610,3,2600,2014
24218,4.1,36745.0,11900,13400,77030,2,1500,2015
394883,5.0,7925.0,20100,19300,65610,0,-800,2015
186654,2.0,38843.0,21400,13400,63250,2,-8000,2015
177488,3.5,39256.0,10300,10200,83200,3,-100,2015
421986,2.4,27219.0,18400,17000,61450,3,-1400,2015
367079,4.3,134267.0,16450,14600,64520,4,-1850,2015
324792,4.4,2951.0,33400,35500,82750,1,2100,2015
283690,3.6,5997.0,26300,27500,59100,1,1200,2015
388368,5.0,20462.0,19200,19200,65610,2,0,2015
388470,4.5,56803.0,9725,9700,65610,2,-25,2015
378819,3.9,73475.0,11050,12100,64520,4,1050,2015
362523,5.0,9264.0,30900,30500,64520,0,-400,2014
537237,4.4,33972.0,9075,9200,73640,2,125,2015
354889,2.5,101724.0,3975,5700,62960,9,1725,2015
269354,2.9,33851.0,18400,17500,59100,2,-900,2015
216306,4.5,16966.0,16950,17300,57290,2,350,2015
372938,3.1,127521.0,8400,7700,64520,5,-700,2015
530843,2.8,127854.0,4375,4400,82150,8,25,2015
305639,4.2,49166.0,8800,9000,59100,2,200,2015
451945,3.0,73224.0,7550,5000,61490,8,-2550,2015
113961,3.4,96154.0,27700,27500,68360,4,-200,2015
250982,2.5,105115.0,2400,2400,59100,15,0,2015
352456,3.7,18328.0,15300,15300,62960,1,0,2015
412883,3.9,85256.0,9800,11000,61450,4,1200,2015
342343,4.2,28014.0,17300,18000,82750,2,700,2015
538429,3.4,60175.0,18400,18200,55590,2,-200,2015
89912,1.0,303584.0,1850,1600,68360,13,-250,2015
425152,4.7,12082.0,18350,17600,61450,3,-750,2015
278143,4.0,37967.0,12950,12800,59100,2,-150,2015
89834,4.5,25567.0,15150,15100,68360,1,-50,2015
546127,3.0,140739.0,5250,4700,81400,10,-550,2015
498943,3.3,64593.0,21500,18200,80610,3,-3300,2014
449879,,119166.0,1550,1350,61490,12,-200,2014
514531,4.6,74905.0,9550,8800,71660,3,-750,2015
446699,3.5,98960.0,18150,18200,56120,7,50,2015
19224,3.5,35898.0,9100,9250,77030,4,150,2015
87978,4.5,73999.0,15250,15800,68360,6,550,2015
281405,4.6,29636.0,14950,16400,59100,2,1450,2015
402677,3.8,85978.0,14800,14700,61450,7,-100,2015
389247,4.0,20702.0,19350,19500,65610,1,150,2015
542295,3.6,40339.0,28700,28700,81400,1,0,2015
217463,1.9,127921.0,4200,3800,57290,6,-400,2015
459954,3.9,210719.0,1200,1700,61490,12,500,2015
247041,3.2,41758.0,16950,16800,59100,2,-150,2015
153571,1.9,13968.0,28900,26000,73100,3,-2900,2015
45605,2.6,12773.0,18400,16900,77030,2,-1500,2015
430710,3.3,74274.0,6575,6800,61450,10,225,2015
188257,4.1,39090.0,11350,12000,63250,2,650,2015
116971,3.6,109199.0,11350,11500,68360,5,150,2015
243637,3.9,28087.0,10900,11400,59100,3,500,2015
352337,4.3,16458.0,11150,12500,62960,1,1350,2015
424677,3.4,52574.0,8900,9500,61450,2,600,2015
408103,4.9,58815.0,20900,22800,61450,4,1900,2015
87215,3.4,112502.0,7925,9100,68360,7,1175,2015
66139,2.9,22624.0,11250,10800,77030,2,-450,2015
104897,4.7,37025.0,29500,30600,68360,4,1100,2015
426226,5.0,16403.0,23000,25100,61450,1,2100,2015
266525,3.6,105568.0,16500,16500,59100,5,0,2015
102403,4.8,20332.0,27900,27600,68360,1,-300,2015
106587,5.0,40873.0,50400,50500,68360,3,100,2015
193747,3.6,39909.0,18400,18500,67090,2,100,2015
296877,3.9,65984.0,10950,10500,59100,2,-450,2015
469758,2.8,48548.0,9900,9900,61490,2,0,2015
321595,2.7,114418.0,9075,7250,82750,8,-1825,2015
370918,3.5,54122.0,9275,9200,64520,3,-75,2015
480623,2.5,45099.0,9200,9700,73130,3,500,2015
527980,4.4,21586.0,29400,20600,70210,2,-8800,2015
348448,2.0,239906.0,700,700,62960,17,0,2014
165452,5.0,21483.0,28600,29750,73100,2,1150,2015
50167,1.0,149588.0,3450,3100,77030,19,-350,2015
411982,1.9,201049.0,1850,2300,61450,8,450,2015
5887,4.3,6017.0,29700,24750,77030,0,-4950,2014
211453,3.7,41551.0,26900,25400,57290,1,-1500,2015
298240,4.1,10245.0,6325,6100,59100,3,-225,2015
239914,4.1,59472.0,10400,10700,59100,2,300,2014
435166,2.1,74881.0,7000,6800,74430,7,-200,2015
136377,3.9,39952.0,13200,13600,73100,3,400,2015
319501,4.3,33381.0,17500,18000,73200,1,500,2015
379786,3.5,98128.0,16550,17000,64520,6,450,2015
14177,3.7,43747.0,10150,10100,77030,2,-50,2015
193466,2.7,81800.0,11700,12000,67090,5,300,2015
450655,3.0,121992.0,600,900,61490,18,300,2014
423482,4.1,10257.0,12150,12000,61450,1,-150,2015
49889,2.1,123711.0,7550,5900,77030,9,-1650,2015
48575,4.7,14226.0,45200,46500,77030,1,1300,2015
96657,4.4,19281.0,50900,50000,68360,1,-900,2015
263260,4.6,32067.0,20700,22800,59100,3,2100,2015
487073,4.4,12303.0,23500,22200,73130,1,-1300,2015
417850,2.7,86294.0,8225,7650,61450,8,-575,2015
464665,3.3,93948.0,6625,8600,61490,4,1975,2015
430988,4.3,42132.0,12250,12800,61450,2,550,2015
489671,2.1,49547.0,11400,10100,73130,3,-1300,2015
169469,4.0,92935.0,14050,13700,73100,7,-350,2015
508045,4.3,66534.0,22500,24400,71660,6,1900,2014
243609,4.3,15768.0,24000,24000,59100,3,0,2015
312863,1.9,126265.0,2950,2600,59100,8,-350,2015
471046,1.0,1.0,15750,5500,62930,1,-10250,2014
414321,4.9,16964.0,24700,27000,61450,1,2300,2015
413379,4.4,21710.0,65000,63750,61450,2,-1250,2015
68719,3.3,140077.0,1500,1400,77030,16,-100,2015
471106,3.0,23804.0,27700,25600,62930,0,-2100,2014
451911,4.1,143048.0,3025,3300,61490,7,275,2015
458240,2.3,93948.0,4750,4000,61490,7,-750,2015
495795,1.9,50196.0,11250,10800,73130,2,-450,2015
10844,1.9,157776.0,5775,5500,77030,7,-275,2014
342919,2.0,96499.0,8150,5700,82750,5,-2450,2015
511611,2.7,48556.0,14100,13100,71660,2,-1000,2015
436949,2.8,124844.0,3250,4500,74430,13,1250,2015
533362,3.5,91865.0,10250,9000,82150,7,-1250,2015
444231,4.9,44212.0,21000,22600,74430,3,1600,2015
448459,3.4,52280.0,10000,10200,56120,2,200,2015
224288,1.9,120620.0,3350,3000,89090,9,-350,2015
10581,4.2,70772.0,23200,24250,77030,3,1050,2014
468005,2.1,48954.0,9950,7600,61490,3,-2350,2015
53789,2.4,56317.0,9150,9000,77030,2,-150,2015
179698,3.7,77077.0,12250,12200,83200,2,-50,2015
500693,1.9,104832.0,4225,2800,80610,7,-1425,2015
485896,3.0,19224.0,11850,15500,73130,1,3650,2015
280954,2.3,62409.0,16800,16400,59100,2,-400,2015
363798,3.4,33573.0,10450,8700,64520,3,-1750,2015
143028,4.8,33404.0,19550,17900,73100,1,-1650,2015
193161,2.8,33112.0,23100,22000,67090,4,-1100,2015
334922,3.7,21802.0,14400,13200,82750,3,-1200,2015
438848,4.1,75795.0,9775,13500,74430,6,3725,2015
465605,3.5,204889.0,2750,1600,61490,13,-1150,2015
173298,4.3,47837.0,6425,6800,83200,7,375,2014
399993,3.7,17109.0,15500,14800,61450,1,-700,2015
400815,3.8,18496.0,13500,13500,61450,2,0,2014
22837,4.6,8384.0,24100,23800,77030,0,-300,2015
44771,3.5,71740.0,10500,11900,77030,3,1400,2015
178699,4.0,15000.0,20000,20800,83200,1,800,2015
12357,3.7,9800.0,15900,15500,77030,2,-400,2015
319538,3.8,19391.0,16400,16500,73200,0,100,2015
193548,2.7,111082.0,2850,2800,67090,10,-50,2015
320220,2.0,111689.0,5875,4900,82750,6,-975,2015
373651,4.3,47689.0,16750,19100,64520,3,2350,2015
209440,4.8,1646.0,24700,24500,57290,1,-200,2015
403049,4.5,37133.0,12800,12500,61450,1,-300,2015
138160,4.0,25943.0,18800,18200,73100,1,-600,2015
519489,2.8,241904.0,200,1200,71660,11,1000,2015
108223,1.9,58183.0,25000,21000,68360,2,-4000,2015
333100,1.9,186270.0,1100,1000,82750,14,-100,2015
366600,4.6,62045.0,13800,13500,64520,5,-300,2015
43640,3.6,123769.0,18400,19000,77030,7,600,2015
139146,3.6,13759.0,11550,11000,73100,3,-550,2015
141488,4.8,22065.0,40100,40400,73100,3,300,2015
9061,3.0,145063.0,2575,3500,77030,5,925,2014
220931,3.9,11123.0,12650,12900,57290,3,250,2015
400812,2.9,134926.0,7775,5800,61450,2,-1975,2014
398758,3.4,107868.0,2150,4100,61450,16,1950,2014
245056,3.8,52227.0,47400,45300,59100,3,-2100,2015
456391,3.1,145347.0,4925,5600,61490,7,675,2015
70360,3.0,22020.0,11300,11500,77030,2,200,2015
154408,4.1,57923.0,19550,20500,73100,4,950,2015
422485,2.5,13388.0,13700,11800,61450,1,-1900,2015
544266,2.3,101457.0,3150,5300,81400,10,2150,2015
396181,4.7,21699.0,26600,26700,65610,2,100,2015
131620,4.1,48477.0,9225,8800,73100,3,-425,2015
398937,4.5,10442.0,27800,27900,61450,1,100,2014
50240,4.4,12149.0,44700,45000,77030,1,300,2015
362381,1.0,107264.0,1550,325,64520,14,-1225,2015
496038,4.4,32147.0,17800,17100,73130,1,-700,2015
363284,4.6,51420.0,41100,42300,64520,3,1200,2015
423567,2.0,170081.0,1450,3800,61450,20,2350,2015
128003,2.5,92747.0,22900,20700,73100,7,-2200,2015
71369,2.0,58538.0,8900,8800,77030,2,-100,2015
106031,3.3,24044.0,17800,16000,68360,3,-1800,2015
357550,3.9,21722.0,12300,11100,62960,3,-1200,2015
131660,3.5,36433.0,13250,13200,73100,3,-50,2015
167075,3.4,69078.0,10550,11250,73100,8,700,2015
416598,4.2,28104.0,23800,23900,61450,1,100,2015
540552,1.9,127015.0,9125,12500,81400,9,3375,2015
154387,4.2,25094.0,23800,26000,73100,4,2200,2015
91250,2.7,75713.0,8725,7700,68360,8,-1025,2015
380121,3.7,28901.0,10850,11100,64520,1,250,2015
339836,3.7,34589.0,10950,10500,82750,1,-450,2015
432013,2.8,119890.0,9600,8500,61450,8,-1100,2015
135694,3.7,83924.0,21700,19000,73100,3,-2700,2015
325245,3.9,63660.0,9375,9000,82750,2,-375,2015
118585,3.7,24718.0,33200,30300,68360,1,-2900,2015
313423,2.1,51523.0,9125,9300,59100,2,175,2015
188402,2.2,99324.0,3925,4700,63250,9,775,2015
345758,3.1,65836.0,9375,8900,82750,5,-475,2015
424352,4.1,45335.0,13650,13400,61450,2,-250,2015
214488,3.4,40503.0,11100,11000,57290,1,-100,2015
83973,3.6,125365.0,7075,8100,68360,9,1025,2015
445923,1.9,161255.0,2075,1200,56120,11,-875,2015
448320,2.9,165148.0,5675,4700,56120,11,-975,2015
256465,3.6,34142.0,29200,27600,59100,3,-1600,2015
324451,1.9,87693.0,7150,3100,82750,8,-4050,2015
8546,4.2,4975.0,56100,52500,77030,1,-3600,2015
325789,4.1,147879.0,7325,6300,82750,5,-1025,2015
362870,2.8,22706.0,13300,10600,64520,3,-2700,2014
31942,3.2,87399.0,17750,16250,77030,5,-1500,2015
33997,1.9,119936.0,19650,18400,77030,7,-1250,2015
545198,1.0,22185.0,10800,7200,81400,2,-3600,2015
154089,4.1,12696.0,19550,19600,73100,1,50,2015
291034,2.7,36881.0,12800,11600,59100,3,-1200,2015
454847,2.4,128196.0,3050,4200,61490,8,1150,2015
517914,4.1,79002.0,8200,9700,71660,7,1500,2015
61522,4.0,42162.0,21400,22000,77030,3,600,2015
272027,4.2,39116.0,29200,28900,59100,2,-300,2015
312295,4.4,28832.0,18650,18500,59100,3,-150,2015
237649,4.1,95685.0,11650,12400,59100,3,750,2014
53933,1.9,208259.0,2900,1500,77030,11,-1400,2015
385755,5.0,11125.0,16500,17200,65610,2,700,2015
270825,3.5,49127.0,10400,10500,59100,2,100,2015
470665,1.9,212779.0,1950,1700,62930,11,-250,2014
203505,1.9,35965.0,12200,10900,57290,3,-1300,2015
323940,2.8,81157.0,20300,18400,82750,7,-1900,2015
91331,2.0,103805.0,4000,1500,68360,8,-2500,2015
162094,2.5,28198.0,10450,10600,73100,3,150,2015
70492,3.5,40111.0,13000,12750,77030,2,-250,2015
59942,3.7,33742.0,11000,11300,77030,2,300,2015
451864,3.7,18229.0,38700,38500,61490,0,-200,2015
73229,2.1,57939.0,8800,9700,68360,4,900,2015
479463,2.8,66704.0,3050,4300,73130,9,1250,2015
485471,3.0,31611.0,25800,26500,73130,3,700,2015
485990,5.0,41372.0,17400,16500,73130,1,-900,2015
463796,2.8,113829.0,10300,11000,61490,8,700,2015
429916,5.0,20203.0,22900,23000,61450,0,100,2015
98824,3.4,72997.0,20500,18800,68360,2,-1700,2015
223472,4.3,58743.0,12300,10200,89090,4,-2100,2015
34132,2.9,136889.0,3875,4500,77030,8,625,2015
477084,,189241.0,1950,2100,73130,11,150,2014
228368,1.9,235686.0,2000,1400,89090,14,-600,2015
496427,2.7,58204.0,11250,12000,73130,3,750,2015
208656,2.3,88531.0,7575,8800,57290,8,1225,2015
369953,2.9,116268.0,4175,5500,64520,8,1325,2015
80580,3.5,39100.0,9625,10000,68360,2,375,2015
151491,2.4,107227.0,4125,4600,73100,7,475,2015
233900,,104875.0,10400,9700,59100,6,-700,2014
489654,2.1,41809.0,42800,42800,73130,3,0,2015
301123,4.8,2553.0,13100,14000,59100,2,900,2015
192836,3.5,97096.0,15900,16900,67090,8,1000,2015
407023,3.4,54361.0,8400,8801,61450,3,401,2015
319244,2.3,42018.0,10800,11400,73200,2,600,2015
415197,3.0,105031.0,7875,7700,61450,9,-175,2015
225741,2.0,192389.0,450,600,89090,13,150,2015
476499,3.8,16653.0,16000,21100,73130,1,5100,2014
22221,2.0,92331.0,7050,7000,77030,7,-50,2015
393409,3.4,50268.0,12800,12600,65610,2,-200,2015
215086,4.4,15069.0,21100,21400,57290,3,300,2015
523098,2.0,114078.0,2400,2500,71660,12,100,2015
241006,1.9,259315.0,500,500,59100,17,0,2014
448037,3.5,117227.0,4100,5300,56120,7,1200,2015
262705,2.7,114398.0,6950,6500,59100,8,-450,2015
151922,4.3,153726.0,9325,7100,73100,6,-2225,2015
235415,,163449.0,3425,3600,59100,11,175,2014
528942,3.3,19120.0,16350,13700,70210,2,-2650,2015
425394,2.9,116332.0,9100,9400,61450,6,300,2015
351307,4.2,32544.0,11000,14500,62960,5,3500,2015
326916,4.9,3376.0,15000,15000,82750,1,0,2015
302844,3.6,50369.0,16450,16500,59100,2,50,2015
457524,3.7,28173.0,19250,20400,61490,3,1150,2015
123931,3.8,38331.0,11650,13000,73100,2,1350,2015
230926,2.1,106922.0,4375,4300,89090,9,-75,2015
16907,2.4,39434.0,11150,10750,77030,6,-400,2015
50845,4.3,10473.0,21900,24000,77030,3,2100,2015
310253,3.7,29332.0,40600,39500,59100,3,-1100,2015
260090,3.2,60989.0,1850,2000,59100,13,150,2015
323139,2.6,14676.0,28900,26750,82750,3,-2150,2015
248833,4.5,29668.0,23600,24700,59100,3,1100,2015
498342,5.0,20428.0,19550,19500,80610,1,-50,2015
135019,3.6,44940.0,10800,10700,73100,2,-100,2015
70667,4.3,16841.0,22500,25750,77030,3,3250,2015
492188,4.7,19123.0,45900,49000,73130,1,3100,2015
70213,2.9,13099.0,16600,13500,77030,1,-3100,2015
367671,4.4,5908.0,20400,18500,64520,1,-1900,2015
62622,3.9,84661.0,11400,11000,77030,7,-400,2015
429148,4.1,29542.0,10800,11100,61450,2,300,2015
82385,4.6,4353.0,21900,21800,68360,1,-100,2015
453762,4.4,92650.0,9000,8500,61490,2,-500,2015
452938,2.6,116327.0,6275,6700,61490,9,425,2015
27344,2.5,108874.0,5225,8500,77030,13,3275,2015
10090,3.5,29262.0,13950,12750,77030,1,-1200,2014
322305,3.6,36934.0,21000,19800,82750,5,-1200,2015
123908,2.8,65181.0,9125,8600,73100,2,-525,2015
9337,2.6,137850.0,5350,5700,77030,8,350,2014
327821,3.4,44185.0,17550,17900,82750,3,350,2015
546079,3.9,56621.0,23800,26400,81400,6,2600,2015
417573,1.9,98546.0,13400,10000,61450,3,-3400,2015
531277,3.5,121822.0,1900,2400,82150,10,500,2015
349815,3.0,28685.0,23000,22000,62960,2,-1000,2014
141571,4.4,27114.0,23400,24000,73100,3,600,2015
222612,4.1,38430.0,17100,16100,89090,2,-1000,2015
93943,4.2,36027.0,23800,25700,68360,4,1900,2015
230808,2.0,111045.0,1225,225,89090,14,-1000,2015
114519,4.6,41642.0,14600,14900,68360,2,300,2015
397944,3.6,58827.0,16700,16800,61450,5,100,2014
459338,1.9,89796.0,8150,8700,61490,8,550,2015
76795,4.1,12362.0,12650,11900,68360,0,-750,2014
398474,1.9,115248.0,3450,2800,61450,9,-650,2014
179313,2.8,107501.0,4775,5100,83200,8,325,2015
283063,2.6,37890.0,12450,11600,59100,2,-850,2015
14866,3.5,72683.0,10950,13300,77030,4,2350,2015
394359,3.7,49512.0,18050,14900,65610,3,-3150,2015
112542,3.2,62535.0,8225,8800,68360,5,575,2015
427129,4.2,65835.0,13400,13000,61450,3,-400,2015
68587,3.8,78413.0,10000,9600,77030,4,-400,2015
201640,4.5,18382.0,23800,27400,57290,1,3600,2014
495879,4.0,22623.0,5375,5000,73130,3,-375,2015
95473,4.0,74848.0,6325,7300,68360,5,975,2015
301150,4.3,31652.0,21900,22500,59100,3,600,2015
445303,4.1,153785.0,2025,2400,56120,12,375,2015
64022,2.0,50446.0,22800,13000,77030,4,-9800,2015
360055,3.5,43448.0,39700,40250,62960,2,550,2015
122659,4.4,23757.0,60000,59500,73100,2,-500,2014
512183,4.1,45255.0,10350,10200,71660,2,-150,2015
311665,3.5,11553.0,31300,30400,59100,2,-900,2015
48135,3.5,36311.0,20500,21900,77030,4,1400,2015
463577,3.8,140097.0,3875,3700,61490,10,-175,2015
350602,2.7,89789.0,4825,4500,62960,10,-325,2015
278220,4.4,14064.0,28800,30500,59100,1,1700,2015
239666,2.0,51601.0,17550,15600,59100,2,-1950,2014
240772,1.9,117395.0,5400,3600,59100,10,-1800,2014
281396,4.8,27891.0,16800,18800,59100,2,2000,2015
204801,4.8,107882.0,6850,6100,57290,4,-750,2015
470229,4.5,19505.0,23400,24200,61490,4,800,2015
532605,2.3,165294.0,1475,1000,82150,15,-475,2015
282528,1.0,128088.0,1950,1800,59100,16,-150,2015
318002,3.5,112877.0,3550,5800,73200,8,2250,2015
495272,4.3,13081.0,23300,24900,73130,2,1600,2015
354745,3.5,49434.0,25200,26000,62960,2,800,2015
455243,3.2,93624.0,8600,8800,61490,9,200,2015
350166,4.4,82242.0,33100,36750,62960,4,3650,2014
129771,3.9,51112.0,15650,15600,73100,4,-50,2015
173613,,198222.0,1025,500,83200,12,-525,2014
459672,2.6,70002.0,5950,7300,61490,5,1350,2015
156881,3.6,36090.0,14350,12900,73100,1,-1450,2015
144700,3.8,65693.0,7375,9000,73100,6,1625,2015
391253,3.5,94189.0,13800,12400,65610,7,-1400,2015
239672,4.4,30216.0,16200,16200,59100,1,0,2014
176984,4.1,44206.0,10900,11200,83200,2,300,2015
451198,2.5,110642.0,5850,7000,61490,7,1150,2015
206143,3.7,23130.0,29000,29750,57290,2,750,2015
517446,3.2,88849.0,13600,12300,71660,8,-1300,2015
31351,3.2,168214.0,4000,3800,77030,12,-200,2015
489602,4.6,21634.0,18650,20600,73130,3,1950,2015
307955,1.9,173136.0,2550,3500,59100,13,950,2015
148252,4.4,24693.0,27800,28100,73100,2,300,2015
505344,3.1,50568.0,11200,11200,80610,2,0,2015
104387,4.8,11688.0,12750,13300,68360,1,550,2015
253182,2.0,113503.0,9550,7200,59100,11,-2350,2015
276573,4.4,34416.0,13150,13100,59100,4,-50,2015
392764,3.9,114218.0,4625,5300,65610,7,675,2015
41324,2.6,99631.0,5725,7000,77030,4,1275,2015
50218,4.7,13625.0,18250,19300,77030,1,1050,2015
169474,2.3,50262.0,8400,6900,73100,7,-1500,2015
174424,2.4,164406.0,1875,3100,83200,10,1225,2015
13636,4.8,23180.0,46900,45750,77030,0,-1150,2015
538642,4.7,13538.0,15450,12900,55590,2,-2550,2015
488462,3.9,74749.0,8325,6900,73130,4,-1425,2015
425187,3.9,135701.0,19650,18200,61450,6,-1450,2015
513158,4.1,24731.0,22700,21600,71660,2,-1100,2015
491145,3.4,99580.0,9025,8900,73130,5,-125,2015
485687,3.7,25491.0,10450,9000,73130,1,-1450,2015
288200,3.0,79440.0,12800,13200,59100,4,400,2015
526008,4.9,2782.0,57700,50500,70210,1,-7200,2015
176285,4.2,55160.0,6775,8100,83200,3,1325,2015
447886,2.4,130223.0,15550,14300,56120,4,-1250,2015
189413,2.3,77052.0,11150,12800,63250,9,1650,2015
82755,3.7,44067.0,13400,13200,68360,2,-200,2015
31414,3.5,13944.0,33800,31750,77030,2,-2050,2015
352578,1.9,128919.0,2400,2300,62960,12,-100,2015
206427,1.9,100588.0,8425,7100,57290,5,-1325,2015
467569,2.3,111191.0,2550,4900,61490,13,2350,2015
509415,1.9,81568.0,3700,3600,71660,13,-100,2015
232523,3.8,32107.0,23200,24200,89090,3,1000,2015
297871,4.1,39688.0,24000,23200,59100,7,-800,2015
101093,1.9,22650.0,2425,4400,68360,14,1975,2015
284813,4.6,22885.0,19450,19800,59100,4,350,2015
219744,4.0,47184.0,16850,18250,57290,3,1400,2015
390852,3.7,98487.0,6400,6400,65610,9,0,2015
227469,3.5,66081.0,11850,11800,89090,2,-50,2015
34774,4.8,9959.0,62000,65000,77030,0,3000,2015
213190,4.2,80435.0,21000,22900,57290,6,1900,2015
226770,2.2,183390.0,350,500,89090,10,150,2015
71673,2.1,107590.0,7525,7250,77030,5,-275,2015
489872,4.0,22651.0,13500,13500,73130,1,0,2015
271269,3.4,57300.0,13200,13000,59100,2,-200,2015
324756,4.9,7789.0,32100,37750,82750,1,5650,2015
367163,3.6,28772.0,11650,11000,64520,2,-650,2015
440379,1.9,126384.0,2450,1800,74430,8,-650,2015
379322,3.8,54457.0,3425,5600,64520,10,2175,2015
419518,2.9,120561.0,750,900,61450,16,150,2015
267147,3.8,21413.0,12150,11200,59100,1,-950,2015
183806,3.6,47901.0,9325,10500,63250,2,1175,2014
211119,4.3,31428.0,20600,19800,57290,3,-800,2015
282538,1.8,239419.0,550,600,59100,18,50,2015
305692,3.4,50922.0,8875,8400,59100,2,-475,2015
38336,4.6,44960.0,40100,41500,77030,3,1400,2015
322874,4.7,39871.0,22100,21200,82750,2,-900,2015
442212,2.9,50210.0,13500,13100,74430,2,-400,2015
533940,3.5,109887.0,4675,3800,82150,11,-875,2015
356846,4.2,85318.0,21200,23600,62960,5,2400,2015
293891,4.0,21322.0,16200,15700,59100,1,-500,2015
35688,2.9,149516.0,5050,5500,77030,8,450,2015
98222,2.7,137691.0,6350,7500,68360,5,1150,2015
496849,3.7,31889.0,11800,12300,73130,3,500,2015
441281,1.9,157277.0,7300,7600,74430,12,300,2015
165616,1.9,40846.0,12200,11000,73100,2,-1200,2015
436246,3.9,34877.0,18700,18500,74430,3,-200,2015
513625,3.9,45009.0,15200,18000,71660,3,2800,2015
547341,2.9,52483.0,8825,6000,78090,5,-2825,2015
206451,3.7,75899.0,4250,3100,57290,8,-1150,2015
297103,1.9,158403.0,1350,1600,59100,13,250,2015
312194,3.2,45828.0,21100,20000,59100,3,-1100,2015
379726,3.6,50204.0,16900,16000,64520,2,-900,2015
182133,2.7,44022.0,11300,9800,83200,3,-1500,2015
29795,4.4,77363.0,14700,13100,77030,3,-1600,2015
256591,2.9,178938.0,2150,2300,59100,10,150,2015
5688,4.1,30806.0,15550,15700,77030,0,150,2014
110972,3.9,34919.0,62000,66500,68360,3,4500,2015
440301,3.6,84948.0,5900,6200,74430,6,300,2015
540140,3.3,61374.0,7425,8500,81400,9,1075,2014
155420,4.6,30388.0,16650,13400,73100,3,-3250,2015
486792,2.3,9844.0,20200,17500,73130,2,-2700,2015
146401,3.4,111688.0,6800,6000,73100,8,-800,2015
91715,3.8,20646.0,21300,20600,68360,1,-700,2015
42222,2.0,13592.0,13950,10100,77030,1,-3850,2015
121366,3.6,23591.0,36200,36200,73100,1,0,2015
377387,5.0,9484.0,19150,19200,64520,2,50,2015
197511,2.0,184483.0,3450,1000,67090,11,-2450,2015
203833,4.5,14874.0,34400,30000,57290,1,-4400,2015
258870,4.6,32231.0,16750,16800,59100,4,50,2015
527738,3.9,32353.0,15050,13500,70210,2,-1550,2015
142417,4.4,14874.0,12700,12900,73100,3,200,2015
403974,3.4,10005.0,14050,13300,61450,2,-750,2015
8361,,238543.0,675,500,77030,18,-175,2014
365450,4.1,147274.0,2850,2300,64520,7,-550,2015
290617,3.7,86379.0,12050,13000,59100,7,950,2015
248641,3.7,31090.0,12700,12200,59100,2,-500,2015
355316,4.1,7491.0,22600,25000,62960,1,2400,2015
368563,2.6,83466.0,5750,6600,64520,6,850,2015
184325,3.8,61434.0,9500,11000,63250,8,1500,2015
548421,3.7,32500.0,11700,11500,48460,1,-200,2015
240694,1.9,150534.0,4475,2500,59100,10,-1975,2015
355604,2.0,87381.0,6300,3800,62960,9,-2500,2015
107348,4.1,9654.0,13100,13800,68360,1,700,2015
359690,3.4,67775.0,10950,11100,62960,3,150,2015
156963,3.5,54619.0,15850,15400,73100,2,-450,2015
22064,4.6,56879.0,21400,21750,77030,4,350,2015
368196,5.0,2335.0,36600,37750,64520,1,1150,2015
285577,2.6,43037.0,16050,12700,59100,3,-3350,2015
298197,3.3,18748.0,22900,23500,59100,3,600,2015
143175,4.6,58899.0,9950,9500,73100,4,-450,2015
63546,4.2,16045.0,9575,8800,77030,2,-775,2015
154364,3.9,64084.0,23200,22000,73100,4,-1200,2015
67657,1.9,204417.0,1575,1400,77030,13,-175,2015
83952,3.4,119794.0,15850,19700,68360,8,3850,2015
435605,1.9,112511.0,4800,2700,74430,8,-2100,2015
337719,4.5,20756.0,13250,15000,82750,3,1750,2015
266426,4.8,26235.0,15850,17100,59100,4,1250,2015
519260,2.3,82692.0,9125,12000,71660,11,2875,2015
70299,3.7,59771.0,8850,9300,77030,2,450,2015
351053,2.8,49972.0,26200,26100,62960,2,-100,2015
321517,2.6,113761.0,3400,3600,82750,12,200,2014
422831,4.0,29699.0,14600,13500,61450,1,-1100,2015
243519,4.6,25536.0,21700,22200,59100,3,500,2015
386456,5.0,19868.0,23300,22400,65610,2,-900,2015
280119,4.2,76705.0,14500,15200,59100,6,700,2015
338242,3.1,94456.0,6125,5200,82750,7,-925,2015
536226,1.9,218241.0,2750,700,82150,16,-2050,2015
451287,2.7,83931.0,5100,6200,61490,9,1100,2015
303268,1.9,106416.0,7450,4700,59100,7,-2750,2015
315221,2.6,118299.0,7750,7100,59100,7,-650,2015
93741,2.8,159028.0,4000,4800,68360,10,800,2015
521832,3.7,41735.0,11150,13100,71660,3,1950,2015
392949,4.4,27326.0,12550,13000,65610,3,450,2015
294291,4.3,29666.0,16300,15600,59100,1,-700,2015
216259,4.8,33866.0,24500,26400,57290,1,1900,2015
242558,4.0,21109.0,17650,17800,59100,1,150,2015
241968,2.1,130527.0,4450,3300,59100,11,-1150,2015
145689,3.0,22537.0,16900,17700,73100,1,800,2015
440397,1.9,119181.0,4150,4700,74430,12,550,2015
58413,4.1,29978.0,11900,11900,77030,1,0,2015
50278,2.8,35629.0,10700,10300,77030,2,-400,2015
514428,4.1,53700.0,12250,12200,71660,2,-50,2015
82249,1.7,196425.0,1425,1000,68360,12,-425,2015
500090,3.7,51782.0,10750,10900,80610,2,150,2015
317285,2.5,92733.0,4250,6400,73200,15,2150,2015
123036,3.7,18720.0,7775,7600,73100,5,-175,2014
85922,2.5,42725.0,12050,12700,68360,2,650,2015
483751,4.9,11923.0,27600,26200,73130,1,-1400,2015
50724,3.7,62827.0,30900,29000,77030,3,-1900,2015
25049,3.3,75974.0,9900,10200,77030,7,300,2015
114245,1.9,138004.0,5225,3100,68360,11,-2125,2015
74312,2.1,327287.0,5250,5000,68360,8,-250,2014
326177,3.5,35194.0,13450,12000,82750,2,-1450,2015
52269,2.1,153433.0,5300,6300,77030,9,1000,2015
319591,4.2,16686.0,11600,13400,73200,2,1800,2015
323356,2.8,44221.0,24200,24100,82750,4,-100,2015
312023,3.6,24296.0,30800,30250,59100,2,-550,2015
121939,4.1,31773.0,14950,15100,73100,2,150,2014
425618,2.7,111312.0,3950,3000,61450,8,-950,2015
85616,3.7,26982.0,10900,11700,68360,2,800,2015
532899,2.5,58727.0,9975,9800,82150,2,-175,2015
11378,4.0,50842.0,16550,16500,77030,2,-50,2015
41522,2.8,58944.0,6400,6700,77030,7,300,2015
69679,4.6,31959.0,29600,28500,77030,3,-1100,2015
221462,4.8,27239.0,22600,22600,57290,1,0,2015
527099,1.9,120302.0,3000,2750,70210,12,-250,2015
435450,3.3,106453.0,2375,2400,74430,11,25,2015
189743,3.7,46396.0,11450,11900,63250,3,450,2015
349765,3.3,59419.0,12000,11900,62960,1,-100,2014
342342,3.3,14710.0,17350,16800,82750,2,-550,2015
136402,3.5,33546.0,12250,11500,73100,3,-750,2015
14640,4.3,31319.0,19950,20250,77030,2,300,2015
249648,2.5,196549.0,825,400,59100,13,-425,2015
345596,3.6,20057.0,9125,8800,82750,2,-325,2015
384082,4.6,3141.0,23800,24400,65610,1,600,2015
419149,4.9,47046.0,11950,13800,61450,3,1850,2015
425955,3.5,54057.0,9350,9201,61450,2,-149,2015
355372,2.8,47056.0,9275,10000,62960,2,725,2015
368035,3.9,40438.0,13750,13000,64520,2,-750,2015
186934,3.9,16968.0,16300,16800,63250,2,500,2015
18382,4.3,37309.0,34200,35250,77030,4,1050,2015
353158,5.0,13464.0,20900,21500,62960,1,600,2015
322885,2.9,15521.0,30000,27400,82750,2,-2600,2015
159746,4.5,31988.0,30800,28750,73100,3,-2050,2015
55713,3.9,91183.0,6450,6100,77030,8,-350,2015
155156,3.1,29127.0,39300,37000,73100,5,-2300,2015
515628,3.6,53366.0,8500,8900,71660,8,400,2015
190042,4.0,30184.0,16000,15500,63250,1,-500,2015
179058,2.9,108718.0,5700,5400,83200,8,-300,2015
355342,4.0,14598.0,29800,27500,62960,2,-2300,2015
450461,3.6,67808.0,8050,9400,61490,8,1350,2014
489646,2.1,18706.0,20800,18400,73130,3,-2400,2015
224676,3.8,90993.0,8450,8000,89090,8,-450,2015
279825,2.3,109139.0,4650,4800,59100,8,150,2015
129869,3.3,100196.0,9125,10000,73100,6,875,2015
122572,4.1,23989.0,10300,11100,73100,3,800,2015
126757,3.0,28263.0,18050,16500,73100,1,-1550,2015
375295,3.4,91775.0,4675,5800,64520,8,1125,2015
325376,4.1,32885.0,11200,11400,82750,3,200,2015
60651,4.5,25878.0,9350,9900,77030,2,550,2015
184901,1.9,116554.0,4650,4500,63250,9,-150,2015
429134,1.9,52438.0,8700,8100,61450,2,-600,2015
372087,4.4,88795.0,8725,10200,64520,3,1475,2015
515719,3.8,36714.0,9750,8900,71660,3,-850,2015
255095,2.4,46675.0,9175,7000,59100,3,-2175,2015
38785,2.9,134066.0,7925,7600,77030,6,-325,2015
2981,2.5,101633.0,12600,12300,77030,6,-300,2014
320294,1.9,120180.0,8100,7900,82750,7,-200,2015
34328,2.0,124162.0,4800,2600,77030,10,-2200,2015
37020,4.3,169616.0,6050,6500,77030,8,450,2015
432426,2.2,24430.0,18850,17100,74430,4,-1750,2015
521822,2.1,30367.0,25200,21200,71660,3,-4000,2015
529461,2.4,88637.0,5475,4300,70210,10,-1175,2015
115680,3.5,38514.0,23700,22000,68360,5,-1700,2015
178055,4.7,12301.0,20700,21000,83200,1,300,2015
114534,4.2,43830.0,11700,13000,68360,2,1300,2015
400962,2.2,109373.0,2975,2900,61450,6,-75,2014
82998,4.3,34895.0,12500,13750,68360,4,1250,2015
77393,4.8,33272.0,22900,22000,68360,0,-900,2014
503026,4.0,21225.0,35700,36300,80610,0,600,2015
443306,4.0,30874.0,18300,18300,74430,1,0,2015
304316,3.1,28797.0,11900,11800,59100,3,-100,2015
460791,2.2,180972.0,2575,3000,61490,7,425,2015
97869,3.8,49332.0,12350,12300,68360,2,-50,2015
279551,2.0,145446.0,1450,1000,59100,16,-450,2015
440466,3.2,116743.0,4825,4200,74430,6,-625,2015
342419,4.3,13626.0,22400,23000,82750,3,600,2015
273287,4.7,20463.0,17450,17800,59100,1,350,2015
415732,2.0,163283.0,2775,4200,61450,12,1425,2015
110726,4.4,22537.0,24100,23500,68360,1,-600,2015
320147,,118512.0,16050,13600,82750,4,-2450,2014
501989,4.2,62103.0,12550,12900,80610,2,350,2015
311907,3.9,42676.0,29400,28600,59100,2,-800,2015
211207,4.1,83753.0,16550,17000,57290,7,450,2015
416425,4.1,21730.0,16900,17500,61450,1,600,2015
536974,2.0,180930.0,2575,1000,73640,17,-1575,2015
359572,3.8,39791.0,9025,9900,62960,1,875,2015
546648,4.3,67475.0,11500,12600,81400,3,1100,2015
203807,4.6,42574.0,17100,16100,57290,1,-1000,2015
381250,4.6,23172.0,11250,11300,64520,2,50,2015
318806,3.5,87280.0,19500,19200,73200,3,-300,2015
419635,3.5,51551.0,37600,37800,61450,3,200,2015
6024,4.2,10974.0,26000,25750,77030,1,-250,2014
436305,1.9,104669.0,2900,3250,74430,11,350,2015
144284,1.9,35171.0,17900,15200,73100,3,-2700,2015
276607,3.5,65697.0,15500,16800,59100,5,1300,2015
505929,1.9,119082.0,750,600,80610,16,-150,2015
462735,2.2,159806.0,2825,4200,61490,9,1375,2015
484438,4.0,10325.0,13900,13700,73130,1,-200,2015
516834,3.5,99615.0,7775,7800,71660,7,25,2015
308338,2.3,147410.0,4525,3200,59100,10,-1325,2015
338114,4.8,23065.0,14450,14200,82750,3,-250,2015
445120,1.9,253817.0,350,700,56120,16,350,2015
431396,1.9,113923.0,4100,3100,61450,8,-1000,2015
506310,2.9,64862.0,20200,19100,80200,4,-1100,2015
210243,2.9,37405.0,16200,16200,57290,1,0,2015
215662,4.9,52693.0,24500,27000,57290,4,2500,2015
289026,1.0,15494.0,20300,9000,59100,0,-11300,2015
109221,1.9,76264.0,4475,3500,68360,7,-975,2015
141980,2.0,125443.0,1400,1000,73100,12,-400,2015
345574,3.7,40093.0,21600,20800,82750,2,-800,2015
443766,2.9,101059.0,5450,6500,74430,6,1050,2015
240648,2.8,89579.0,4700,6200,59100,8,1500,2014
208432,4.2,15482.0,11650,13000,57290,2,1350,2015
470404,3.5,131166.0,15600,14700,61490,5,-900,2015
240218,3.0,12394.0,24600,26600,59100,1,2000,2015
22986,4.4,28644.0,20100,20750,77030,4,650,2015
90066,4.9,28269.0,18000,17200,68360,1,-800,2015
401495,4.3,16792.0,33200,34600,61450,1,1400,2015
419294,3.7,33885.0,14700,14800,61450,3,100,2015
385776,3.6,13594.0,27500,24500,65610,2,-3000,2015
299295,3.2,37323.0,13150,12500,59100,2,-650,2015
240674,2.0,201493.0,2700,3200,59100,8,500,2014
37843,2.9,173001.0,2175,1500,77030,12,-675,2015
461796,2.6,49823.0,17600,15800,61490,3,-1800,2015
533630,1.9,216471.0,1100,1050,82150,8,-50,2015
139662,3.6,159306.0,4675,3600,73100,7,-1075,2015
462295,3.5,82443.0,16500,16000,61490,7,-500,2015
426379,2.7,164742.0,2125,2500,61450,8,375,2015
22284,2.7,108432.0,12300,12750,77030,8,450,2015
30313,4.2,10862.0,33200,32500,77030,9,-700,2015
531918,2.6,50939.0,12550,11600,82150,2,-950,2015
488449,3.7,41076.0,13800,13800,73130,3,0,2015
280868,4.3,29780.0,13300,13700,59100,1,400,2015
73586,,999999.0,3375,400,68360,5,-2975,2014
465995,2.4,174801.0,2150,1900,61490,9,-250,2015
499404,2.1,70222.0,7250,7700,80610,4,450,2015
162397,3.7,55821.0,8900,8600,73100,2,-300,2015
284658,4.3,29802.0,21400,22200,59100,3,800,2015
166350,3.3,115636.0,16100,15700,73100,6,-400,2015
361834,3.7,33446.0,17100,16800,64520,2,-300,2014
263800,4.0,17984.0,12450,14000,59100,1,1550,2015
94180,4.1,54876.0,8350,9300,68360,3,950,2015
418224,4.2,49434.0,11300,11600,61450,3,300,2015
337884,4.8,905.0,23800,23900,82750,1,100,2015
276025,4.5,41272.0,17800,17900,59100,3,100,2015
243649,4.7,12283.0,13650,13400,59100,3,-250,2015
139032,1.9,26991.0,12100,9400,73100,3,-2700,2015
68145,3.7,51618.0,14000,14700,77030,6,700,2015
432345,2.8,44782.0,22200,22100,74430,2,-100,2014
379458,1.9,50807.0,17850,17000,64520,2,-850,2015
34870,3.9,6268.0,16650,21750,77030,1,5100,2015
218082,4.5,11504.0,21100,24300,57290,1,3200,2015
185821,2.7,84678.0,4425,4900,63250,7,475,2015
410586,2.1,144161.0,8125,7300,61450,8,-825,2015
90243,4.1,25815.0,16150,15300,68360,2,-850,2015
3733,2.7,98424.0,9750,7600,77030,8,-2150,2014
227524,2.8,138750.0,3975,4300,89090,7,325,2015
97642,3.7,107380.0,12500,11400,68360,6,-1100,2015
145304,3.8,75271.0,22700,25000,73100,4,2300,2015
347622,2.2,40075.0,9800,8200,82750,3,-1600,2015
191366,,115653.0,5925,5000,67090,10,-925,2014
119662,2.6,30415.0,14300,12700,73100,4,-1600,2015
216793,4.2,19758.0,22000,24000,57290,2,2000,2015
26357,3.9,35624.0,13600,12000,77030,2,-1600,2015
125794,3.9,18605.0,21800,22000,73100,1,200,2015
35494,3.9,28559.0,20800,19250,77030,3,-1550,2015
97230,2.9,122962.0,11350,13300,68360,8,1950,2015
35559,3.5,95700.0,7050,7300,77030,5,250,2015
479990,4.3,36333.0,13200,14300,73130,4,1100,2015
323649,3.9,7101.0,21100,21500,82750,2,400,2015
139319,3.3,45287.0,12650,11500,73100,3,-1150,2015
512955,2.6,66279.0,27300,26500,71660,4,-800,2015
32597,4.4,5605.0,23800,21200,77030,1,-2600,2015
276622,2.9,105745.0,6225,6600,59100,5,375,2015
172936,3.9,80096.0,17400,17000,73100,5,-400,2015
131026,4.8,44149.0,15100,16000,73100,3,900,2015
393346,2.1,39250.0,21800,18400,65610,3,-3400,2015
405280,2.1,178305.0,5900,5200,61450,10,-700,2015
22228,3.9,74231.0,5625,6800,77030,7,1175,2015
400012,5.0,17001.0,22100,22100,61450,2,0,2015
406972,2.6,18151.0,18150,17500,61450,2,-650,2015
15355,2.5,122924.0,4775,4800,77030,10,25,2015
237131,3.6,164519.0,1725,2000,59100,12,275,2014
466500,2.8,147670.0,8400,7400,61490,11,-1000,2015
87025,4.5,53584.0,22400,23000,68360,3,600,2015
116325,4.0,104519.0,15100,15800,68360,7,700,2015
71839,1.0,113138.0,3150,550,77030,10,-2600,2015
154449,3.2,64934.0,7975,9700,73100,5,1725,2015
420799,3.4,18246.0,23300,23500,61450,1,200,2015
4950,1.9,179920.0,1750,1250,77030,13,-500,2014
147783,2.6,29105.0,10100,8300,73100,3,-1800,2015
335004,3.6,39525.0,13950,13300,82750,3,-650,2015
530287,1.9,92110.0,5800,3500,82150,9,-2300,2015
425674,1.9,159334.0,1775,1800,61450,13,25,2015
295501,4.8,15576.0,20000,21300,59100,2,1300,2015
202944,3.3,39979.0,12250,11400,57290,2,-850,2015
68916,3.1,46569.0,22600,23500,77030,3,900,2015
80634,5.0,8847.0,28400,27300,68360,2,-1100,2015
151714,5.0,11553.0,38400,38800,73100,1,400,2015
185049,3.8,49218.0,17100,17800,63250,2,700,2015
540866,1.0,245573.0,900,400,81400,19,-500,2015
180243,3.8,20130.0,11950,11700,83200,1,-250,2015
502846,2.6,113135.0,11100,13600,80610,4,2500,2015
22551,3.5,63520.0,6125,7700,77030,12,1575,2015
479750,2.2,34787.0,12050,10000,73130,3,-2050,2015
446881,4.3,43240.0,16900,15900,56120,2,-1000,2015
295940,4.4,55950.0,13850,13300,59100,2,-550,2015
71078,3.7,94894.0,17900,19500,77030,9,1600,2015
207829,3.5,22354.0,19800,17500,57290,2,-2300,2015
458154,2.9,81763.0,11550,11700,61490,6,150,2015
435647,2.0,149221.0,1375,350,74430,12,-1025,2015
516354,3.8,36208.0,24300,25200,71660,2,900,2015
227280,3.5,113357.0,2350,2600,89090,11,250,2015
455244,3.5,165024.0,3175,3200,61490,9,25,2015
108163,2.6,164697.0,9025,8600,68360,11,-425,2015
469514,1.9,194421.0,500,600,61490,9,100,2015
203112,4.1,35240.0,21800,21250,57290,3,-550,2015
69261,5.0,44667.0,9875,10600,77030,3,725,2015
303546,4.2,24167.0,12950,13000,59100,2,50,2015
41315,4.5,26338.0,20000,20500,77030,4,500,2015
511187,5.0,30176.0,26300,26500,71660,3,200,2015
66519,3.5,23110.0,11200,11200,77030,2,0,2015
358940,3.6,38366.0,33800,32750,62960,2,-1050,2015
410676,3.1,1.0,3900,2600,61450,11,-1300,2015
168844,3.6,46749.0,9375,10400,73100,3,1025,2015
364074,3.9,89866.0,5200,7000,64520,4,1800,2015
412281,4.6,18881.0,15000,14400,61450,1,-600,2015
217177,3.2,97964.0,4075,3700,57290,11,-375,2015
214005,4.9,25079.0,15400,15600,57290,1,200,2015
218256,2.7,50065.0,11200,11700,57290,2,500,2015
287324,3.5,24982.0,24200,23900,59100,1,-300,2015
525138,3.7,34977.0,12500,11600,70210,1,-900,2014
305615,2.5,13532.0,16450,14000,59100,0,-2450,2015
409535,2.7,63808.0,9725,8700,61450,3,-1025,2015
183873,1.9,69024.0,6000,6100,63250,10,100,2015
351031,3.2,47597.0,11850,12000,62960,2,150,2015
284933,4.0,62722.0,10250,10800,59100,5,550,2015
431833,2.8,262733.0,1300,2450,61450,12,1150,2015
269084,2.1,102089.0,3575,1000,59100,12,-2575,2015
218204,4.4,34727.0,12700,13000,57290,1,300,2015
350110,3.9,15343.0,15700,15600,62960,0,-100,2014
82219,2.0,118948.0,3100,1000,68360,11,-2100,2015
141159,2.3,91910.0,7400,5900,73100,7,-1500,2015
17005,3.0,13863.0,16550,17200,77030,1,650,2015
77607,1.9,120094.0,3200,2900,68360,7,-300,2014
121593,,24106.0,29400,30500,73100,1,1100,2014
301131,4.2,46028.0,23600,24000,59100,3,400,2015
437573,4.0,175737.0,9475,9400,74430,8,-75,2015
203314,3.6,13274.0,21800,20200,57290,1,-1600,2015
249125,4.0,20625.0,19450,19000,59100,1,-450,2015
391575,4.3,60806.0,18850,19000,65610,7,150,2015
91884,4.3,7354.0,11750,12400,68360,1,650,2015
380498,4.1,20568.0,32100,35000,64520,3,2900,2015
453722,2.0,83679.0,2200,1800,61490,13,-400,2015
120367,1.9,124486.0,6600,5600,73100,7,-1000,2014
251539,4.0,29726.0,15000,14000,59100,2,-1000,2015
407289,2.2,268046.0,275,700,61450,14,425,2015
38172,3.4,107641.0,7100,9400,77030,9,2300,2015
222561,2.0,171709.0,800,400,89090,17,-400,2014
389915,3.7,87882.0,16750,15700,65610,3,-1050,2015
266975,1.9,114893.0,3050,1000,59100,11,-2050,2015
159140,4.1,29523.0,45600,47250,73100,1,1650,2015
477388,4.0,12430.0,11900,11800,73130,1,-100,2015
244699,4.8,19019.0,21200,19600,59100,2,-1600,2015
227685,3.0,104003.0,2600,2200,89090,9,-400,2015
546540,3.8,28871.0,9700,10100,81400,3,400,2015
362017,4.8,23890.0,13750,13600,64520,1,-150,2014
511088,4.4,33431.0,21700,20600,71660,2,-1100,2015
255565,2.0,91647.0,6950,8900,59100,9,1950,2015
84481,2.4,71291.0,7750,6200,68360,9,-1550,2015
20500,3.6,42904.0,21000,22000,77030,3,1000,2015
37297,3.3,132045.0,1650,1400,77030,16,-250,2015
535074,1.9,132622.0,1000,650,82150,13,-350,2015
190322,3.0,59189.0,30700,23500,63250,7,-7200,2015
25088,1.0,793.0,25400,8500,77030,1,-16900,2015
215093,3.5,80835.0,12050,11300,57290,3,-750,2015
398259,2.0,4192.0,19950,15200,61450,0,-4750,2015
72731,3.7,98366.0,13200,12750,77030,9,-450,2015
445015,4.6,20826.0,16900,16200,56120,3,-700,2015
146546,3.7,17355.0,34400,31000,73100,2,-3400,2015
296735,3.7,59407.0,17800,18400,59100,4,600,2015
152105,3.7,24926.0,14350,13300,73100,2,-1050,2015
40905,3.7,45838.0,9225,9800,77030,2,575,2015
526291,2.1,53017.0,13350,11500,70210,4,-1850,2015
91288,1.9,165310.0,2050,1600,68360,8,-450,2015
220008,2.4,82257.0,11700,10400,57290,9,-1300,2015
307879,1.9,100067.0,6800,6500,59100,11,-300,2015
164484,3.7,34556.0,12700,12000,73100,3,-700,2015
396492,4.4,126290.0,8850,8000,65610,7,-850,2015
121388,2.9,10436.0,33100,29600,73100,2,-3500,2015
289948,2.9,167964.0,5400,5900,59100,10,500,2015
501521,3.9,37534.0,24600,24700,80610,1,100,2015
67772,3.5,70211.0,14150,15500,77030,7,1350,2015
313146,3.9,94004.0,3125,2000,59100,12,-1125,2015
341917,4.3,14678.0,19250,19600,82750,2,350,2015
538897,3.8,84029.0,18850,14100,55590,4,-4750,2015
272445,3.5,48173.0,17200,17900,59100,4,700,2015
253507,2.7,33214.0,30900,31700,59100,2,800,2015
65326,1.0,21748.0,22600,17250,77030,1,-5350,2015
478214,2.6,38781.0,12050,11500,73130,3,-550,2015
278561,1.9,191954.0,1000,1200,59100,14,200,2015
4212,2.7,97445.0,6000,7000,77030,9,1000,2014
387290,4.4,59960.0,20900,18600,65610,4,-2300,2015
37755,2.8,255212.0,10050,9000,77030,9,-1050,2015
376192,3.7,44270.0,24000,22900,64520,3,-1100,2015
198376,1.9,162673.0,825,950,67090,15,125,2015
460272,1.9,95452.0,9375,4000,61490,6,-5375,2015
283506,1.9,185716.0,8825,7400,59100,8,-1425,2015
179897,3.6,35762.0,12700,11700,83200,3,-1000,2015
299202,4.2,25306.0,15750,15600,59100,1,-150,2015
538061,2.0,179025.0,5025,4200,55590,7,-825,2015
212698,4.9,17024.0,16300,17800,57290,1,1500,2015
294873,5.0,7185.0,14050,16200,59100,1,2150,2015
471952,2.9,19223.0,11900,11000,62930,2,-900,2015
389730,4.3,84007.0,14700,14200,65610,7,-500,2015
449716,3.2,37902.0,9600,9700,61490,2,100,2014
225942,1.9,146755.0,3525,3600,89090,5,75,2015
347606,2.9,40462.0,37500,35000,82750,3,-2500,2015
494946,3.3,33185.0,15300,16600,73130,2,1300,2015
521624,3.7,46489.0,8075,8500,71660,2,425,2015
198674,4.0,17696.0,16450,16200,67090,1,-250,2015
445921,1.9,123366.0,4050,2900,56120,11,-1150,2015
539554,4.2,34979.0,18050,19000,55590,2,950,2015
278881,3.7,81911.0,9600,10000,59100,4,400,2015
541531,4.6,19984.0,22900,22000,81400,2,-900,2015
58056,4.7,15065.0,45200,43200,77030,0,-2000,2015
322612,4.9,15941.0,33600,32700,82750,0,-900,2015
401418,3.9,37222.0,16850,18000,61450,3,1150,2015
466066,2.6,85854.0,23200,24000,61490,3,800,2015
135741,4.4,43710.0,20000,20750,73100,3,750,2015
132635,4.4,46793.0,11250,10800,73100,3,-450,2015
37395,4.4,11683.0,24200,25400,77030,2,1200,2015
207166,4.6,20298.0,20100,22400,57290,4,2300,2015
108578,3.5,55960.0,12400,12300,68360,2,-100,2015
309575,4.2,105831.0,14750,14000,59100,3,-750,2015
338030,4.8,8039.0,21700,22600,82750,1,900,2015
95404,4.1,27416.0,19100,18000,68360,4,-1100,2015
221070,4.9,15520.0,17800,18000,57290,1,200,2015
31168,1.9,85494.0,6250,8300,77030,8,2050,2015
180821,3.2,129727.0,5175,4000,83200,10,-1175,2015
213698,4.4,77156.0,20500,23100,57290,5,2600,2015
41928,2.4,199616.0,4350,4100,77030,12,-250,2015
178176,2.0,190563.0,825,850,83200,17,25,2015
440869,3.2,116113.0,13200,13000,74430,8,-200,2015
188847,4.1,110966.0,24200,21500,63250,2,-2700,2015
382426,2.9,75379.0,9900,9500,65610,6,-400,2014
79987,4.3,76201.0,6575,8300,68360,7,1725,2015
471804,3.2,114420.0,6475,6500,62930,9,25,2015
24978,2.4,38085.0,19200,18000,77030,4,-1200,2015
350678,4.1,40317.0,10850,11400,62960,2,550,2015
437936,2.1,98652.0,3375,500,74430,14,-2875,2015
151395,4.2,18048.0,19600,18800,73100,5,-800,2015
331687,2.3,134735.0,1850,1300,82750,10,-550,2015
91280,1.9,154328.0,2300,2000,68360,8,-300,2015
59496,3.5,31144.0,10250,10000,77030,3,-250,2015
214608,4.3,42929.0,13500,13600,57290,2,100,2015
19114,3.5,54727.0,8250,9500,77030,4,1250,2015
51099,3.2,70753.0,9275,8600,77030,6,-675,2015
425444,3.6,82451.0,10200,9100,61450,2,-1100,2015
272140,3.9,29273.0,19850,23800,59100,3,3950,2015
337044,4.9,34092.0,14200,14100,82750,2,-100,2015
336782,1.9,95937.0,7250,3900,82750,6,-3350,2015
27300,2.8,172709.0,4925,4500,77030,12,-425,2015
407699,3.9,112085.0,12900,14100,61450,5,1200,2015
318066,2.5,165630.0,8075,6300,73200,10,-1775,2015
324646,5.0,4053.0,19650,20500,82750,1,850,2015
268689,3.4,97434.0,8775,8200,59100,4,-575,2015
66176,4.6,10637.0,36000,35500,77030,0,-500,2015
353447,1.9,110226.0,11250,10000,62960,9,-1250,2015
116518,3.6,61205.0,11550,11100,68360,1,-450,2015
19534,2.0,179200.0,1600,500,77030,11,-1100,2015
392281,3.5,61682.0,19100,18100,65610,5,-1000,2015
397859,3.6,62429.0,13150,13000,61450,4,-150,2014
139736,2.0,116878.0,2550,900,73100,9,-1650,2015
305040,4.6,11627.0,32300,33500,59100,0,1200,2015
423391,4.8,18692.0,23300,23500,61450,0,200,2015
289794,2.6,140017.0,4400,3200,59100,7,-1200,2015
390575,3.5,68988.0,22900,20600,65610,8,-2300,2015
249885,4.7,7874.0,20700,21200,59100,1,500,2015
239424,4.7,15462.0,22000,22800,59100,2,800,2015
170748,2.9,69456.0,16550,16700,73100,5,150,2015
102806,4.3,53804.0,10400,9500,68360,3,-900,2015
510422,4.3,25682.0,11600,10500,71660,3,-1100,2015
342706,2.1,35375.0,18700,17800,82750,3,-900,2015
294275,2.1,9316.0,21200,18400,59100,0,-2800,2015
257305,4.8,13430.0,20700,19700,59100,0,-1000,2015
82938,4.2,99747.0,22600,22800,68360,4,200,2015
488751,4.0,40064.0,19200,19300,73130,2,100,2015
439886,2.1,126203.0,4625,6100,74430,11,1475,2015
524789,,249701.0,300,400,70210,14,100,2014
496222,2.5,35963.0,17900,13000,73130,3,-4900,2015
280891,4.1,20807.0,15500,17000,59100,2,1500,2015
520196,4.5,29552.0,25000,23400,71660,2,-1600,2015
151555,2.6,109474.0,5375,2600,73100,10,-2775,2015
97388,4.7,21219.0,11100,11300,68360,1,200,2015
251578,2.6,39950.0,18900,18500,59100,2,-400,2015
236827,3.5,68187.0,9500,9600,59100,2,100,2014
114529,2.8,20788.0,24500,19900,68360,0,-4600,2015
398118,1.9,127025.0,6650,6700,61450,7,50,2014
287561,2.1,131419.0,2075,2300,59100,9,225,2015
124505,3.6,104674.0,12200,12500,73100,6,300,2015
385250,4.1,67054.0,4675,4100,65610,7,-575,2015
115671,4.2,107809.0,9000,9600,68360,5,600,2015
423868,2.1,112158.0,13350,10000,61450,8,-3350,2015
219523,2.6,27121.0,17550,15300,57290,1,-2250,2015
259501,4.1,74180.0,13200,15600,59100,2,2400,2015
181549,3.6,37951.0,11300,11200,83200,1,-100,2015
494630,3.3,24416.0,15250,14200,73130,1,-1050,2015
184280,3.0,61386.0,16250,15000,63250,6,-1250,2015
278524,4.1,99618.0,20100,22000,59100,9,1900,2015
145088,2.8,96197.0,3550,3450,73100,10,-100,2015
531073,4.1,52906.0,29500,25500,82150,5,-4000,2015
406861,2.8,177674.0,9875,11700,61450,8,1825,2015
224482,2.3,92688.0,9100,8200,89090,9,-900,2015
322951,3.8,12177.0,23900,22750,82750,2,-1150,2015
499093,1.9,135327.0,5500,3600,80610,2,-1900,2014
367809,4.9,2756.0,32500,38750,64520,1,6250,2015
461839,4.4,129758.0,14650,16100,61490,6,1450,2015
527927,3.8,83672.0,9650,10200,70210,5,550,2015
326549,2.1,160150.0,1900,600,82750,13,-1300,2015
145796,4.2,25256.0,21400,22000,73100,3,600,2015
107178,4.4,32958.0,20200,20500,68360,2,300,2015
53706,3.4,48618.0,23200,22800,77030,2,-400,2015
10599,3.8,60020.0,26300,27250,77030,5,950,2014
275542,3.7,61081.0,7725,8000,59100,3,275,2015
510272,4.4,70270.0,9800,10300,71660,6,500,2015
347315,2.0,38517.0,10350,9800,82750,1,-550,2015
92695,2.5,126136.0,6275,6800,68360,8,525,2015
480931,4.3,24731.0,14500,14300,73130,2,-200,2015
532643,2.9,83953.0,9875,8100,82150,5,-1775,2015
517470,1.9,169457.0,3375,2700,71660,12,-675,2015
133538,4.0,27603.0,16500,15800,73100,1,-700,2015
320157,,1.0,15100,2750,82750,4,-12350,2014
192228,3.5,27326.0,9600,9300,67090,7,-300,2014
328440,3.2,40464.0,24800,25250,82750,3,450,2015
288670,1.9,68946.0,13550,12200,59100,4,-1350,2015
134544,3.0,156841.0,1850,850,73100,13,-1000,2015
83014,5.0,27621.0,17950,19700,68360,4,1750,2015
324181,4.4,77364.0,14350,13900,82750,4,-450,2015
287828,3.8,34274.0,12850,12800,59100,2,-50,2015
518495,3.8,40145.0,12950,12800,71660,2,-150,2015
50903,4.1,29641.0,13150,15750,77030,3,2600,2015
223561,2.1,174014.0,4050,4600,89090,10,550,2015
290122,3.8,32276.0,16600,17300,59100,1,700,2015
504317,3.9,42239.0,28300,29700,80610,2,1400,2015
29717,4.5,17510.0,30300,30400,77030,1,100,2015
195305,3.5,96908.0,13350,13600,67090,4,250,2015
130959,4.3,49795.0,24200,25250,73100,5,1050,2015
490617,4.9,19691.0,22500,23600,73130,2,1100,2015
312738,3.2,140828.0,3275,2500,59100,6,-775,2015
304865,3.7,49493.0,16650,16800,59100,2,150,2015
388399,3.4,54165.0,8175,7400,65610,3,-775,2015
100023,3.6,150133.0,9150,10500,68360,5,1350,2015
263625,3.0,19247.0,14050,12900,59100,3,-1150,2015
226805,2.5,113086.0,7925,6800,89090,7,-1125,2015
378965,1.9,175128.0,5350,2800,64520,12,-2550,2015
406530,2.0,59054.0,12300,8600,61450,8,-3700,2015
258348,2.6,66381.0,10650,9500,59100,3,-1150,2015
121291,4.7,22718.0,13150,12500,73100,2,-650,2015
56136,4.0,30996.0,18750,20000,77030,2,1250,2015
330590,3.8,100401.0,9950,8600,82750,4,-1350,2015
12969,3.7,21096.0,14400,14000,77030,2,-400,2015
475611,,83871.0,3925,3500,73130,8,-425,2014
104426,3.0,23003.0,11400,7800,68360,1,-3600,2015
457744,4.3,28654.0,14350,14000,61490,3,-350,2015
55044,3.7,44857.0,19350,20750,77030,4,1400,2015
374915,3.5,104535.0,2775,3700,64520,11,925,2015
296859,3.5,50450.0,9600,9500,59100,2,-100,2015
467740,3.6,55995.0,25200,26300,61490,4,1100,2015
107463,1.7,85496.0,5775,3500,68360,6,-2275,2015
412088,2.1,119353.0,4100,3500,61450,10,-600,2015
480144,2.0,180157.0,4400,4100,73130,10,-300,2015
315995,4.1,12701.0,28000,28000,73200,3,0,2014
315544,1.9,120453.0,4450,2400,59100,10,-2050,2015
268022,2.5,107795.0,5900,1500,59100,9,-4400,2015
286591,4.0,14403.0,15050,15900,59100,1,850,2015
349426,4.4,6676.0,14300,14200,62960,1,-100,2015
172613,4.1,89759.0,7050,7300,73100,7,250,2015
257856,3.8,45015.0,13850,14400,59100,3,550,2015
500014,4.2,23452.0,11550,12900,80610,2,1350,2015
331886,2.7,25278.0,21400,19000,82750,3,-2400,2015
530057,1.9,223943.0,675,650,82150,10,-25,2014
498807,2.9,60289.0,8300,9700,80610,10,1400,2014
113781,3.6,94936.0,12600,13000,68360,6,400,2015
190922,2.9,35383.0,9250,8800,63250,2,-450,2015
76689,2.8,172282.0,2900,2500,68360,11,-400,2014
434766,4.1,36174.0,13150,13100,74430,4,-50,2015
68762,2.6,52417.0,9125,8600,77030,2,-525,2015
423407,4.1,44092.0,13450,15100,61450,3,1650,2015
171178,4.2,37052.0,12950,13400,73100,3,450,2015
102242,4.9,44067.0,16650,18400,68360,3,1750,2015
178996,4.4,47772.0,10700,12500,83200,4,1800,2015
205646,4.1,39621.0,10400,10000,57290,1,-400,2015
450204,3.4,68922.0,9575,8100,61490,2,-1475,2014
526681,4.9,6446.0,10250,9500,70210,3,-750,2015
508772,3.5,106294.0,13300,13800,71660,7,500,2014
518092,3.5,127365.0,4575,5200,71660,8,625,2015
302131,4.2,42043.0,27700,27800,59100,2,100,2015
305816,2.5,61185.0,8675,9000,59100,5,325,2015
333487,1.9,130444.0,2550,1200,82750,10,-1350,2015
490149,2.0,121018.0,5100,4600,73130,9,-500,2015
250994,3.7,15037.0,20300,21400,59100,1,1100,2015
73721,4.2,25890.0,30700,28500,68360,0,-2200,2014
155308,2.4,88357.0,9700,7800,73100,6,-1900,2015
439708,2.0,138990.0,525,250,74430,18,-275,2015
70258,3.0,35197.0,22200,21750,77030,2,-450,2015
58892,3.5,78825.0,12500,11300,77030,4,-1200,2015
98031,2.2,39867.0,15950,10000,68360,3,-5950,2015
424662,4.7,24263.0,20700,21400,61450,2,700,2015
280238,2.9,43854.0,26200,25500,59100,3,-700,2015
490270,3.8,34275.0,27700,27750,73130,2,50,2015
3442,2.8,82643.0,3525,5000,77030,7,1475,2014
334486,4.3,32988.0,22200,20600,82750,3,-1600,2015
6595,4.3,61785.0,37800,41500,77030,2,3700,2014
287532,2.4,224037.0,10200,5250,59100,7,-4950,2015
264075,4.4,17659.0,11100,11600,59100,4,500,2015
277767,4.0,46071.0,10900,12700,59100,4,1800,2015
497984,4.2,41533.0,12650,12900,73130,1,250,2015
128884,1.9,165506.0,775,650,73100,11,-125,2015
472414,4.9,10941.0,26400,27500,62930,1,1100,2015
415776,2.0,164777.0,3900,2300,61450,14,-1600,2015
247062,4.2,31769.0,22400,23800,59100,3,1400,2015
16756,3.7,30771.0,19200,19250,77030,4,50,2015
533721,2.9,126225.0,2125,1100,82150,10,-1025,2015
406930,4.8,16081.0,12300,11800,61450,1,-500,2015
543481,4.6,19170.0,12100,13400,81400,4,1300,2015
349750,4.8,7016.0,47000,46500,62960,0,-500,2014
352199,2.5,97391.0,4375,4300,62960,7,-75,2015
487860,4.6,33428.0,18050,18500,73130,1,450,2015
461179,1.9,134634.0,1825,900,61490,12,-925,2015
509751,3.2,43488.0,13750,12700,71660,3,-1050,2015
434851,1.9,164263.0,2200,1000,74430,11,-1200,2015
383464,2.4,34949.0,19050,16100,65610,2,-2950,2014
212925,3.5,91552.0,24500,26400,57290,3,1900,2015
526015,3.8,36111.0,34900,30400,70210,2,-4500,2015
466134,2.7,145800.0,3050,4000,61490,10,950,2015
427494,2.7,104309.0,5000,4900,61450,10,-100,2015
482093,3.4,57868.0,12200,12500,73130,2,300,2015
243617,4.2,21267.0,29400,28500,59100,3,-900,2015
199822,4.2,56080.0,22300,22200,67090,3,-100,2015
381401,3.6,53541.0,7675,8900,64520,3,1225,2015
295097,3.5,125671.0,4275,4000,59100,9,-275,2015
59295,4.4,36609.0,10800,10500,77030,1,-300,2015
67525,4.2,48420.0,8475,7000,77030,1,-1475,2015
196050,2.0,25623.0,29000,26250,67090,2,-2750,2015
144158,4.9,17226.0,27700,28900,73100,2,1200,2015
127421,5.0,16962.0,28600,27500,73100,2,-1100,2015
149136,4.3,33862.0,22800,23500,73100,2,700,2015
514069,4.0,39049.0,21300,21500,71660,3,200,2015
427412,2.7,93684.0,11950,10100,61450,7,-1850,2015
121316,4.4,15569.0,52500,52000,73100,1,-500,2014
331012,2.7,21749.0,11450,9500,82750,1,-1950,2015
398613,,160162.0,3500,5000,61450,11,1500,2014
493704,4.3,26324.0,18700,20400,73130,3,1700,2015
346403,4.3,99527.0,14500,12000,82750,8,-2500,2015
185640,3.1,40676.0,19850,19600,63250,2,-250,2015
470837,3.1,70751.0,6000,5400,62930,6,-600,2014
411551,3.6,81983.0,9550,9100,61450,4,-450,2015
267217,5.0,17968.0,20900,21000,59100,1,100,2015
145776,4.3,28292.0,22800,20400,73100,3,-2400,2015
374270,4.5,34681.0,13600,13500,64520,3,-100,2015
496573,2.6,42153.0,8350,8200,73130,2,-150,2015
30104,3.5,65432.0,10100,10000,77030,5,-100,2015
160086,3.4,33925.0,18950,17000,73100,3,-1950,2015
193259,4.2,32020.0,13350,13300,67090,2,-50,2015
307599,4.5,22630.0,12050,12400,59100,3,350,2015
479629,4.1,40390.0,13750,13400,73130,1,-350,2015
277561,3.5,18369.0,26500,27200,59100,1,700,2015
401149,4.5,21758.0,20100,21300,61450,1,1200,2015
104336,2.8,142259.0,3800,3400,68360,9,-400,2015
237250,4.6,3954.0,23900,23900,59100,0,0,2014
210833,4.8,45112.0,18400,19000,57290,2,600,2015
12283,2.5,274711.0,1525,1700,77030,16,175,2014
349196,4.2,35657.0,34200,36000,62960,3,1800,2014
548875,3.9,102998.0,18050,17100,48460,3,-950,2015
172549,3.7,30817.0,19050,19700,73100,4,650,2015
378235,3.4,70459.0,14150,16400,64520,8,2250,2015
323311,3.3,76664.0,10350,10300,82750,4,-50,2015
145310,4.9,59922.0,24100,25300,73100,4,1200,2015
488748,3.0,35164.0,17050,15600,73130,2,-1450,2015
543162,3.6,70408.0,11800,12000,81400,2,200,2015
419100,3.7,22564.0,13850,14200,61450,2,350,2015
193574,1.0,108208.0,1275,350,67090,16,-925,2015
128666,3.6,50597.0,13850,14100,73100,7,250,2015
169213,2.5,55901.0,5125,3400,73100,5,-1725,2015
314360,1.9,148528.0,4050,3300,59100,9,-750,2015
272553,4.2,46172.0,14950,17000,59100,4,2050,2015
386561,4.6,52140.0,11300,12100,65610,3,800,2015
531708,4.1,45915.0,16450,15800,82150,2,-650,2015
222737,2.0,285901.0,3075,3200,89090,8,125,2014
51299,4.1,84267.0,4700,7000,77030,9,2300,2015
550073,2.9,50465.0,9175,8800,48460,2,-375,2015
426907,3.5,100041.0,5050,3500,61450,5,-1550,2015
332509,4.1,41815.0,11700,11900,82750,3,200,2015
233007,4.7,51918.0,9200,10000,89090,3,800,2015
311734,4.2,17513.0,11600,11900,59100,2,300,2015
511901,3.6,107256.0,8650,8600,71660,7,-50,2015
467658,2.8,101859.0,4425,3700,61490,8,-725,2015
140566,3.4,126240.0,5550,5900,73100,12,350,2015
370246,2.5,120933.0,4175,5400,64520,8,1225,2015
173024,3.7,104923.0,19400,14600,83200,3,-4800,2014
229886,4.1,54273.0,10800,11300,89090,2,500,2015
156932,1.9,53929.0,8350,4100,73100,4,-4250,2015
13242,4.3,11528.0,21300,24000,77030,4,2700,2015
97404,3.6,24210.0,12000,10400,68360,1,-1600,2015
46475,3.5,139840.0,4100,5300,77030,12,1200,2015
478632,4.1,38860.0,13500,13400,73130,3,-100,2015
475959,4.4,75200.0,5375,6800,73130,10,1425,2014
499743,4.6,21752.0,16250,16800,80610,4,550,2015
55959,2.5,117118.0,6175,7900,77030,8,1725,2015
450683,4.5,18621.0,16550,16000,61490,0,-550,2014
429058,2.8,125175.0,2325,2650,61450,13,325,2015
130001,4.4,42879.0,14250,14200,73100,1,-50,2015
5698,4.9,17565.0,16200,16200,77030,0,0,2014
532316,2.1,115280.0,7575,5800,82150,7,-1775,2015
311656,3.1,63236.0,13100,13600,59100,2,500,2015
173676,,188351.0,2825,3500,83200,13,675,2014
232596,3.1,139709.0,5000,4700,89090,9,-300,2015
273845,4.0,19579.0,22800,25000,59100,1,2200,2015
19828,2.9,36349.0,12300,13500,77030,1,1200,2015
432460,2.0,11420.0,17250,17100,74430,0,-150,2014
370085,3.9,141034.0,6375,7100,64520,11,725,2015
200937,2.8,29398.0,35900,35000,67090,3,-900,2015
254686,2.6,38128.0,30100,30800,59100,1,700,2015
478763,4.5,25831.0,23800,24400,73130,4,600,2015
102670,4.6,40252.0,10050,9800,68360,1,-250,2015
145967,4.0,83487.0,9025,11800,73100,12,2775,2015
515123,3.4,23524.0,26800,28000,71660,2,1200,2015
121326,4.4,11458.0,24500,24500,73100,1,0,2014
506083,,156672.0,1225,1050,80200,10,-175,2014
467157,1.9,161356.0,3200,5700,61490,16,2500,2015
546146,4.2,16528.0,19400,20200,81400,1,800,2015
548500,3.8,44570.0,7750,8900,48460,2,1150,2015
326369,4.2,37989.0,14000,13700,82750,3,-300,2015
105816,4.3,32818.0,21700,22600,68360,1,900,2015
248535,3.4,40962.0,11000,10800,59100,2,-200,2015
84053,4.4,8028.0,12550,12000,68360,1,-550,2015
518714,3.5,101302.0,10800,10300,71660,2,-500,2015
455551,2.6,110344.0,7300,8500,61490,8,1200,2015
274308,4.2,37354.0,12800,14400,59100,4,1600,2015
260714,3.0,185727.0,3250,2900,59100,12,-350,2015
22475,3.5,137024.0,5075,4100,77030,11,-975,2015
336315,2.1,52390.0,10700,8900,82750,3,-1800,2015
369287,3.2,58760.0,17500,17200,64520,8,-300,2015
406693,4.4,27134.0,18100,16900,61450,1,-1200,2015
181637,4.5,43054.0,16400,17200,83200,3,800,2015
440561,2.2,129551.0,1075,500,74430,14,-575,2015
57087,3.9,51797.0,10350,9800,77030,3,-550,2015
389876,2.0,162844.0,900,900,65610,17,0,2015
503936,4.1,79872.0,8750,9300,80610,8,550,2015
93680,2.6,105636.0,7875,9900,68360,8,2025,2015
197112,2.4,165243.0,1625,2500,67090,14,875,2015
321342,4.3,41877.0,16400,16800,82750,3,400,2014
459620,4.2,112071.0,7900,9700,61490,4,1800,2015
88070,4.0,47678.0,31800,32500,68360,3,700,2015
527266,2.0,141453.0,2475,1500,70210,19,-975,2015
238527,1.9,176082.0,3825,4100,59100,9,275,2014
208403,4.4,26648.0,22400,22200,57290,2,-200,2015
356004,2.0,167714.0,1550,950,62960,14,-600,2015
198527,1.0,64058.0,4675,2600,67090,14,-2075,2015
198530,2.8,23432.0,10850,10500,67090,1,-350,2015
375420,4.1,77340.0,18300,19000,64520,5,700,2015
239646,3.2,11994.0,21100,18400,59100,1,-2700,2014
250954,1.9,126389.0,1675,400,59100,12,-1275,2015
221291,3.8,19802.0,14200,14200,57290,3,0,2015
233240,2.5,25138.0,21900,17400,59100,3,-4500,2014
466157,4.3,54530.0,10550,11000,61490,3,450,2015
447983,3.9,78491.0,15450,15800,56120,5,350,2015
345607,2.4,14858.0,8450,8000,82750,2,-450,2015
91609,1.0,134082.0,2400,600,68360,13,-1800,2015
333004,2.6,34581.0,13000,11900,82750,4,-1100,2015
422753,3.6,33131.0,22100,21100,61450,0,-1000,2015
344745,4.5,96415.0,15550,16600,82750,4,1050,2015
506099,,166183.0,925,600,80200,12,-325,2014
381353,4.1,17698.0,10700,11100,64520,2,400,2015
10993,2.0,100998.0,4000,2200,77030,11,-1800,2015
367167,4.6,24053.0,11900,12500,64520,2,600,2015
435039,2.9,42019.0,10050,10400,74430,3,350,2015
202203,1.6,85570.0,6925,7500,57290,6,575,2014
104213,2.0,95064.0,6350,4100,68360,6,-2250,2015
540724,3.3,120191.0,1800,1500,81400,10,-300,2015
360434,1.9,83443.0,6975,6700,62960,7,-275,2015
197406,2.5,94200.0,3975,3700,67090,9,-275,2015
120820,1.9,162063.0,1600,800,73100,14,-800,2015
30646,4.0,9535.0,34800,34000,77030,1,-800,2015
81039,2.8,3686.0,14000,13400,68360,1,-600,2015
325073,2.5,19918.0,10250,9700,82750,4,-550,2015
71354,2.3,54591.0,9850,9900,77030,2,50,2015
181746,3.0,25511.0,16950,17900,83200,1,950,2015
116163,3.0,62148.0,35500,36250,68360,4,750,2015
444337,4.6,37063.0,23200,23900,56120,3,700,2014
544940,3.3,40702.0,11200,11800,81400,2,600,2015
125162,3.5,42623.0,15550,14300,73100,3,-1250,2015
281325,4.2,12221.0,48900,48000,59100,0,-900,2015
124865,4.2,44973.0,36500,36250,73100,3,-250,2015
249402,2.2,160116.0,4025,3100,59100,9,-925,2015
7616,,149480.0,1175,950,77030,12,-225,2014
66031,4.2,24331.0,24100,23750,77030,1,-350,2015
314182,3.3,71433.0,8075,8500,59100,3,425,2015
500058,4.8,29268.0,28100,30100,80610,2,2000,2015
218154,3.5,31285.0,13100,12900,57290,1,-200,2015
391082,5.0,15708.0,14600,14300,65610,1,-300,2015
15750,2.0,126799.0,6375,9400,77030,14,3025,2015
144492,4.1,35268.0,31800,27800,73100,2,-4000,2015
335472,3.6,33167.0,20200,19900,82750,2,-300,2015
187538,2.1,76174.0,10600,10000,63250,8,-600,2015
217961,2.7,132695.0,1525,1800,57290,13,275,2015
259123,4.2,87519.0,19750,19800,59100,5,50,2015
212752,4.4,42033.0,12200,12500,57290,1,300,2015
7630,2.5,186855.0,1200,1950,77030,14,750,2014
426129,2.8,194162.0,2875,3000,61450,9,125,2015
185582,3.9,67862.0,8000,9100,63250,5,1100,2015
235999,,24721.0,16200,10800,59100,0,-5400,2014
453389,4.3,32064.0,20200,20200,61490,1,0,2015
159547,4.0,27400.0,18800,19800,73100,1,1000,2015
315665,3.8,49387.0,11250,11100,59100,5,-150,2015
75950,,124219.0,6375,7100,68360,7,725,2014
407757,2.7,101623.0,11100,8700,61450,9,-2400,2015
518372,2.6,104342.0,9200,8200,71660,4,-1000,2015
69467,3.5,61260.0,8550,8700,77030,2,150,2015
175709,2.8,176403.0,1675,1600,83200,10,-75,2015
368403,4.2,39404.0,34500,31000,64520,3,-3500,2015
74306,2.4,162910.0,4025,3400,68360,9,-625,2015
248417,3.5,36593.0,11900,11700,59100,1,-200,2015
143790,5.0,23590.0,24800,26000,73100,3,1200,2015
65479,3.9,17382.0,29000,27750,77030,3,-1250,2015
13691,2.0,62813.0,9050,8700,77030,3,-350,2015
237693,3.4,55799.0,15000,15900,59100,4,900,2015
276166,3.5,19942.0,12950,13000,59100,3,50,2015
175218,3.5,71568.0,5875,4650,83200,7,-1225,2015
528306,4.1,10978.0,20000,20000,70210,1,0,2015
431385,2.8,142903.0,2700,3000,61450,7,300,2015
282098,2.7,53899.0,13250,12800,59100,2,-450,2015
437934,1.0,368971.0,1275,900,74430,14,-375,2015
231924,4.1,50154.0,7975,7900,89090,2,-75,2015
1189,3.7,43096.0,19550,19250,77030,2,-300,2014
73631,4.4,22668.0,19250,21000,68360,0,1750,2014
360060,3.3,53459.0,22200,23250,62960,2,1050,2015
396292,3.0,54001.0,9150,4100,65610,4,-5050,2015
236298,3.0,49918.0,16750,16200,59100,1,-550,2014
255868,4.0,34534.0,13100,14000,59100,2,900,2015
251261,4.0,21115.0,18850,18400,59100,1,-450,2015
307435,2.7,82857.0,20900,19200,59100,8,-1700,2015
448741,1.9,86027.0,5200,3600,61490,4,-1600,2014
441866,4.3,88852.0,14400,15200,74430,6,800,2015
365021,4.5,65611.0,19300,21100,64520,4,1800,2015
328243,4.3,96983.0,31500,30250,82750,4,-1250,2015
203837,4.5,18660.0,22700,23000,57290,1,300,2015
480898,2.1,115930.0,2875,2300,73130,10,-575,2015
361191,,117002.0,4200,4500,64520,8,300,2014
485158,4.4,41262.0,18750,18400,73130,2,-350,2015
131529,4.1,39128.0,29700,30750,73100,2,1050,2015
394607,3.6,110847.0,6700,7400,65610,3,700,2015
64989,4.6,7055.0,21400,22750,77030,1,1350,2015
518131,4.9,37587.0,20700,21700,71660,1,1000,2015
233851,2.2,94762.0,4550,3700,59100,7,-850,2015
452701,3.7,81551.0,20300,19700,61490,4,-600,2015
367546,2.8,144976.0,2950,2500,64520,9,-450,2015
543400,3.7,60652.0,31100,29300,81400,3,-1800,2015
344190,2.4,19388.0,22600,21100,82750,2,-1500,2015
120644,1.9,44892.0,36000,30000,73100,9,-6000,2014
504528,4.3,29644.0,12000,13600,80610,3,1600,2015
323597,1.0,99918.0,4700,1200,82750,12,-3500,2015
137883,4.2,18394.0,8100,7300,73100,3,-800,2015
442471,4.0,24916.0,27800,27500,74430,1,-300,2015
17157,3.5,130344.0,7725,9800,77030,11,2075,2015
160627,4.6,26369.0,30500,31500,73100,1,1000,2015
451759,3.5,9990.0,17000,17000,61490,1,0,2015
222659,2.0,122212.0,11050,11500,89090,5,450,2014
380029,4.0,10151.0,31300,32250,64520,1,950,2015
384645,3.5,33490.0,9625,9400,65610,5,-225,2015
179843,3.1,42431.0,10500,10500,83200,1,0,2015
143760,3.8,27271.0,23400,24300,73100,3,900,2015
136848,3.6,34396.0,10600,9800,73100,5,-800,2015
356749,3.8,19371.0,25000,24000,62960,1,-1000,2015
374307,2.5,127592.0,2875,3600,64520,8,725,2015
226842,3.3,212678.0,1350,1800,89090,12,450,2015
297246,4.9,7333.0,27300,26800,59100,1,-500,2015
539984,3.5,17691.0,29900,30000,81400,2,100,2015
442832,1.9,125290.0,3425,2500,74430,10,-925,2015
270652,3.6,40631.0,17400,17500,59100,1,100,2015
512728,1.9,74644.0,7800,5700,71660,7,-2100,2015
526251,3.2,128324.0,6050,5500,70210,8,-550,2015
454547,3.0,96741.0,9800,11500,61490,4,1700,2015
349854,3.5,35971.0,12150,12100,62960,2,-50,2014
127567,4.2,10101.0,18500,19700,73100,1,1200,2015
438111,3.3,137223.0,3925,3800,74430,11,-125,2015
4459,2.4,119462.0,2900,3100,77030,10,200,2014
253261,4.7,21345.0,18900,19400,59100,1,500,2015
377823,1.9,285041.0,325,500,64520,12,175,2015
449087,,126004.0,6475,5700,61490,8,-775,2014
484441,3.0,8502.0,14000,13900,73130,1,-100,2015
515590,4.3,9797.0,19100,22000,71660,3,2900,2015
270585,1.9,184546.0,1050,1300,59100,15,250,2015
116089,3.9,35674.0,20600,21900,68360,3,1300,2015
62893,2.8,60249.0,9175,8900,77030,2,-275,2015
449749,2.0,43506.0,10650,5300,61490,2,-5350,2014
439918,4.8,26198.0,22500,23100,74430,2,600,2015
260622,2.0,81013.0,5825,900,59100,10,-4925,2015
384980,4.9,55024.0,26300,29000,65610,3,2700,2015
86719,3.7,152301.0,6925,10900,68360,7,3975,2015
470099,4.1,28898.0,17900,18500,61490,2,600,2015
153689,4.4,65512.0,14950,15500,73100,2,550,2015
196179,3.7,53672.0,10100,11700,67090,3,1600,2015
296205,3.3,96079.0,14200,13500,59100,4,-700,2015
455245,4.6,90632.0,8925,9800,61490,9,875,2015
268658,3.3,82941.0,10050,9500,59100,4,-550,2015
236488,3.9,39454.0,13350,13500,59100,1,150,2015
267483,3.9,36966.0,11800,11700,59100,2,-100,2015
196404,3.7,16542.0,15400,14500,67090,1,-900,2015
259134,2.6,106400.0,25100,24800,59100,5,-300,2015
547642,2.4,136394.0,5250,3000,78090,10,-2250,2015
109482,3.6,36451.0,12800,12800,68360,3,0,2015
150588,4.2,56290.0,10150,10100,73100,2,-50,2015
329659,2.8,9429.0,18150,17100,82750,3,-1050,2015
287010,4.4,8396.0,16650,17100,59100,2,450,2015
28484,3.5,60770.0,18300,17900,77030,2,-400,2015
8487,4.7,10297.0,39100,38250,77030,1,-850,2014
506803,2.2,165735.0,1975,2100,80200,14,125,2015
540880,4.7,5196.0,19950,19900,81400,3,-50,2015
420662,2.3,143423.0,3900,4900,61450,13,1000,2015
450175,2.9,92762.0,8350,8300,61490,2,-50,2014
84956,4.0,25691.0,39500,39000,68360,2,-500,2015
48436,4.4,9282.0,22700,24600,77030,1,1900,2015
361762,4.0,14124.0,12000,12600,64520,1,600,2014
123588,3.9,23882.0,22100,22300,73100,3,200,2015
152,3.8,28172.0,22300,21000,77030,1,-1300,2014
518336,3.6,28957.0,12700,13500,71660,3,800,2015
246130,4.3,13620.0,21000,21400,59100,1,400,2015
85090,1.9,64855.0,8275,5200,68360,4,-3075,2015
341289,4.6,55010.0,23500,24201,82750,2,701,2015
286492,2.7,40497.0,12500,10200,59100,3,-2300,2015
493208,4.3,31515.0,20000,20700,73130,3,700,2015
377288,1.9,111807.0,4025,4100,64520,9,75,2015
379401,5.0,11256.0,20500,20000,64520,0,-500,2015
550349,2.0,139135.0,1425,300,54620,9,-1125,2015
231851,4.2,37465.0,23000,22900,89090,1,-100,2015
459883,3.9,131875.0,4400,4500,61490,10,100,2015
243072,3.8,15348.0,14650,15100,59100,1,450,2015
69182,2.9,132589.0,13700,14100,77030,8,400,2015
399729,4.8,30253.0,16300,17700,61450,1,1400,2015
505789,3.5,116090.0,2925,3700,80610,11,775,2015
484330,3.8,42424.0,11550,10800,73130,3,-750,2015
292190,5.0,6123.0,39400,41000,59100,1,1600,2015
272173,3.6,74232.0,11300,11000,59100,3,-300,2015
304007,2.4,89350.0,2225,1600,59100,11,-625,2015
298741,3.1,66834.0,4375,5500,59100,5,1125,2015
164915,4.4,7334.0,28300,27400,73100,1,-900,2015
245375,3.8,37160.0,14350,15300,59100,6,950,2015
355180,1.9,109096.0,1750,1700,62960,13,-50,2015
348363,,164108.0,850,1400,62960,12,550,2014
416044,3.7,31475.0,11000,10700,61450,3,-300,2015
251759,2.0,104640.0,2100,1000,59100,12,-1100,2015
136958,2.9,94496.0,7900,7100,73100,8,-800,2015
262234,4.5,25750.0,12300,12200,59100,1,-100,2015
359703,3.0,63887.0,6925,5500,62960,4,-1425,2015
294396,4.0,82949.0,10650,10300,59100,7,-350,2015
256096,3.8,92312.0,5825,5400,59100,5,-425,2015
133771,4.7,11574.0,10800,10900,73100,2,100,2015
218638,2.7,149846.0,5700,8900,57290,7,3200,2015
283354,4.1,26084.0,7800,8600,59100,5,800,2015
198683,3.3,49549.0,11050,11600,67090,2,550,2015
185841,2.7,120385.0,6075,5200,63250,8,-875,2015
195595,2.9,19786.0,33400,32400,67090,2,-1000,2015
187100,4.2,40165.0,27500,27200,63250,1,-300,2015
536440,3.4,49519.0,12700,14100,73640,3,1400,2015
159914,5.0,15417.0,31400,29500,73100,0,-1900,2015
352572,4.2,51906.0,15900,15800,62960,11,-100,2015
376754,4.1,65947.0,22700,23900,64520,3,1200,2015
196841,1.0,179298.0,2450,750,67090,11,-1700,2015
305300,3.8,34136.0,10700,11500,59100,2,800,2015
27875,2.5,24298.0,12550,11500,77030,3,-1050,2015
216245,4.8,10735.0,33600,34000,57290,1,400,2015
419127,3.1,118557.0,7625,8500,61450,9,875,2015
354301,2.2,158982.0,1925,2900,62960,10,975,2015
344221,2.6,34652.0,16150,14700,82750,3,-1450,2015
428966,2.9,79345.0,8825,11500,61450,10,2675,2015
438831,3.5,86439.0,19700,18200,74430,2,-1500,2015
526037,5.0,6480.0,33600,37200,70210,1,3600,2015
243316,4.3,24143.0,23600,25300,59100,2,1700,2015
352518,2.7,67499.0,15900,14700,62960,7,-1200,2015
93166,3.7,103830.0,11150,11800,68360,7,650,2015
192541,2.5,73183.0,15300,16200,67090,3,900,2015
510401,4.3,35538.0,19700,19700,71660,3,0,2015
207926,4.6,85318.0,16750,19400,57290,7,2650,2015
222235,2.0,56551.0,3750,3500,89090,14,-250,2015
510642,2.1,134448.0,3125,3200,71660,7,75,2015
383119,4.8,28062.0,19500,21100,65610,1,1600,2014
61772,3.6,35634.0,21300,21500,77030,1,200,2015
509928,3.9,40599.0,13200,14600,71660,2,1400,2015
249468,1.9,108311.0,3650,2000,59100,10,-1650,2015
173450,,1.0,5150,3100,83200,9,-2050,2014
123133,2.0,75013.0,850,1700,73100,18,850,2015
45751,2.4,228665.0,2075,3300,77030,13,1225,2015
439261,3.2,40957.0,22800,22800,74430,2,0,2015
436898,2.0,77038.0,9275,9000,74430,8,-275,2015
269855,4.0,15993.0,12550,12600,59100,1,50,2015
210584,4.0,60607.0,31500,30800,57290,2,-700,2015
249854,4.8,11944.0,21300,21700,59100,1,400,2015
373001,3.9,92544.0,6000,7200,64520,6,1200,2015
78142,4.0,98346.0,23900,23900,68360,4,0,2015
363732,3.7,24648.0,22600,21600,64520,3,-1000,2015
420388,4.1,10169.0,14700,15100,61450,1,400,2015
216632,4.4,22537.0,18850,19000,57290,2,150,2015
550030,3.4,128068.0,3900,4100,48460,7,200,2015
313897,2.5,22525.0,61000,52600,59100,3,-8400,2015
391315,4.9,29365.0,11600,11600,65610,1,0,2015
159665,4.0,23166.0,16250,16900,73100,1,650,2015
291579,4.3,46106.0,17100,17000,59100,1,-100,2015
45174,3.9,111156.0,4250,4000,77030,9,-250,2015
180564,4.3,23939.0,16650,18200,83200,1,1550,2015
399187,4.2,59336.0,8975,8900,61450,2,-75,2014
474918,1.9,57972.0,10350,8500,73130,3,-1850,2014
142177,4.7,33046.0,27000,30500,73100,3,3500,2015
348597,3.8,49413.0,20600,20300,62960,2,-300,2015
336193,4.8,7900.0,22500,24000,82750,1,1500,2015
171011,3.1,41287.0,29500,30600,73100,3,1100,2015
346688,2.7,36391.0,13600,11700,82750,2,-1900,2015
107366,3.5,93541.0,20900,21000,68360,5,100,2015
352771,2.0,1.0,5475,1050,62960,12,-4425,2015
317150,2.5,115066.0,7200,7000,73200,5,-200,2015
428005,1.9,139604.0,2125,1800,61450,9,-325,2015
181965,2.5,21926.0,20400,20000,83200,1,-400,2015
286503,4.0,18963.0,13400,13600,59100,1,200,2015
391520,5.0,10810.0,17950,18900,65610,1,950,2015
300852,3.0,8899.0,35900,38600,59100,0,2700,2015
179750,4.3,105800.0,10100,10800,83200,4,700,2015
495717,3.9,13681.0,19100,18100,73130,1,-1000,2015
140944,4.8,11354.0,48000,45000,73100,3,-3000,2015
203174,2.4,96933.0,11500,13000,57290,7,1500,2015
195529,2.9,57717.0,10050,9500,67090,2,-550,2015
403373,3.7,125897.0,6450,7000,61450,9,550,2015
170017,5.0,12799.0,37900,36750,73100,1,-1150,2015
373106,4.8,34554.0,11500,11700,64520,2,200,2015
309730,3.5,74504.0,9825,9500,59100,2,-325,2015
17942,4.4,43722.0,10200,12300,77030,3,2100,2015
418482,2.0,166187.0,2025,1000,61450,15,-1025,2015
125049,3.6,36541.0,12200,13200,73100,3,1000,2015
295545,2.5,65094.0,12900,9900,59100,3,-3000,2015
119225,4.4,16353.0,16300,16400,73100,3,100,2014
191542,2.0,155171.0,1075,325,67090,21,-750,2014
188387,1.9,150232.0,3900,4300,63250,8,400,2015
130144,4.2,43573.0,10900,10600,73100,2,-300,2015
416897,2.7,118184.0,2325,2200,61450,15,-125,2015
342260,3.2,76120.0,9050,8900,82750,9,-150,2015
406206,4.5,20877.0,11500,12000,61450,2,500,2015
10828,2.4,121034.0,12050,11000,77030,7,-1050,2014
125956,4.2,52463.0,12300,13100,73100,3,800,2015
50125,2.0,152278.0,2575,1600,77030,14,-975,2015
249198,4.3,128932.0,10450,10800,59100,6,350,2015
214172,3.8,41532.0,45300,49000,57290,2,3700,2015
476682,,27938.0,25700,25300,73130,1,-400,2014
467255,3.6,8719.0,17550,17100,61490,1,-450,2015
2932,2.8,74029.0,11000,12000,77030,5,1000,2014
508999,3.7,46764.0,11700,10800,71660,1,-900,2014
26611,3.7,44454.0,9550,10400,77030,3,850,2015
515068,4.3,52727.0,8900,9100,71660,2,200,2015
460803,3.7,134481.0,8250,9700,61490,7,1450,2015
391301,1.5,176399.0,2025,1800,65610,11,-225,2015
18540,4.6,7085.0,19150,20500,77030,1,1350,2015
137523,3.5,44843.0,15200,15900,73100,3,700,2015
449957,3.8,62422.0,5850,6100,61490,4,250,2014
358232,2.6,57577.0,15950,15500,62960,2,-450,2015
433188,1.9,130993.0,1625,650,74430,10,-975,2014
374715,4.3,30574.0,23500,24200,64520,2,700,2015
495332,3.5,34824.0,21400,20500,73130,3,-900,2015
410885,3.7,26311.0,12750,12500,61450,3,-250,2015
360311,3.5,53290.0,21300,19500,62960,10,-1800,2015
446864,2.2,140314.0,3250,3200,56120,10,-50,2015
301995,4.3,15589.0,20900,21200,59100,1,300,2015
242120,4.0,52894.0,21400,21100,59100,3,-300,2015
182948,,153450.0,7625,6200,63250,8,-1425,2014
60989,3.9,44583.0,41200,41000,77030,4,-200,2015
451410,2.8,110147.0,3400,4100,61490,12,700,2015
242928,3.9,78580.0,2125,3200,59100,8,1075,2015
42343,2.8,117385.0,3250,4000,77030,10,750,2015
210155,3.5,151375.0,6450,6400,57290,10,-50,2015
48140,2.0,70858.0,6150,5500,77030,4,-650,2015
497023,2.7,37346.0,20400,20300,73130,3,-100,2015
479801,4.4,52705.0,10950,13300,73130,3,2350,2015
282401,1.9,151520.0,1350,1100,59100,10,-250,2015
441467,4.4,97176.0,5025,5800,74430,11,775,2015
411772,1.9,136229.0,1775,2700,61450,6,925,2015
6513,2.6,62803.0,10650,10300,77030,2,-350,2014
253031,4.7,55913.0,28300,30800,59100,5,2500,2015
85686,3.7,29221.0,13900,13400,68360,2,-500,2015
501900,2.5,38228.0,22800,26250,80610,4,3450,2015
365271,1.0,246365.0,775,275,64520,19,-500,2015
341898,1.9,121890.0,1950,1600,82750,14,-350,2015
178104,4.2,47407.0,23400,24400,83200,3,1000,2015
306974,2.4,38374.0,9775,9000,59100,3,-775,2015
157317,2.8,33500.0,19150,18400,73100,2,-750,2015
286526,3.9,32238.0,13600,14700,59100,3,1100,2015
412047,1.9,156291.0,2475,1000,61450,9,-1475,2015
378880,1.0,105980.0,4500,700,64520,7,-3800,2015
320112,,49188.0,10450,8800,82750,3,-1650,2014
308015,4.0,11453.0,20300,19200,59100,1,-1100,2015
524000,,54435.0,6800,7300,70210,4,500,2014
181755,4.0,19886.0,17000,18000,83200,1,1000,2015
144587,4.2,27591.0,15100,17000,73100,3,1900,2015
10424,1.9,36222.0,12300,9250,77030,2,-3050,2014
416812,2.9,126601.0,6225,6700,61450,9,475,2015
508988,4.1,40586.0,21100,20500,71660,1,-600,2014
400410,3.7,124186.0,15150,13800,61450,8,-1350,2015
332655,3.9,35957.0,17900,19600,82750,3,1700,2015
420193,4.4,125759.0,12600,13500,61450,8,900,2015
487357,2.3,51186.0,14450,11000,73130,5,-3450,2015
317281,3.5,98551.0,4900,7100,73200,8,2200,2015
126418,4.1,25205.0,10750,10800,73100,3,50,2015
327717,4.2,39077.0,13300,14100,82750,4,800,2015
232364,4.4,112692.0,2550,3500,89090,8,950,2015
106878,4.6,73661.0,28100,28000,68360,3,-100,2015
138928,4.2,34833.0,10500,10400,73100,3,-100,2015
336730,2.7,43851.0,19750,19500,82750,4,-250,2015
501681,3.6,48732.0,22700,22900,80610,4,200,2015
20684,4.8,70573.0,22000,21000,77030,4,-1000,2015
455630,3.5,118953.0,4650,6700,61490,8,2050,2015
33397,4.1,23131.0,36100,36250,77030,3,150,2015
385347,4.8,24147.0,12300,12000,65610,2,-300,2015
345904,2.1,47442.0,24600,22200,82750,2,-2400,2015
417368,2.8,137604.0,11100,9200,61450,6,-1900,2015
362883,3.7,54878.0,9400,8500,64520,3,-900,2014
470557,4.3,123339.0,12500,11900,62930,6,-600,2014
374447,4.3,12699.0,13350,13700,64520,3,350,2015
304496,3.7,43986.0,11350,11500,59100,2,150,2015
107075,4.7,28802.0,18850,19200,68360,3,350,2015
352556,3.2,109116.0,15150,13500,62960,9,-1650,2015
546824,4.6,16331.0,37700,37600,81400,0,-100,2015
150265,2.0,57402.0,14900,15200,73100,2,300,2015
103600,1.9,110732.0,6975,5600,68360,7,-1375,2015
233276,2.8,35085.0,17150,15200,59100,4,-1950,2015
318821,1.1,110212.0,3275,1500,73200,8,-1775,2015
112291,3.4,88514.0,5725,5700,68360,4,-25,2015
249490,4.0,9435.0,12600,10200,59100,1,-2400,2015
170518,3.6,21216.0,24300,24750,73100,2,450,2015
109635,1.9,173278.0,6750,3800,68360,4,-2950,2015
3822,4.2,143199.0,6125,6600,77030,8,475,2014
232039,2.7,111477.0,3725,3700,89090,11,-25,2015
237207,4.8,5197.0,29800,30100,59100,0,300,2014
444523,,82370.0,6000,5500,56120,8,-500,2014
424763,3.5,31313.0,14800,15200,61450,3,400,2015
221220,3.9,63697.0,24200,23900,57290,3,-300,2015
74860,,110290.0,1425,1600,68360,11,175,2014
66417,4.4,11141.0,14350,13750,77030,1,-600,2015
333204,4.9,19235.0,30100,30500,82750,2,400,2015
227,3.9,12154.0,27900,27500,77030,1,-400,2014
282249,2.2,112711.0,8950,7000,59100,5,-1950,2015
31602,4.9,75348.0,35400,36750,77030,3,1350,2015
274948,1.9,101833.0,5275,3200,59100,12,-2075,2015
195069,2.7,60634.0,9900,7500,67090,4,-2400,2015
164058,4.3,39957.0,21300,23100,73100,3,1800,2015
34990,2.0,11834.0,11550,6600,77030,0,-4950,2015
398639,2.2,153444.0,2400,2800,61450,11,400,2014
488252,2.0,170657.0,3850,2800,73130,9,-1050,2015
394745,4.8,41158.0,19700,19600,65610,2,-100,2015
473915,4.2,92677.0,10150,11300,62930,5,1150,2015
468988,1.9,153649.0,2000,1000,61490,9,-1000,2015
208746,3.7,41234.0,13800,13500,57290,1,-300,2015
373519,4.8,34448.0,14300,14700,64520,2,400,2015
533245,2.6,91100.0,2150,1700,82150,14,-450,2015
61373,2.3,47354.0,6325,5200,77030,4,-1125,2015
437655,3.6,76435.0,8650,8200,74430,4,-450,2015
450981,3.8,131437.0,3150,3500,61490,5,350,2014
452384,2.6,82762.0,9300,9800,61490,9,500,2015
500771,4.9,22047.0,14150,11900,80610,2,-2250,2015
521129,4.5,38926.0,14100,13700,71660,3,-400,2015
196763,4.3,6635.0,19100,17400,67090,1,-1700,2015
276505,4.4,33275.0,16400,16000,59100,4,-400,2015
217313,4.8,38559.0,35200,38000,57290,3,2800,2015
445647,4.4,64789.0,13900,14900,56120,3,1000,2015
89052,3.2,23708.0,15400,15800,68360,3,400,2015
407828,4.3,34351.0,9850,9500,61450,2,-350,2015
451899,4.4,118224.0,6325,7500,61490,6,1175,2015
466070,2.8,139615.0,3575,5000,61490,4,1425,2015
384065,4.4,19752.0,12150,11300,65610,1,-850,2015
455813,3.5,166091.0,2325,3300,61490,13,975,2015
233673,2.4,30509.0,11950,10600,59100,5,-1350,2014
486522,2.4,53676.0,12950,12300,73130,2,-650,2015
478884,4.9,22936.0,26800,28400,73130,1,1600,2015
10516,3.1,89937.0,10450,11500,77030,4,1050,2015
166481,3.8,119632.0,8625,8500,73100,9,-125,2015
166496,2.5,124934.0,4800,4800,73100,11,0,2015
322763,4.4,9425.0,22600,22600,82750,1,0,2015
129734,2.8,39143.0,13100,13800,73100,4,700,2015
103654,3.4,112929.0,5200,6100,68360,8,900,2015
345440,3.6,33522.0,9950,9400,82750,3,-550,2015
298146,4.1,51571.0,12800,13100,59100,2,300,2015
192352,4.9,14169.0,11400,11300,67090,1,-100,2015
423575,3.9,31661.0,18800,18000,61450,1,-800,2015
386605,3.0,60725.0,3000,1800,65610,31,-1200,2015
61987,3.3,15797.0,12850,10500,77030,3,-2350,2015
324136,2.9,55104.0,1725,2650,82750,15,925,2015
361392,4.2,70616.0,24500,22250,64520,2,-2250,2014
425605,2.8,98330.0,2100,2500,61450,8,400,2015
352820,4.9,5790.0,35000,34100,62960,2,-900,2015
164465,3.8,19510.0,12350,13600,73100,3,1250,2015
440957,2.7,193124.0,5150,5900,74430,8,750,2015
148861,4.9,14661.0,35400,37250,73100,4,1850,2015
407537,4.2,28347.0,14100,15000,61450,3,900,2015
350236,4.3,41542.0,17950,19600,62960,7,1650,2014
165631,2.4,33131.0,10650,9000,73100,3,-1650,2015
143320,4.4,7216.0,19200,18600,73100,2,-600,2015
17808,4.5,24160.0,12200,14000,77030,2,1800,2015
268155,1.9,149074.0,2700,2300,59100,11,-400,2015
154082,4.4,32184.0,15100,16000,73100,1,900,2015
489770,4.0,18766.0,18700,20600,73130,1,1900,2015
481221,1.9,88597.0,2275,1050,73130,11,-1225,2015
532639,2.9,88748.0,9275,8000,82150,3,-1275,2015
22556,2.6,72584.0,7525,10600,77030,12,3075,2015
71106,3.8,15004.0,22300,22000,77030,1,-300,2015
238955,4.7,10726.0,12800,13900,59100,1,1100,2015
315727,3.3,181945.0,2975,2300,59100,11,-675,2015
93442,4.9,3886.0,25700,25500,68360,4,-200,2015
291221,3.6,30759.0,15050,14600,59100,2,-450,2015
507610,4.1,102364.0,7100,7700,80200,3,600,2015
474829,4.2,45323.0,28500,29500,73130,3,1000,2014
466347,1.0,130429.0,9200,8600,61490,10,-600,2015
94704,2.0,1.0,1975,350,68360,12,-1625,2015
356381,2.8,106700.0,8525,11200,62960,7,2675,2015
462647,3.9,47159.0,12650,14800,61490,3,2150,2015
359980,3.7,59920.0,30700,30000,62960,2,-700,2015
520015,4.2,78448.0,11550,12600,71660,4,1050,2015
167321,5.0,17326.0,20300,20100,73100,0,-200,2015
189588,4.4,61616.0,12550,13000,63250,3,450,2015
547644,1.9,115802.0,3250,700,78090,12,-2550,2015
545725,4.8,4314.0,41900,41000,81400,0,-900,2015
432225,2.9,111490.0,4825,4800,61450,10,-25,2015
185095,1.9,112185.0,5850,4600,63250,5,-1250,2015
237528,3.9,30746.0,28100,28000,59100,2,-100,2014
506747,3.5,172075.0,17950,16000,80200,5,-1950,2015
429774,2.9,44492.0,12050,10600,61450,2,-1450,2015
22254,1.9,57994.0,8625,8400,77030,7,-225,2015
206439,3.3,114296.0,4975,5600,57290,6,625,2015
73038,3.8,79388.0,19600,18500,77030,4,-1100,2015
59742,4.2,62025.0,12900,12500,77030,2,-400,2015
176308,4.8,39868.0,9275,10400,83200,5,1125,2015
18909,4.1,11110.0,24000,25500,77030,3,1500,2015
470913,4.2,85496.0,13200,12700,62930,2,-500,2015
426764,3.7,23550.0,11250,11700,61450,2,450,2015
468931,1.9,159661.0,6875,6800,61490,5,-75,2015
100834,2.3,118065.0,21000,22100,68360,5,1100,2015
541604,4.8,32675.0,20600,22600,81400,3,2000,2015
98988,4.0,38184.0,17000,16800,68360,3,-200,2015
170450,3.7,52732.0,37000,36800,73100,2,-200,2015
45975,3.2,64536.0,19850,19100,77030,3,-750,2015
131224,2.0,149345.0,650,700,73100,14,50,2015
290081,1.9,184211.0,1900,2000,59100,14,100,2015
530990,4.1,54173.0,11800,10700,82150,2,-1100,2015
382592,4.8,56673.0,5750,8800,65610,7,3050,2014
130745,3.5,44128.0,18300,18300,73100,4,0,2015
512336,3.8,73000.0,11700,13000,71660,6,1300,2015
38372,5.0,16364.0,44800,49600,77030,3,4800,2015
199748,2.7,43152.0,13950,13600,67090,2,-350,2015
5210,1.0,244874.0,1000,500,77030,17,-500,2014
213888,4.8,11368.0,59300,63200,57290,1,3900,2015
233804,2.6,73290.0,10700,8000,59100,6,-2700,2014
179622,2.9,148895.0,4000,6200,83200,12,2200,2015
111988,4.3,63173.0,25000,24750,68360,4,-250,2015
429951,3.2,77441.0,4075,6000,61450,11,1925,2015
93835,4.9,13267.0,21300,22000,68360,1,700,2015
501731,3.7,24405.0,19400,18500,80610,1,-900,2015
479686,4.4,26515.0,27400,27000,73130,3,-400,2015
378955,2.4,125937.0,7450,8000,64520,11,550,2015
382262,3.4,131229.0,5800,5800,65610,4,0,2014
223107,2.4,155803.0,3950,4400,89090,7,450,2015
485853,3.0,21562.0,13300,12900,73130,1,-400,2015
235278,,146488.0,4000,2100,59100,10,-1900,2014
286326,1.9,120682.0,4025,6100,59100,13,2075,2015
88086,1.9,19367.0,12900,10000,68360,3,-2900,2015
367187,3.6,20342.0,14500,14200,64520,2,-300,2015
106375,2.0,137180.0,14850,11000,68360,7,-3850,2015
146731,4.5,84259.0,7500,6700,73100,4,-800,2015
435834,2.1,131978.0,1000,900,74430,11,-100,2015
313058,3.0,73907.0,2950,3700,59100,10,750,2015
446566,3.6,112502.0,5325,4800,56120,9,-525,2015
391838,2.5,99734.0,3875,3600,65610,8,-275,2015
444009,2.9,180902.0,2000,2200,74430,11,200,2015
16190,4.4,33981.0,35900,36500,77030,3,600,2015
139748,1.0,131701.0,4125,1100,73100,10,-3025,2015
177797,3.7,35911.0,11400,11300,83200,2,-100,2015
252372,3.5,35762.0,20200,19400,59100,3,-800,2015
393502,4.6,56917.0,13150,13000,65610,2,-150,2015
304997,3.5,52792.0,13700,13600,59100,2,-100,2015
203799,4.4,17169.0,19350,19400,57290,1,50,2015
114425,2.4,91706.0,9550,9900,68360,10,350,2015
18566,4.9,6389.0,13300,14100,77030,1,800,2015
185328,4.1,61622.0,13650,13800,63250,2,150,2015
358436,2.2,107395.0,5100,5600,62960,7,500,2015
90834,3.7,107782.0,12200,12100,68360,4,-100,2015
322996,4.8,5072.0,12500,14000,82750,2,1500,2015
108758,4.7,14127.0,26500,26300,68360,0,-200,2015
175178,4.4,26419.0,9350,10500,83200,3,1150,2015
203765,4.9,23209.0,12250,12700,57290,3,450,2015
395333,3.3,60500.0,8075,8700,65610,3,625,2015
473013,3.8,54170.0,14200,13900,62930,2,-300,2015
549836,2.7,36096.0,23600,21700,48460,2,-1900,2015
477703,4.6,19768.0,20400,20900,73130,1,500,2015
57653,4.3,30409.0,18700,18300,77030,1,-400,2015
458449,4.6,79891.0,12850,13100,61490,9,250,2015
404906,5.0,57743.0,24400,26800,61450,4,2400,2015
125038,3.7,19485.0,13200,11800,73100,3,-1400,2015
312150,4.5,16225.0,11900,12500,59100,2,600,2015
534403,2.6,80849.0,8375,6800,82150,3,-1575,2015
362854,3.2,97105.0,7300,7600,64520,3,300,2014
50081,2.2,123044.0,2550,3200,77030,12,650,2015
78987,2.5,114344.0,5450,4100,68360,5,-1350,2015
528994,2.9,34473.0,10950,11200,70210,3,250,2015
14541,4.4,18428.0,23800,24200,77030,2,400,2015
52360,1.9,184707.0,2375,1700,77030,10,-675,2015
52456,2.2,164413.0,1575,2200,77030,12,625,2015
35088,4.4,48367.0,9600,11200,77030,2,1600,2015
459688,2.4,88815.0,7400,6800,61490,5,-600,2015
82364,3.0,9816.0,27100,26500,68360,1,-600,2015
439872,2.8,101099.0,9375,9200,74430,9,-175,2015
497074,3.1,34245.0,14450,13300,73130,3,-1150,2015
49194,4.7,29148.0,26300,27250,77030,3,950,2015
431804,3.2,60948.0,6600,8600,61450,8,2000,2015
184681,3.4,49749.0,10000,11600,63250,5,1600,2015
301513,4.8,27892.0,10100,11400,59100,3,1300,2015
134597,4.8,16029.0,25900,23750,73100,2,-2150,2015
25523,3.7,8698.0,22400,19600,77030,1,-2800,2015
255382,4.4,18737.0,28000,29300,59100,2,1300,2015
90346,3.6,18440.0,26600,24300,68360,1,-2300,2015
252670,3.7,29069.0,14850,13700,59100,3,-1150,2015
59855,4.2,32617.0,11450,9250,77030,2,-2200,2015
375065,4.2,81923.0,10250,10500,64520,3,250,2015
129925,4.9,93725.0,5325,7100,73100,9,1775,2015
200946,3.2,89926.0,13000,9400,67090,5,-3600,2015
483503,4.6,69398.0,12350,12100,73130,3,-250,2015
183493,,69234.0,14700,14000,63250,1,-700,2014
382440,,160298.0,10900,12600,65610,6,1700,2014
499493,4.0,41957.0,40400,40500,80610,1,100,2015
307900,3.9,82055.0,3725,4000,59100,11,275,2015
142810,3.3,65511.0,13800,12100,73100,8,-1700,2015
251716,3.0,133594.0,5375,6400,59100,9,1025,2015
307976,1.9,164384.0,900,700,59100,14,-200,2015
301724,3.8,80369.0,5975,6800,59100,8,825,2015
73266,,99975.0,16100,15600,68360,3,-500,2014
481895,4.9,42343.0,23800,24100,73130,4,300,2015
159567,4.0,31891.0,18200,18400,73100,1,200,2015
130750,4.8,8736.0,28400,27000,73100,4,-1400,2015
194122,3.5,81917.0,12800,11200,67090,3,-1600,2015
119676,2.7,42255.0,19600,17400,73100,4,-2200,2015
208558,4.2,60186.0,9750,11200,57290,4,1450,2015
488357,4.6,14017.0,19650,20200,73130,2,550,2015
479925,2.5,38642.0,23300,23300,73130,4,0,2015
265226,4.0,15665.0,11700,11500,59100,1,-200,2015
484053,2.1,21983.0,11300,10200,73130,3,-1100,2015
323039,3.9,34796.0,28600,27500,82750,3,-1100,2015
228259,2.0,178836.0,1150,500,89090,15,-650,2015
191564,,31053.0,17850,11900,67090,1,-5950,2014
362967,2.5,57149.0,7750,6500,64520,4,-1250,2015
243411,2.8,61456.0,10600,9500,59100,3,-1100,2015
32649,4.3,13579.0,44800,44000,77030,1,-800,2015
213368,2.8,38214.0,14000,12600,57290,3,-1400,2015
532361,3.0,64794.0,7500,5000,82150,9,-2500,2015
322755,4.3,9570.0,22600,23200,82750,1,600,2015
233262,1.0,36063.0,10350,7800,59100,3,-2550,2014
467843,2.3,39497.0,8575,9200,61490,7,625,2015
112259,2.0,155686.0,525,300,68360,15,-225,2015
506222,2.8,94827.0,10750,11800,80200,1,1050,2014
274528,3.7,87347.0,4075,6600,59100,10,2525,2015
35028,4.7,36202.0,11400,12100,77030,2,700,2015
531694,1.9,114608.0,3350,2800,82150,13,-550,2015
502718,4.7,15674.0,15650,15800,80610,1,150,2015
401637,4.3,71537.0,13850,13500,61450,3,-350,2015
313135,3.5,146289.0,4375,4000,59100,12,-375,2015
496153,4.5,13898.0,26100,27700,73130,1,1600,2015
467540,2.9,124924.0,5675,6100,61490,11,425,2015
134502,4.2,101200.0,4850,5700,73100,7,850,2015
458160,2.4,98309.0,3175,2600,61490,6,-575,2015
33514,3.6,68149.0,9900,9700,77030,3,-200,2015
512876,4.8,36286.0,28400,27900,71660,2,-500,2015
171436,4.2,48268.0,23900,25100,73100,4,1200,2015
205256,4.1,126111.0,11250,11700,57290,6,450,2015
466111,2.1,166165.0,5150,5100,61490,11,-50,2015
394707,4.4,15142.0,25500,22200,65610,1,-3300,2015
492438,3.0,20204.0,13700,11500,73130,2,-2200,2015
242897,3.5,63241.0,20500,19400,59100,7,-1100,2015
320282,4.1,170726.0,10300,8500,82750,7,-1800,2015
141432,4.9,66009.0,26000,24500,73100,3,-1500,2015
508358,2.9,41385.0,11150,10300,71660,1,-850,2014
488026,3.7,54981.0,10350,10700,73130,2,350,2015
185638,3.7,16250.0,10250,8000,63250,2,-2250,2015
544973,2.8,46847.0,12650,13500,81400,3,850,2015
221451,2.2,132130.0,2050,3400,57290,12,1350,2015
472045,1.9,79737.0,7200,6300,62930,4,-900,2015
126108,3.2,36750.0,17450,15500,73100,3,-1950,2015
477801,4.0,63498.0,33600,32800,73130,4,-800,2015
202611,3.6,25018.0,12600,13000,57290,3,400,2015
456080,3.7,41427.0,22300,23600,61490,2,1300,2015
121174,3.2,37803.0,16950,16000,73100,2,-950,2015
394799,4.9,22486.0,17500,17500,65610,3,0,2015
276645,3.0,20333.0,13500,13700,59100,1,200,2015
399344,,138766.0,4100,3800,61450,9,-300,2014
195089,2.5,50183.0,7450,7300,67090,5,-150,2015
126130,3.3,48551.0,20700,19800,73100,3,-900,2015
187747,2.7,110528.0,9925,9100,63250,9,-825,2015
48603,3.9,22133.0,13400,14200,77030,2,800,2015
73174,2.3,25115.0,13600,10400,68360,2,-3200,2014
338741,3.6,25847.0,10150,10400,82750,2,250,2015
547987,4.7,22106.0,21400,22000,78090,2,600,2015
524712,,181925.0,600,700,70210,12,100,2014
336347,2.8,33499.0,12400,11400,82750,3,-1000,2015
482227,1.9,33323.0,10300,9000,73130,3,-1300,2015
321105,3.7,28514.0,12700,14400,82750,2,1700,2014
356090,3.6,36060.0,8150,10300,62960,7,2150,2015
430910,2.0,29912.0,11550,7900,61450,1,-3650,2015
442680,1.9,259525.0,1150,1500,74430,10,350,2015
179327,4.4,27782.0,29300,29000,83200,1,-300,2015
545760,3.8,48873.0,23800,24000,81400,4,200,2015
376190,5.0,8731.0,20900,21000,64520,0,100,2015
118227,2.1,108994.0,4000,900,68360,7,-3100,2015
269223,2.7,111739.0,8725,8200,59100,2,-525,2015
344560,2.0,97232.0,10200,8300,82750,7,-1900,2015
270700,2.0,23767.0,13400,9600,59100,1,-3800,2015
242437,4.2,160860.0,6775,6600,59100,8,-175,2015
76817,4.1,1831.0,19200,19200,68360,0,0,2014
465655,4.8,32651.0,20900,22900,61490,1,2000,2015
194035,3.5,114430.0,9225,10800,67090,5,1575,2015
231579,4.1,32681.0,14550,13600,89090,3,-950,2015
366955,4.8,50177.0,17000,17500,64520,3,500,2015
362448,4.7,15658.0,16650,16500,64520,1,-150,2015
14900,4.3,58506.0,16700,17000,77030,5,300,2015
203635,2.0,40520.0,18650,14800,57290,3,-3850,2015
127772,1.0,1.0,3700,1000,73100,15,-2700,2015
136559,1.9,152769.0,1800,1500,73100,10,-300,2015
434864,3.5,141248.0,6250,6100,74430,11,-150,2015
476295,,72009.0,1375,1800,73130,14,425,2014
97073,3.1,89511.0,9075,10200,68360,5,1125,2015
179225,4.6,25894.0,28600,28700,83200,1,100,2015
236688,3.7,61274.0,24000,22200,59100,3,-1800,2015
257969,4.5,13879.0,11200,12200,59100,4,1000,2015
256450,3.8,32510.0,20000,20600,59100,2,600,2015
337803,3.2,38778.0,21100,20000,82750,3,-1100,2015
102977,3.7,107597.0,7850,6700,68360,6,-1150,2015
180909,4.5,32281.0,15800,17200,83200,2,1400,2015
539270,3.7,28632.0,14150,15000,55590,2,850,2015
490205,2.5,49277.0,11600,10400,73130,2,-1200,2015
63722,3.6,31198.0,43100,43500,77030,4,400,2015
181543,4.2,25300.0,41900,40250,83200,3,-1650,2015
114483,3.6,35760.0,10600,10500,68360,2,-100,2015
166336,3.1,81461.0,19450,18500,73100,5,-950,2015
278450,3.8,59132.0,12550,13400,59100,4,850,2015
431537,2.9,141844.0,1700,2800,61450,14,1100,2015
158465,4.1,12650.0,20000,21800,73100,1,1800,2015
309556,3.9,37327.0,20100,21500,59100,2,1400,2015
477079,,107945.0,3475,4400,73130,10,925,2014
513388,4.1,40963.0,18250,18100,71660,1,-150,2015
187722,2.0,102855.0,9275,10000,63250,4,725,2015
258418,3.9,24913.0,22600,21000,59100,3,-1600,2015
136097,2.8,39125.0,17300,16000,73100,3,-1300,2015
124368,4.9,29072.0,31000,32500,73100,3,1500,2015
411723,2.6,106571.0,8500,9400,61450,5,900,2015
546152,4.3,48744.0,21900,24500,81400,1,2600,2015
126751,3.0,14599.0,20200,20300,73100,1,100,2015
506313,3.7,49517.0,9225,9300,80200,4,75,2015
230477,1.9,61791.0,7500,5900,89090,7,-1600,2015
38105,3.6,60613.0,11800,11700,77030,2,-100,2015
146505,4.4,31307.0,19150,18900,73100,1,-250,2015
495700,3.9,18951.0,19100,19200,73130,1,100,2015
32881,4.2,52465.0,12350,12400,77030,2,50,2015
130259,4.3,19365.0,24900,24500,73100,3,-400,2015
161162,3.7,31752.0,12900,13200,73100,3,300,2015
463496,3.9,53700.0,9550,8400,61490,3,-1150,2015
44998,3.5,66664.0,4225,6200,77030,7,1975,2015
51826,3.8,36386.0,19650,22300,77030,3,2650,2015
220087,3.6,38266.0,12650,12800,57290,1,150,2015
534163,1.9,142352.0,7050,5000,82150,13,-2050,2015
3501,,121679.0,17050,15800,77030,7,-1250,2014
342203,1.9,215312.0,725,750,82750,15,25,2015
23706,3.5,78261.0,21200,21000,77030,4,-200,2015
364511,4.6,6419.0,25100,27300,64520,1,2200,2015
177379,5.0,22297.0,17250,19400,83200,1,2150,2015
546246,4.0,23690.0,13750,13000,81400,2,-750,2015
78692,2.9,116809.0,5425,5800,68360,7,375,2014
81014,2.0,191355.0,975,600,68360,12,-375,2015
357956,1.9,30550.0,24400,20000,62960,3,-4400,2015
488680,5.0,14249.0,17300,17000,73130,1,-300,2015
80016,3.0,49637.0,5475,5800,68360,7,325,2015
345805,4.3,26574.0,36400,33250,82750,1,-3150,2015
442954,2.2,129351.0,5200,5500,74430,11,300,2015
495955,5.0,8029.0,23400,24100,73130,0,700,2015
340034,3.7,37265.0,11550,12900,82750,3,1350,2015
131150,3.1,59643.0,16600,16400,73100,7,-200,2015
461845,3.6,108537.0,19900,18500,61490,7,-1400,2015
311173,3.5,130043.0,1825,2700,59100,12,875,2015
27586,4.5,18451.0,14800,15100,77030,2,300,2015
450289,1.9,134401.0,5650,5500,61490,9,-150,2014
270586,1.9,1.0,2700,900,59100,15,-1800,2015
392679,3.5,31656.0,12400,12400,65610,3,0,2015
385321,4.4,3443.0,15300,15600,65610,2,300,2015
476618,,24758.0,35900,34500,73130,1,-1400,2014
288986,3.0,93971.0,6700,5700,59100,9,-1000,2015
482654,4.6,38527.0,11750,10700,73130,3,-1050,2015
74012,2.4,66392.0,4125,3050,68360,8,-1075,2015
256908,2.2,37542.0,20500,18600,59100,4,-1900,2015
305343,5.0,7822.0,21400,23300,59100,2,1900,2015
10294,2.5,32161.0,12200,12700,77030,2,500,2014
458835,4.8,7911.0,18950,19900,61490,1,950,2015
60186,3.8,24875.0,19900,20000,77030,2,100,2015
23319,2.3,23221.0,25900,24500,77030,4,-1400,2015
499832,3.4,128636.0,3250,4000,80610,8,750,2015
336669,1.9,42800.0,21500,19200,82750,4,-2300,2015
410864,2.9,33943.0,20800,18700,61450,3,-2100,2015
300451,3.8,55552.0,22000,22800,59100,3,800,2015
63306,2.0,999999.0,2075,4200,77030,9,2125,2015
291351,2.0,30885.0,14450,12400,59100,1,-2050,2015
366598,4.1,37259.0,17100,16700,64520,4,-400,2015
38972,4.4,11869.0,30800,29100,77030,1,-1700,2015
100752,4.2,53516.0,22100,21500,68360,4,-600,2015
108159,3.6,50479.0,9300,7900,68360,2,-1400,2015
520043,1.9,141208.0,8050,1200,71660,10,-6850,2015
258209,3.9,31457.0,9225,9900,59100,2,675,2015
112739,2.0,164802.0,475,400,68360,15,-75,2015
46401,3.6,100853.0,8825,9600,77030,11,775,2015
265211,4.0,13543.0,17200,17500,59100,1,300,2015
482115,3.5,60296.0,26700,26301,73130,2,-399,2015
544635,4.8,25319.0,21000,21200,81400,1,200,2015
202621,2.5,38990.0,14550,12600,57290,3,-1950,2015
515468,2.5,106720.0,1500,2200,71660,13,700,2015
250946,2.6,182438.0,1000,1400,59100,12,400,2015
142885,3.4,86287.0,5750,7000,73100,9,1250,2015
286913,4.0,20065.0,19650,19500,59100,1,-150,2015
319422,3.7,21125.0,24700,27100,73200,2,2400,2015
383152,4.6,14154.0,16150,16100,65610,1,-50,2014
158810,1.9,103406.0,2625,3650,73100,8,1025,2015
258334,4.9,8025.0,14800,14800,59100,3,0,2015
20932,2.0,169512.0,5775,5500,77030,7,-275,2015
90355,5.0,20404.0,27500,28900,68360,2,1400,2015
505173,4.2,30080.0,10100,11200,80610,3,1100,2015
37317,2.4,36313.0,10250,10900,77030,1,650,2015
378288,3.5,45062.0,13900,14201,64520,1,301,2015
525001,1.9,67709.0,9975,7500,70210,2,-2475,2014
280440,2.6,86775.0,6450,6600,59100,6,150,2015
329874,1.9,37567.0,10900,9200,82750,3,-1700,2015
444228,2.5,58694.0,8475,8200,74430,3,-275,2015
483840,4.1,20556.0,9625,9700,73130,2,75,2015
14049,2.0,30385.0,12600,8500,77030,1,-4100,2015
259150,2.7,87406.0,6925,7700,59100,5,775,2015
163400,4.3,42200.0,39100,39000,73100,3,-100,2015
80626,4.6,23733.0,12350,13200,68360,2,850,2015
42882,4.0,86314.0,7700,10100,77030,9,2400,2015
256690,3.7,38176.0,14650,15300,59100,3,650,2015
435218,3.5,99578.0,5725,6600,74430,9,875,2015
132628,3.5,38665.0,11700,12800,73100,3,1100,2015
41045,4.3,39039.0,9800,10600,77030,2,800,2015
489877,4.0,17265.0,17900,18200,73130,0,300,2015
485105,2.0,28553.0,11300,5000,73130,2,-6300,2015
52475,2.9,129917.0,1025,1450,77030,13,425,2015
188721,4.2,49167.0,10100,10100,63250,2,0,2015
369579,4.8,16505.0,16450,17100,64520,2,650,2015
406975,3.5,44298.0,9375,8700,61450,2,-675,2015
419814,4.4,7428.0,15300,16300,61450,1,1000,2015
456496,3.5,55907.0,2400,3900,61490,17,1500,2015
186795,3.0,114075.0,4850,3300,63250,8,-1550,2015
326858,2.3,182626.0,6750,5700,82750,4,-1050,2015
537483,,115632.0,13750,12400,55590,4,-1350,2014
430426,2.7,80080.0,4200,4000,61450,6,-200,2015
132361,4.4,43033.0,38800,37250,73100,3,-1550,2015
100192,2.7,88286.0,4825,4200,68360,8,-625,2015
338845,3.9,19314.0,24700,25250,82750,1,550,2015
79274,4.3,77937.0,15050,14200,68360,3,-850,2015
106096,3.4,57497.0,14550,14700,68360,1,150,2015
459105,3.4,133709.0,7700,9300,61490,7,1600,2015
422988,2.1,,1075,500,61450,15,-575,2015
4047,3.3,21022.0,12500,11800,77030,0,-700,2014
5820,4.8,22819.0,26400,25300,77030,0,-1100,2014
348971,4.7,21981.0,19000,18800,62960,0,-200,2015
168600,4.2,45076.0,19850,21000,73100,3,1150,2015
39210,4.9,20974.0,18900,19600,77030,2,700,2015
440872,1.9,148886.0,3150,3300,74430,8,150,2015
249320,4.0,14230.0,28800,29000,59100,1,200,2015
84655,3.5,19863.0,20200,19100,68360,1,-1100,2015
493074,3.4,63674.0,7400,8100,73130,5,700,2015
67915,3.5,21025.0,10800,11000,77030,2,200,2015
513650,4.0,59958.0,17500,18400,71660,4,900,2015
359033,4.0,22152.0,10900,11700,62960,3,800,2015
161392,4.3,37378.0,36400,33250,73100,5,-3150,2015
461214,2.4,186026.0,475,1200,61490,15,725,2015
319296,4.3,59594.0,15850,15000,73200,3,-850,2015
1640,4.4,16480.0,70000,72500,77030,2,2500,2014
99149,3.5,73757.0,20300,19100,68360,9,-1200,2015
193073,3.4,29610.0,21400,21500,67090,3,100,2015
515450,1.9,168547.0,1700,1500,71660,12,-200,2015
63403,1.0,27131.0,14650,7400,77030,1,-7250,2015
446355,3.7,41603.0,15400,16800,56120,4,1400,2015
238956,4.7,17809.0,12500,13400,59100,1,900,2015
535713,3.7,53838.0,11000,10800,82150,2,-200,2015
392577,2.8,82614.0,15100,12500,65610,7,-2600,2015
243443,4.4,34304.0,10400,11500,59100,3,1100,2015
42604,4.0,92142.0,7200,8400,77030,5,1200,2015
45679,3.4,88076.0,10650,13000,77030,7,2350,2015
436981,3.1,70190.0,16650,14900,74430,3,-1750,2015
349223,3.7,40889.0,11750,13750,62960,6,2000,2015
329322,4.0,23434.0,11300,12000,82750,4,700,2015
79433,2.9,84380.0,13300,12800,68360,5,-500,2015
67813,2.0,125079.0,3625,1000,77030,9,-2625,2015
533280,3.5,71771.0,8975,7900,82150,5,-1075,2015
454886,1.9,129627.0,2825,2900,61490,10,75,2015
384048,2.5,110974.0,3875,4400,65610,10,525,2015
503470,4.0,15096.0,14750,15100,80610,1,350,2015
368453,2.0,1.0,6350,1650,64520,7,-4700,2015
119771,3.8,114792.0,12250,12800,73100,3,550,2014
445402,2.6,100583.0,7775,7200,56120,7,-575,2015
157173,2.7,50913.0,13900,12400,73100,3,-1500,2015
233906,,177800.0,11150,9200,59100,6,-1950,2014
114491,3.9,62117.0,13300,14500,68360,2,1200,2015
445926,3.5,128276.0,6325,5700,56120,11,-625,2015
215288,4.9,10601.0,16700,17300,57290,1,600,2015
112606,1.9,128064.0,4000,3800,68360,7,-200,2015
514627,1.9,139230.0,5100,4100,71660,5,-1000,2015
336183,4.0,11644.0,25900,25800,82750,1,-100,2015
481612,4.1,10706.0,22600,22800,73130,1,200,2015
259836,4.4,26492.0,30100,33800,59100,3,3700,2015
299697,1.9,138988.0,1000,700,59100,18,-300,2015
308225,2.1,47992.0,12400,11500,59100,2,-900,2015
410879,4.3,47263.0,26500,27000,61450,3,500,2015
158800,3.1,85048.0,25800,25000,73100,6,-800,2015
330414,4.8,14427.0,25100,26000,82750,3,900,2015
467598,4.3,107011.0,7350,9800,61490,3,2450,2015
70411,4.8,16283.0,16100,17100,77030,2,1000,2015
320624,2.1,108395.0,3450,2800,82750,11,-650,2015
173584,2.4,144075.0,6700,3400,83200,11,-3300,2014
14945,4.4,84151.0,16950,19400,77030,6,2450,2015
424169,1.9,103016.0,10100,8000,61450,9,-2100,2015
443308,4.0,21159.0,16200,16300,74430,1,100,2015
310431,2.5,59460.0,13200,13900,59100,4,700,2015
254585,5.0,1751.0,12600,13300,59100,0,700,2015
226949,3.6,62784.0,9925,9400,89090,3,-525,2015
421241,2.3,147976.0,7225,8400,61450,8,1175,2015
535865,3.6,60826.0,9000,9000,82150,4,0,2015
208005,2.0,162141.0,2875,2000,57290,8,-875,2015
366204,2.9,63654.0,22500,22750,64520,3,250,2015
501298,5.0,19092.0,25600,26000,80610,1,400,2015
294940,4.1,55373.0,24400,25000,59100,3,600,2015
535998,1.9,109901.0,6050,5200,82150,10,-850,2015
279462,4.2,79802.0,19850,19600,59100,5,-250,2015
212113,3.9,38570.0,11100,10900,57290,2,-200,2015
168772,4.8,25894.0,17200,18600,73100,3,1400,2015
285102,4.4,18389.0,4000,6400,59100,10,2400,2015
487879,4.4,7762.0,21500,22100,73130,1,600,2015
47980,2.5,41605.0,10600,10500,77030,3,-100,2015
118878,2.8,84355.0,6100,4800,68360,5,-1300,2015
274093,3.9,44233.0,10150,11100,59100,3,950,2015
146181,3.5,17672.0,12650,11400,73100,3,-1250,2015
486390,1.9,109573.0,6675,4800,73130,11,-1875,2015
66977,3.2,82222.0,1525,2900,77030,12,1375,2015
223982,3.5,93317.0,12250,12300,89090,6,50,2015
134842,3.9,45172.0,10600,11000,73100,3,400,2015
136687,4.1,24563.0,12250,12400,73100,3,150,2015
317726,1.9,54394.0,16800,13100,73200,2,-3700,2015
377803,1.9,199045.0,1825,900,64520,10,-925,2015
331472,4.5,29226.0,11700,11600,82750,2,-100,2015
470771,3.8,47663.0,6975,6700,62930,2,-275,2014
364729,2.1,53841.0,38000,36000,64520,3,-2000,2015
175706,4.0,124196.0,3375,3000,83200,9,-375,2015
414383,3.6,17564.0,12650,12000,61450,2,-650,2015
264903,3.2,104348.0,5325,6600,59100,11,1275,2015
241446,3.8,12110.0,19150,18500,59100,2,-650,2014
339066,3.6,79836.0,13650,13100,82750,6,-550,2015
440899,4.2,58678.0,18450,19200,74430,4,750,2015
225139,3.7,110611.0,6800,5700,89090,4,-1100,2015
470797,4.1,63712.0,10500,9700,62930,2,-800,2014
353956,2.0,122336.0,7075,6200,62960,9,-875,2015
543976,3.4,41381.0,18600,17300,81400,7,-1300,2015
42099,4.1,32899.0,15600,15500,77030,1,-100,2015
420719,2.8,81800.0,9750,9400,61450,3,-350,2015
167108,1.9,194914.0,450,250,73100,11,-200,2015
390328,3.6,198005.0,2450,3200,65610,12,750,2015
12845,4.2,11970.0,17300,17100,77030,1,-200,2015
215203,2.6,63533.0,7300,7200,57290,5,-100,2015
89406,3.5,141277.0,5400,5000,68360,5,-400,2015
290706,3.4,211665.0,2800,3300,59100,11,500,2015
198073,2.8,110277.0,8225,9100,67090,11,875,2015
526604,1.0,120795.0,2375,800,70210,10,-1575,2015
55754,4.3,20466.0,73000,74500,77030,1,1500,2015
110127,2.8,56930.0,8975,8500,68360,2,-475,2015
162903,3.5,9892.0,19800,19800,73100,1,0,2015
44882,3.5,64354.0,4200,5100,77030,4,900,2015
182842,,70960.0,10050,8600,63250,8,-1450,2014
440864,1.9,40803.0,8450,7000,74430,6,-1450,2015
90107,4.6,9445.0,44800,45250,68360,1,450,2015
502097,2.9,158307.0,2200,3300,80610,11,1100,2015
355726,2.9,37789.0,24300,24800,62960,2,500,2015
160283,3.5,37342.0,11550,12500,73100,3,950,2015
147398,3.4,58030.0,10150,9100,73100,2,-1050,2015
40931,4.4,24412.0,21300,20250,77030,2,-1050,2015
100065,4.0,23154.0,14650,14600,68360,6,-50,2015
177776,4.0,62626.0,9775,9700,83200,2,-75,2015
240912,2.8,162044.0,875,500,59100,13,-375,2014
170186,3.5,55980.0,8975,9300,73100,2,325,2015
153555,4.9,55935.0,14000,14900,73100,2,900,2015
162811,4.1,79530.0,16000,14900,73100,8,-1100,2015
169056,2.6,110858.0,12300,11800,73100,4,-500,2015
352759,4.5,45782.0,3975,6300,62960,10,2325,2015
121950,2.1,33119.0,13100,16600,73100,2,3500,2014
534124,3.4,114864.0,7650,7000,82150,8,-650,2015
512852,2.3,64553.0,9250,9100,71660,2,-150,2015
57501,4.1,6238.0,59500,60000,77030,3,500,2015
40619,2.3,61032.0,1150,2400,77030,18,1250,2015
15409,1.0,95070.0,1600,900,77030,10,-700,2015
466987,4.0,29974.0,11100,11600,61490,1,500,2015
225501,3.3,145209.0,5875,5500,89090,10,-375,2015
406988,4.2,40168.0,8825,9100,61450,2,275,2015
86141,2.2,73569.0,9000,8000,68360,3,-1000,2015
432562,3.2,69259.0,12850,13100,74430,5,250,2014
418781,2.7,99701.0,6575,6800,61450,8,225,2015
105131,1.9,126233.0,3450,4300,68360,9,850,2015
205766,3.9,29995.0,14750,16400,57290,3,1650,2015
79604,3.2,69181.0,8675,8700,68360,3,25,2015
407252,2.8,109979.0,2850,2700,61450,10,-150,2015
355620,1.0,86901.0,2500,1600,62960,12,-900,2015
309393,4.8,6657.0,10850,9400,59100,1,-1450,2015
514064,3.7,90678.0,17150,17400,71660,3,250,2015
62720,1.9,158295.0,3700,2100,77030,11,-1600,2015
456104,3.5,105125.0,6250,6600,61490,4,350,2015
10663,3.6,123754.0,2275,1900,77030,11,-375,2015
365490,1.9,106935.0,2825,1400,64520,10,-1425,2015
240785,2.4,78202.0,3150,3300,59100,10,150,2014
163172,4.8,18559.0,34200,34800,73100,0,600,2015
263928,4.4,41057.0,18500,18100,59100,4,-400,2015
75345,3.5,29421.0,9250,9500,68360,1,250,2014
327190,1.9,97929.0,11100,8800,82750,7,-2300,2015
290479,4.3,30849.0,14900,15000,59100,3,100,2015
59322,4.3,31128.0,36300,37500,77030,2,1200,2015
502865,1.9,74401.0,6450,6000,80610,9,-450,2015
548564,4.2,23562.0,11500,10900,48460,1,-600,2015
506552,3.5,81039.0,17250,16800,80200,6,-450,2015
338491,4.4,17768.0,11450,11200,82750,3,-250,2015
383717,3.5,75623.0,7800,7800,65610,6,0,2015
36767,3.9,35827.0,17550,19500,77030,4,1950,2015
298299,4.2,115802.0,6625,6400,59100,5,-225,2015
1934,2.0,71171.0,12150,12250,77030,3,100,2014
51410,3.1,146001.0,16700,17400,77030,11,700,2015
517412,2.8,90850.0,6475,7400,71660,5,925,2015
167851,4.1,36811.0,30300,30400,73100,2,100,2015
178829,4.0,26662.0,16950,18400,83200,1,1450,2015
113856,3.7,69968.0,32200,30000,68360,2,-2200,2015
239195,1.9,12725.0,29700,27400,59100,0,-2300,2014
33968,3.5,69206.0,10850,10750,77030,7,-100,2015
39588,3.2,34366.0,10300,8500,77030,2,-1800,2015
429878,4.5,18420.0,21900,21500,61450,0,-400,2015
126764,3.0,16527.0,19800,18800,73100,1,-1000,2015
204646,3.7,23112.0,14300,14000,57290,2,-300,2015
452240,3.5,33751.0,11850,11900,61490,2,50,2015
25286,2.8,97652.0,7425,7700,77030,3,275,2015
468796,2.4,87381.0,4925,6200,61490,13,1275,2015
58557,3.8,16011.0,14800,15200,77030,1,400,2015
270227,2.5,74390.0,7400,6900,59100,4,-500,2015
274622,3.8,161538.0,1850,2000,59100,12,150,2015
420668,1.9,116035.0,4475,2700,61450,14,-1775,2015
543056,1.9,135472.0,5500,4200,81400,9,-1300,2015
517307,4.5,40377.0,14700,14700,71660,2,0,2015
33812,3.5,125907.0,5200,4800,77030,5,-400,2015
372142,1.9,35722.0,28200,26400,64520,3,-1800,2015
473420,2.0,190361.0,2725,1850,62930,14,-875,2015
101345,1.9,175295.0,10000,10500,68360,8,500,2015
477585,2.0,154176.0,7975,5200,73130,10,-2775,2015
479365,3.0,8113.0,13700,13600,73130,1,-100,2015
205502,5.0,15789.0,18200,17700,57290,3,-500,2015
369622,3.9,35686.0,13450,13900,64520,2,450,2015
79223,4.3,51514.0,13550,13700,68360,2,150,2015
463309,3.4,103064.0,8050,8800,61490,6,750,2015
451926,1.9,76705.0,11150,8200,61490,8,-2950,2015
116777,4.7,87104.0,34700,36500,68360,3,1800,2015
542938,2.9,57264.0,9075,10800,81400,6,1725,2015
80686,3.9,43423.0,26700,28700,68360,3,2000,2015
516462,3.7,39100.0,10850,11500,71660,3,650,2015
147307,3.5,62410.0,9875,9300,73100,2,-575,2015
292507,3.8,53890.0,16100,16200,59100,2,100,2015
468182,2.7,95826.0,2425,3300,61490,12,875,2015
267645,3.0,60937.0,14900,14800,59100,3,-100,2015
331351,4.9,9190.0,18450,17800,82750,1,-650,2015
435095,3.6,30228.0,11750,12200,74430,4,450,2015
538387,3.9,67284.0,9350,9100,55590,4,-250,2015
107145,4.2,34035.0,20900,20700,68360,1,-200,2015
81962,2.1,103638.0,3675,2200,68360,8,-1475,2015
120807,3.8,9394.0,29200,27500,73100,0,-1700,2014
379893,3.8,33226.0,18950,18400,64520,3,-550,2015
490313,2.5,17054.0,11700,11200,73130,3,-500,2015
539328,4.0,83508.0,18200,17500,55590,6,-700,2015
61031,2.5,139653.0,5775,5500,77030,6,-275,2015
359626,4.2,54916.0,20100,19500,62960,3,-600,2015
420538,4.1,96728.0,15400,16400,61450,5,1000,2015
29645,4.2,29982.0,54900,56000,77030,3,1100,2015
94538,2.4,123346.0,3950,3100,68360,8,-850,2015
154589,4.2,93962.0,15600,19900,73100,8,4300,2015
475902,4.0,15397.0,15850,15800,73130,1,-50,2015
327480,3.2,111959.0,9225,7800,82750,5,-1425,2015
4437,3.6,137094.0,6350,7600,77030,10,1250,2014
322088,3.1,167350.0,2250,2250,82750,11,0,2014
208030,4.8,30320.0,25800,27100,57290,3,1300,2015
259054,4.2,33549.0,9150,9400,59100,4,250,2015
261697,1.9,79966.0,9250,6000,59100,5,-3250,2015
347274,2.7,37000.0,1525,1550,82750,12,25,2015
175103,3.7,21632.0,11150,10600,83200,2,-550,2015
517191,4.2,37127.0,12850,12900,71660,1,50,2015
84174,4.2,106185.0,11700,11400,68360,5,-300,2015
335323,3.3,37737.0,16150,14700,82750,1,-1450,2015
239223,4.3,20548.0,12200,12500,59100,1,300,2015
94629,3.6,135006.0,2750,3900,68360,9,1150,2015
186673,2.1,86497.0,8725,9000,63250,3,275,2015
38589,3.5,61767.0,10250,10250,77030,3,0,2015
262459,2.0,24193.0,25800,24800,59100,2,-1000,2015
484687,3.4,99096.0,11450,9100,73130,7,-2350,2015
74971,4.9,8273.0,29900,29500,68360,0,-400,2014
103037,1.9,56753.0,14550,15300,68360,8,750,2015
492658,2.0,70859.0,11800,9700,73130,5,-2100,2015
119802,3.5,81654.0,14500,14700,73100,4,200,2014
487688,4.1,34341.0,10700,10200,73130,3,-500,2015
482835,4.0,28256.0,18400,18000,73130,1,-400,2015
418197,4.8,37493.0,13950,14600,61450,3,650,2015
216419,2.9,98325.0,8325,9100,57290,6,775,2015
249743,4.7,14450.0,12800,13300,59100,1,500,2015
73225,,144286.0,11300,10100,68360,3,-1200,2014
262445,2.0,32483.0,15600,13600,59100,1,-2000,2015
48616,3.7,31942.0,13050,13600,77030,2,550,2015
257089,3.7,46972.0,37800,37500,59100,1,-300,2015
544829,5.0,1310.0,23600,23300,81400,1,-300,2015
509890,4.3,32339.0,17750,17800,71660,1,50,2015
50231,1.0,17584.0,14750,13000,77030,1,-1750,2015
248177,2.3,125865.0,2125,1800,59100,11,-325,2015
381437,4.6,19097.0,16600,18750,64520,5,2150,2015
402902,2.0,236791.0,525,500,61450,12,-25,2015
249916,4.0,18003.0,15700,15600,59100,1,-100,2015
295567,2.9,33488.0,12050,10800,59100,3,-1250,2015
47845,4.4,25421.0,29200,29500,77030,3,300,2015
51217,3.6,91138.0,11750,14500,77030,8,2750,2015
974,3.6,34682.0,16500,18100,77030,2,1600,2014
161055,3.6,7685.0,10750,9800,73100,3,-950,2015
456823,4.4,14692.0,16650,17000,61490,1,350,2015
88749,2.8,96206.0,15400,14200,68360,6,-1200,2015
475414,,110306.0,2825,2900,73130,7,75,2014
462796,2.9,119029.0,4050,4100,61490,11,50,2015
20428,4.2,70161.0,10200,10500,77030,3,300,2015
384190,3.9,31709.0,13350,13000,65610,3,-350,2015
520808,3.7,32966.0,25800,25300,71660,1,-500,2015
396647,4.4,23667.0,28500,28100,65610,1,-400,2015
546497,2.2,120836.0,2275,2500,81400,14,225,2015
442140,4.0,21115.0,14150,14000,74430,1,-150,2015
228761,1.9,116365.0,1300,1400,89090,11,100,2015
19729,4.1,31861.0,9725,12000,77030,1,2275,2015
329892,1.0,20363.0,15100,9500,82750,1,-5600,2015
382751,3.9,111267.0,5925,6100,65610,8,175,2014
43634,3.7,116890.0,6375,6700,77030,7,325,2015
261084,2.9,101992.0,3925,4500,59100,9,575,2015
536230,2.8,128029.0,6100,4450,82150,8,-1650,2015
411850,2.3,240004.0,2200,2900,61450,7,700,2015
349711,3.3,59661.0,13300,12900,62960,1,-400,2015
216135,4.9,10522.0,12800,13800,57290,1,1000,2015
385240,2.0,95874.0,6075,4500,65610,7,-1575,2015
535862,3.6,51674.0,5600,4900,82150,4,-700,2015
124879,3.5,27498.0,39900,37000,73100,3,-2900,2015
15780,3.5,139240.0,950,1150,77030,16,200,2015
250356,3.5,74112.0,5550,5800,59100,6,250,2015
52758,3.6,33511.0,23700,24000,77030,4,300,2015
504353,1.9,140289.0,5625,4200,80610,10,-1425,2015
508798,4.1,102212.0,9300,7750,71660,3,-1550,2014
60410,3.1,92938.0,10400,11750,77030,7,1350,2015
404591,3.0,42158.0,17250,17000,61450,3,-250,2015
493858,3.3,47669.0,10900,11000,73130,3,100,2015
412853,4.3,29166.0,31000,31000,61450,4,0,2015
187372,2.0,26617.0,17900,11200,63250,1,-6700,2015
18232,3.5,41637.0,12600,12700,77030,2,100,2015
374600,3.3,29964.0,13850,13400,64520,2,-450,2015
31998,2.6,79760.0,14800,14200,77030,6,-600,2015
203260,4.0,16189.0,13250,13200,57290,3,-50,2015
44092,3.9,63021.0,18850,20500,77030,3,1650,2015
474229,2.6,51748.0,7650,6600,62930,2,-1050,2015
139313,3.7,9539.0,13550,14700,73100,3,1150,2015
227189,2.7,113064.0,7000,6200,89090,9,-800,2015
84274,4.4,3253.0,21100,20700,68360,1,-400,2015
231862,4.9,55934.0,13150,12700,89090,2,-450,2015
85752,4.7,39273.0,22600,24200,68360,3,1600,2015
299056,2.5,111575.0,2050,1700,59100,15,-350,2015
395105,4.2,63670.0,10550,10400,65610,5,-150,2015
34251,2.0,154684.0,5775,2500,77030,9,-3275,2015
304388,2.0,119270.0,3275,1600,59100,9,-1675,2015
393298,3.5,52067.0,14900,13400,65610,5,-1500,2015
469732,2.7,53508.0,9925,10300,61490,2,375,2015
209994,4.1,160519.0,3100,4200,57290,7,1100,2015
360568,4.8,45474.0,20200,20900,64520,3,700,2014
331422,4.8,32377.0,22800,24600,82750,2,1800,2015
116819,4.2,46612.0,23000,23400,68360,3,400,2015
2690,2.0,,3700,2200,77030,5,-1500,2015
76135,4.1,43169.0,21300,22200,68360,1,900,2014
133170,3.6,77512.0,6050,7000,73100,8,950,2015
376734,4.1,48496.0,13550,13900,64520,2,350,2015
188000,4.3,29370.0,26500,26750,63250,1,250,2015
125267,2.8,31401.0,9825,9600,73100,4,-225,2015
161602,4.2,12451.0,9425,9500,73100,1,75,2015
284643,4.4,27747.0,12750,13200,59100,3,450,2015
155850,3.7,37255.0,15700,14600,73100,2,-1100,2015
5284,,76047.0,425,300,77030,21,-125,2014
337829,4.4,96263.0,7725,9100,82750,3,1375,2015
415046,4.6,40073.0,14300,15100,61450,2,800,2015
398164,2.1,80828.0,10850,9000,61450,7,-1850,2014
249622,3.0,131289.0,3675,3600,59100,12,-75,2015
297248,2.5,102618.0,6125,5300,59100,11,-825,2015
422269,4.4,9113.0,11700,12600,61450,1,900,2015
225670,1.9,132772.0,5450,5900,89090,9,450,2015
100646,4.7,20544.0,24000,28000,68360,2,4000,2015
39078,4.9,1361.0,22600,17100,77030,1,-5500,2015
127617,3.6,49062.0,8125,8200,73100,4,75,2015
476200,,204261.0,1575,900,73130,13,-675,2014
70199,2.7,23471.0,11500,10700,77030,1,-800,2015
495328,4.1,39623.0,22500,22900,73130,3,400,2015
62606,2.5,150355.0,11700,9250,77030,7,-2450,2015
478345,2.4,124404.0,3200,4600,73130,8,1400,2015
136950,3.3,59347.0,10700,11800,73100,7,1100,2015
406026,3.3,35678.0,18000,18800,61450,4,800,2015
45115,2.4,85927.0,9475,7750,77030,8,-1725,2015
154570,4.4,27946.0,20500,22400,73100,8,1900,2015
44779,3.8,14423.0,15550,16500,77030,3,950,2015
68171,2.0,114330.0,4350,7500,77030,9,3150,2015
427230,1.9,134832.0,2450,1700,61450,7,-750,2015
247363,4.3,38464.0,13950,14500,59100,2,550,2015
323593,3.3,124024.0,3475,4500,82750,12,1025,2015
150123,2.4,60944.0,7275,6800,73100,3,-475,2015
50812,4.2,21779.0,13100,15400,77030,3,2300,2015
319007,3.3,47406.0,15150,11000,73200,3,-4150,2015
71390,4.0,50058.0,9675,9800,77030,2,125,2015
442651,1.9,105461.0,10850,9400,74430,7,-1450,2015
199051,2.2,81941.0,4425,3500,67090,9,-925,2015
251091,3.0,59329.0,425,350,59100,23,-75,2015
97525,4.8,42629.0,34300,37750,68360,11,3450,2015
217095,3.4,195616.0,2900,3000,57290,12,100,2015
216373,3.9,24354.0,12700,13000,57290,3,300,2015
457534,4.4,37629.0,18950,20200,61490,3,1250,2015
26326,1.0,147130.0,3325,1250,77030,9,-2075,2015
288068,2.0,26717.0,14800,11000,59100,1,-3800,2015
231704,3.7,114687.0,8025,7000,89090,5,-1025,2015
150670,3.8,22307.0,15300,14200,73100,2,-1100,2015
259497,3.6,50724.0,12950,11200,59100,2,-1750,2015
317025,3.6,98163.0,15000,15900,73200,7,900,2015
370823,4.4,41431.0,16600,16900,64520,2,300,2015
360838,2.0,127467.0,3775,2200,64520,9,-1575,2014
50341,1.0,34584.0,12600,9100,77030,2,-3500,2015
205205,4.1,64820.0,18050,17700,57290,4,-350,2015
382428,4.8,8763.0,17850,16100,65610,0,-1750,2014
111865,4.4,28776.0,27200,29100,68360,3,1900,2015
296424,4.6,30082.0,20700,21900,59100,1,1200,2015
333005,2.8,57539.0,14950,13800,82750,4,-1150,2015
325890,3.9,46944.0,15150,15300,82750,7,150,2015
508651,4.2,27493.0,29000,28250,71660,6,-750,2014
155596,2.0,35416.0,9500,7700,73100,3,-1800,2015
484417,4.0,20480.0,12100,12200,73130,1,100,2015
365283,2.0,60330.0,9650,7100,64520,2,-2550,2015
484860,4.9,17307.0,22800,23900,73130,1,1100,2015
98587,4.5,6604.0,14900,15800,68360,1,900,2015
382884,2.5,145011.0,10450,10000,65610,10,-450,2014
88516,2.0,31110.0,15600,13500,68360,3,-2100,2015
545233,4.0,33114.0,14200,14600,81400,1,400,2015
180732,4.3,45234.0,8075,8901,83200,2,826,2015
248422,3.8,39887.0,11800,12100,59100,1,300,2015
75105,,153402.0,675,700,68360,16,25,2014
149471,4.0,23021.0,26700,27750,73100,2,1050,2015
346613,4.7,21247.0,28600,30200,82750,1,1600,2015
280899,2.6,33452.0,9525,7600,59100,2,-1925,2015
505500,3.9,14987.0,32900,31000,80610,3,-1900,2015
425564,3.1,81124.0,6850,7500,61450,6,650,2015
424366,3.5,55216.0,8200,7200,61450,3,-1000,2015
440244,2.4,166015.0,2450,2900,74430,13,450,2015
38143,2.1,61354.0,9600,10500,77030,4,900,2015
167406,2.3,18965.0,20200,17900,73100,3,-2300,2015
145856,3.4,30603.0,11950,12100,73100,4,150,2015
343909,3.2,30827.0,12700,12500,82750,2,-200,2015
203102,4.1,42662.0,22300,20900,57290,3,-1400,2015
313929,4.4,134971.0,9025,9900,59100,4,875,2015
130142,3.5,20826.0,12150,11300,73100,2,-850,2015
286476,4.0,39937.0,23000,24400,59100,3,1400,2015
549005,2.9,95881.0,4425,2000,48460,9,-2425,2015
170306,4.7,24391.0,26800,26400,73100,2,-400,2015
230023,2.9,103910.0,9200,9100,89090,7,-100,2015
287185,3.9,58183.0,29900,31800,59100,5,1900,2015
408508,4.3,18148.0,12800,12500,61450,2,-300,2015
114755,4.5,12470.0,57600,15700,68360,1,-41900,2015
115934,4.0,48479.0,9300,9700,68360,2,400,2015
174010,3.8,55397.0,13200,13500,83200,3,300,2015
536278,2.0,215038.0,975,300,82150,13,-675,2015
534663,3.7,52160.0,16600,16200,82150,2,-400,2015
191305,,78691.0,3400,5100,67090,8,1700,2014
73219,4.3,23410.0,17350,18900,68360,4,1550,2015
146454,3.6,108819.0,9650,11600,73100,10,1950,2015
42069,1.9,210273.0,325,275,77030,18,-50,2015
204406,5.0,29842.0,13400,14100,57290,1,700,2015
298333,2.5,163626.0,4500,3900,59100,9,-600,2015
147674,4.3,25339.0,21100,20700,73100,2,-400,2015
383775,2.6,233909.0,2350,1050,65610,9,-1300,2014
164277,3.7,117029.0,16250,15800,73100,8,-450,2015
448991,2.6,124454.0,3250,4200,61490,8,950,2015
284450,4.1,35675.0,13550,15200,59100,3,1650,2015
369357,2.0,121279.0,1100,1750,64520,11,650,2015
366891,4.1,44813.0,32900,33000,64520,3,100,2015
64364,1.9,151161.0,2475,2300,77030,10,-175,2015
58638,2.0,22566.0,45100,28000,77030,0,-17100,2015
336689,3.9,47555.0,17100,17800,82750,4,700,2015
108952,3.8,140666.0,7975,8300,68360,5,325,2015
186,3.7,17337.0,23600,20250,77030,1,-3350,2014
193399,2.9,66712.0,16600,16000,67090,4,-600,2015
123450,3.6,29601.0,16350,17000,73100,3,650,2015
416977,1.9,71763.0,6050,5000,61450,7,-1050,2015
377268,1.9,124162.0,4350,3000,64520,8,-1350,2015
262564,3.6,10339.0,27300,26500,59100,1,-800,2015
468471,1.9,191681.0,1100,1000,61490,17,-100,2015
11818,2.7,54945.0,10200,8500,77030,6,-1700,2015
338357,4.3,54842.0,12400,12600,82750,2,200,2015
4755,2.1,100116.0,1850,1400,77030,12,-450,2014
30074,4.3,41945.0,18200,18000,77030,4,-200,2015
364573,2.6,115731.0,8450,13300,64520,4,4850,2015
263686,3.5,60391.0,9500,9300,59100,3,-200,2015
127751,1.9,82514.0,7325,4000,73100,10,-3325,2015
321163,2.5,194999.0,3525,2800,82750,13,-725,2014
403754,3.5,66655.0,12250,11500,61450,3,-750,2015
512254,3.4,30473.0,19550,18200,71660,4,-1350,2015
167003,4.3,62219.0,8650,10900,73100,6,2250,2015
319525,3.6,76145.0,4725,5700,73200,9,975,2015
43401,5.0,9986.0,25300,27000,77030,1,1700,2015
259144,3.6,73876.0,7750,8400,59100,5,650,2015
396439,2.4,93218.0,15650,16800,65610,6,1150,2015
323475,4.4,35278.0,44100,42400,82750,5,-1700,2015
249234,2.9,97237.0,11450,10500,59100,7,-950,2015
547906,1.9,160301.0,4350,2200,78090,8,-2150,2015
544289,4.4,37582.0,16200,17200,81400,1,1000,2015
379337,4.8,38546.0,20300,21800,64520,3,1500,2015
78517,3.1,40815.0,10700,10600,68360,1,-100,2014
163579,1.9,126803.0,4800,4500,73100,9,-300,2015
519004,3.3,120380.0,18200,16700,71660,5,-1500,2015
117379,2.0,32976.0,43600,40600,68360,0,-3000,2015
351299,3.5,72825.0,11200,11300,62960,4,100,2015
367114,1.0,1.0,2525,300,64520,13,-2225,2015
255223,2.9,127972.0,5500,4800,59100,7,-700,2015
496906,3.0,74423.0,6600,6800,73130,4,200,2015
509502,4.1,37220.0,15650,15700,71660,1,50,2015
58021,3.9,61939.0,16350,9400,77030,2,-6950,2015
405464,2.1,202754.0,1575,2000,61450,16,425,2015
119820,3.5,116321.0,7000,6300,73100,4,-700,2014
12737,3.2,187895.0,5875,7000,77030,13,1125,2015
318438,3.6,66102.0,14900,14600,73200,4,-300,2015
151042,2.3,34355.0,10950,10000,73100,3,-950,2015
26214,4.0,91891.0,4850,6200,77030,11,1350,2015
59121,4.6,25311.0,21800,23525,77030,3,1725,2015
31879,4.1,48522.0,16350,19000,77030,4,2650,2015
15738,1.9,163251.0,875,950,77030,14,75,2015
161636,2.0,172130.0,1950,1600,73100,14,-350,2015
311715,4.4,66463.0,11000,10700,59100,2,-300,2015
539899,2.0,169039.0,1025,825,81400,17,-200,2014
252029,2.7,131378.0,5300,4100,59100,10,-1200,2015
72809,1.9,135043.0,1750,1300,77030,16,-450,2015
27594,3.9,20540.0,19250,18700,77030,2,-550,2015
423830,4.7,39742.0,39900,42000,61450,2,2100,2015
53954,2.0,38572.0,10300,11000,77030,3,700,2015
46859,3.7,25046.0,22100,20400,77030,2,-1700,2015
279570,4.5,19197.0,32400,27600,59100,2,-4800,2015
370731,1.0,182856.0,925,1050,64520,14,125,2015
286007,4.6,20869.0,32600,32600,59100,2,0,2015
366738,4.5,48606.0,7700,13600,64520,10,5900,2015
212340,4.3,51347.0,12250,12200,57290,2,-50,2015
466246,4.4,14728.0,15850,16100,61490,1,250,2015
446609,3.5,61057.0,10750,10000,56120,3,-750,2015
421566,2.6,117316.0,4725,6000,61450,11,1275,2015
213070,3.2,88439.0,9475,10000,57290,8,525,2015
247821,2.4,127262.0,6950,5000,59100,5,-1950,2015
277280,2.9,82165.0,7300,7000,59100,3,-300,2015
23956,2.1,168502.0,3350,3500,77030,11,150,2015
35133,3.8,30086.0,22000,22900,77030,2,900,2015
549144,4.0,104125.0,13950,12100,48460,5,-1850,2015
71729,4.0,92995.0,4300,4700,77030,7,400,2015
55867,2.1,83018.0,4425,5000,77030,5,575,2015
406727,4.4,15731.0,14800,14300,61450,1,-500,2015
530030,3.4,133214.0,7125,7000,82150,10,-125,2015
194720,2.2,116335.0,7000,7400,67090,9,400,2015
92171,3.4,61814.0,10700,10700,68360,2,0,2015
67504,3.6,75493.0,1400,3300,77030,13,1900,2015
446341,4.9,15403.0,26200,26400,56120,1,200,2015
475090,,87710.0,6550,7000,73130,4,450,2014
454911,5.0,11256.0,18400,18500,61490,1,100,2015
5103,2.8,203020.0,825,1600,77030,15,775,2014
262891,4.1,32346.0,13550,13200,59100,2,-350,2015
161962,3.8,34019.0,21900,22500,73100,3,600,2015
8392,2.8,38199.0,9875,9700,77030,2,-175,2015
363136,4.4,11286.0,15600,14800,64520,1,-800,2015
163115,4.6,13369.0,17950,17800,73100,1,-150,2015
153122,4.6,11341.0,28700,22000,73100,1,-6700,2015
531730,4.7,57463.0,11950,13000,82150,7,1050,2015
53308,3.4,23647.0,13150,12250,77030,3,-900,2015
271552,4.2,52719.0,39200,39400,59100,4,200,2015
481457,5.0,68571.0,26200,19200,73130,5,-7000,2015
346572,4.6,21428.0,22800,24000,82750,1,1200,2015
72521,3.6,65461.0,6675,7500,77030,7,825,2015
168981,3.8,77323.0,22100,20600,73100,4,-1500,2015
521501,3.4,79333.0,8725,11400,71660,8,2675,2015
463225,1.9,215815.0,350,800,61490,13,450,2015
84283,4.8,578.0,12700,12500,68360,0,-200,2015
524371,,106042.0,5000,4100,70210,8,-900,2014
439210,2.7,213582.0,625,1350,74430,12,725,2015
328805,4.3,28710.0,15500,13900,82750,2,-1600,2015
294517,1.9,1.0,5000,2800,59100,11,-2200,2015
357248,3.6,58066.0,10950,10300,62960,3,-650,2015
75056,,134825.0,1125,750,68360,14,-375,2014
264058,4.8,6035.0,11600,12300,59100,4,700,2015
109172,3.7,118056.0,8100,7100,68360,3,-1000,2015
83586,4.3,67987.0,20300,19000,68360,2,-1300,2015
451281,1.9,112243.0,2225,3000,61490,9,775,2015
120694,2.3,23073.0,9425,10900,73100,11,1475,2015
200331,3.9,41961.0,10200,10700,67090,2,500,2015
479875,4.2,36167.0,24700,23200,73130,4,-1500,2015
493018,4.1,16978.0,14450,14900,73130,2,450,2015
488087,4.1,11634.0,16200,15000,73130,2,-1200,2015
480671,4.0,20061.0,18850,20000,73130,1,1150,2015
438921,1.9,106359.0,16200,13800,74430,6,-2400,2015
294904,4.8,3388.0,24600,23000,59100,2,-1600,2015
87914,1.0,107710.0,1525,950,68360,15,-575,2015
341059,4.2,28413.0,17600,20000,82750,4,2400,2015
8092,3.4,114896.0,15150,14100,77030,8,-1050,2015
456956,2.5,167780.0,1475,2200,61490,9,725,2015
449578,3.6,4778.0,13850,13200,61490,1,-650,2014
14246,4.0,48792.0,12650,13000,77030,2,350,2015
151407,4.3,47418.0,25000,26000,73100,5,1000,2015
514525,4.1,39491.0,12800,13500,71660,1,700,2015
35408,2.0,13781.0,13950,10500,77030,0,-3450,2015
459100,2.5,120761.0,3725,3800,61490,6,75,2015
48089,3.7,26191.0,24700,23000,77030,4,-1700,2015
250622,3.5,137604.0,1225,2100,59100,16,875,2015
402501,2.9,74926.0,8025,7800,61450,3,-225,2015
484214,3.8,33295.0,17750,17400,73130,3,-350,2015
339107,1.9,161638.0,3225,3200,82750,12,-25,2015
383938,5.0,29560.0,23600,25500,65610,3,1900,2015
414986,2.8,28917.0,19250,19400,61450,2,150,2015
200276,3.9,42953.0,11000,11100,67090,1,100,2015
102284,4.4,18899.0,19950,21400,68360,4,1450,2015
58099,3.0,17063.0,20000,19500,77030,1,-500,2015
114461,3.7,27061.0,11800,12100,68360,1,300,2015
204393,4.7,7063.0,27700,28200,57290,1,500,2015
181802,4.1,22568.0,11300,11500,83200,2,200,2015
217593,1.9,121189.0,6050,2100,57290,10,-3950,2015
135661,4.2,26327.0,49100,50000,73100,2,900,2015
473531,4.2,45469.0,18600,19000,62930,3,400,2015
209068,3.4,61245.0,15850,15500,57290,2,-350,2015
94678,2.2,215901.0,1075,1300,68360,11,225,2015
470372,2.8,153503.0,1675,3500,61490,13,1825,2015
329873,2.4,33406.0,11100,9700,82750,3,-1400,2015
310250,4.9,8915.0,28400,26000,59100,3,-2400,2015
204933,5.0,21067.0,23000,22900,57290,1,-100,2015
274232,2.9,28027.0,14750,13600,59100,3,-1150,2015
355960,1.9,114937.0,7700,7500,62960,7,-200,2015
324714,4.6,11767.0,51400,51000,82750,2,-400,2015
153683,4.4,11809.0,44700,44800,73100,0,100,2015
234899,1.0,166300.0,1425,900,59100,9,-525,2014
302126,4.6,12838.0,12900,13500,59100,1,600,2015
507968,4.8,17108.0,19950,19500,71660,1,-450,2015
148477,4.2,121335.0,12500,10900,73100,8,-1600,2015
228895,4.1,108091.0,7850,6900,89090,10,-950,2015
200708,3.4,48982.0,16600,16700,67090,4,100,2015
365060,4.1,73361.0,8225,9000,64520,6,775,2015
281107,4.3,48236.0,13800,14900,59100,3,1100,2015
393593,5.0,70266.0,14350,14000,65610,1,-350,2015
286628,1.9,102582.0,8150,6900,59100,4,-1250,2015
257473,4.9,21719.0,15700,15700,59100,1,0,2015
339270,3.6,25667.0,23800,22250,82750,2,-1550,2015
76137,4.9,16548.0,27000,29000,68360,1,2000,2014
61599,4.0,27260.0,35200,34500,77030,3,-700,2015
254958,4.8,37971.0,16500,17300,59100,4,800,2015
432066,4.8,4963.0,14650,14800,61450,0,150,2015
118971,3.5,61058.0,17400,15900,68360,7,-1500,2015
463185,3.6,74859.0,11900,12500,61490,10,600,2015
477597,3.4,25304.0,19050,18700,73130,1,-350,2015
329331,4.6,61681.0,13750,13400,82750,4,-350,2015
456623,2.3,136915.0,4625,3100,61490,8,-1525,2015
398685,2.0,186133.0,1575,375,61450,13,-1200,2015
436897,4.0,29935.0,18550,17500,74430,1,-1050,2015
197835,3.1,32201.0,25400,26750,67090,3,1350,2015
196963,4.2,56374.0,7600,9200,67090,4,1600,2015
249615,4.3,20744.0,17500,19600,59100,1,2100,2015
397262,3.7,54820.0,10750,11000,65610,5,250,2015
335454,3.7,58897.0,16850,15800,82750,2,-1050,2015
60645,3.8,15333.0,10050,9500,77030,2,-550,2015
301603,5.0,28461.0,17750,19200,59100,4,1450,2015
433092,1.9,1.0,5950,650,74430,9,-5300,2014
498722,3.3,92606.0,15400,12500,80610,4,-2900,2014
436562,2.5,54448.0,22500,23500,74430,5,1000,2015
441665,2.5,126390.0,5175,5500,74430,10,325,2015
75526,4.7,16149.0,17000,18500,68360,1,1500,2014
124786,4.0,22598.0,14250,14200,73100,1,-50,2015
538714,3.1,65423.0,13550,11400,55590,2,-2150,2015
324433,3.1,98597.0,9200,9100,82750,8,-100,2015
426772,3.6,42937.0,29600,31000,61450,2,1400,2015
413390,2.9,78037.0,9900,9600,61450,6,-300,2015
329126,2.7,35479.0,11950,10400,82750,3,-1550,2015
39224,4.1,24845.0,15750,17500,77030,2,1750,2015
62815,5.0,4732.0,18900,20000,77030,1,1100,2015
492556,4.8,25282.0,15900,17600,73130,2,1700,2015
159467,5.0,12003.0,27800,28200,73100,0,400,2015
474393,4.9,60162.0,25900,25000,62930,4,-900,2015
424156,1.9,90599.0,5250,5200,61450,7,-50,2015
146157,4.1,30300.0,22400,23250,73100,3,850,2015
195249,4.0,127252.0,12900,12200,67090,3,-700,2015
244317,1.9,185485.0,2100,1500,59100,11,-600,2015
520440,4.3,19987.0,15000,15000,71660,1,0,2015
463524,5.0,5479.0,19200,21000,61490,1,1800,2015
314368,3.5,116985.0,8450,9100,59100,10,650,2015
100271,1.9,113110.0,5100,2700,68360,10,-2400,2015
476343,,111167.0,1025,1100,73130,15,75,2014
192977,4.3,25130.0,24000,24000,67090,3,0,2015
130851,3.2,75219.0,5225,6500,73100,9,1275,2015
350931,3.8,39471.0,29300,28250,62960,3,-1050,2015
332236,4.7,18656.0,11200,11000,82750,1,-200,2015
494268,4.8,13631.0,32000,32500,73130,2,500,2015
370219,2.8,124449.0,2325,2900,64520,11,575,2015
149068,4.2,19121.0,31000,30400,73100,1,-600,2015
192389,5.0,11390.0,13950,14000,67090,1,50,2015
413090,4.5,89370.0,16300,17200,61450,8,900,2015
15138,3.6,90048.0,9875,11500,77030,8,1625,2015
368390,4.5,4306.0,35600,35500,64520,1,-100,2015
385223,4.1,86677.0,5425,5800,65610,6,375,2015
303516,2.9,56221.0,17050,16200,59100,2,-850,2015
42800,2.9,79546.0,8100,10100,77030,9,2000,2015
486485,3.1,65061.0,13650,13600,73130,2,-50,2015
177968,4.0,85883.0,8550,9400,83200,5,850,2015
450804,2.9,56320.0,8475,8200,61490,2,-275,2014
42491,3.6,48672.0,12650,13600,77030,3,950,2015
158878,3.1,34359.0,25500,24900,73100,2,-600,2015
57221,3.0,49757.0,10500,4500,77030,2,-6000,2015
40503,2.4,146440.0,2925,3100,77030,11,175,2015
8659,3.5,61334.0,26900,25750,77030,2,-1150,2014
410559,2.3,77609.0,12900,11600,61450,7,-1300,2015
344505,1.9,40454.0,9600,5700,82750,3,-3900,2015
172479,5.0,49070.0,28000,26600,73100,1,-1400,2015
456173,2.8,107114.0,3225,3800,61490,8,575,2015
143944,3.6,77996.0,6175,5900,73100,7,-275,2015
446018,1.0,123116.0,9800,8200,56120,13,-1600,2015
139807,4.3,145954.0,2600,3200,73100,13,600,2015
514856,4.4,34434.0,16200,16700,71660,1,500,2015
97743,2.3,83302.0,7450,3400,68360,10,-4050,2015
111762,2.7,137786.0,3625,3000,68360,12,-625,2015
244210,2.5,175814.0,2575,2600,59100,9,25,2015
405299,3.1,109661.0,8475,8200,61450,11,-275,2015
401222,4.6,12124.0,15300,15500,61450,1,200,2015
404807,3.5,47502.0,12350,11400,61450,3,-950,2015
67548,2.8,206451.0,2575,3000,77030,12,425,2015
266030,3.8,41593.0,12550,13000,59100,2,450,2015
243256,4.5,28290.0,22100,21200,59100,2,-900,2015
285543,4.6,17775.0,22100,22800,59100,2,700,2015
271542,4.8,34592.0,14700,16200,59100,4,1500,2015
417842,3.4,131808.0,12950,11800,61450,8,-1150,2015
283892,4.4,19265.0,18950,19600,59100,2,650,2015
234995,1.9,163998.0,2400,2600,59100,9,200,2014
196150,3.4,64305.0,15950,16400,67090,2,450,2015
34897,2.9,5188.0,13150,12250,77030,1,-900,2015
97728,3.5,105868.0,4250,3500,68360,9,-750,2015
307846,4.0,23285.0,29500,29800,59100,1,300,2015
472121,4.1,118950.0,4025,3500,62930,8,-525,2015
307430,2.7,73192.0,12700,11700,59100,7,-1000,2015
507201,3.1,28815.0,10800,12100,80200,3,1300,2015
344700,1.9,156635.0,1650,750,82750,14,-900,2015
258317,4.4,12487.0,10850,11300,59100,3,450,2015
528710,1.9,108966.0,2225,1000,70210,9,-1225,2015
343843,4.3,36685.0,20800,21000,82750,2,200,2015
423446,1.9,79243.0,7025,5200,61450,3,-1825,2015
16534,2.6,11492.0,14300,13250,77030,3,-1050,2015
209667,4.6,32421.0,13000,13700,57290,3,700,2015
373162,4.2,44184.0,11500,11300,64520,3,-200,2015
540595,3.4,86075.0,10300,12000,81400,6,1700,2015
22642,4.1,29713.0,15100,15000,77030,1,-100,2015
54356,1.9,225183.0,4575,3800,77030,11,-775,2015
248797,4.2,23487.0,24100,27000,59100,3,2900,2015
54088,3.0,52516.0,13000,13250,77030,4,250,2015
419094,3.7,37562.0,16150,15600,61450,2,-550,2015
253006,4.0,25326.0,18800,19300,59100,1,500,2015
66730,2.0,54498.0,17250,14600,77030,2,-2650,2015
318669,4.2,7291.0,29700,31400,73200,1,1700,2015
479291,2.4,29450.0,12350,13000,73130,3,650,2015
222849,2.9,59463.0,7900,6600,89090,0,-1300,2014
56693,4.3,41770.0,15650,8750,77030,3,-6900,2015
345059,4.4,28732.0,11650,12500,82750,3,850,2015
514744,2.4,88194.0,9350,10300,71660,8,950,2015
228212,3.5,154113.0,2075,2300,89090,9,225,2015
151006,2.9,34278.0,17800,17200,73100,3,-600,2015
41636,3.2,91437.0,4175,5700,77030,8,1525,2015
540311,3.7,145850.0,10750,11200,81400,9,450,2015
229564,3.1,71867.0,1200,1100,89090,17,-100,2015
14514,2.5,226264.0,1300,1800,77030,13,500,2015
451029,4.0,152964.0,5150,5500,61490,10,350,2015
252502,2.6,31254.0,12150,10400,59100,3,-1750,2015
72861,2.7,38138.0,20500,19300,77030,3,-1200,2015
139717,2.6,115593.0,16000,14300,73100,9,-1700,2015
312723,3.3,84673.0,10150,10100,59100,6,-50,2015
440655,1.0,66728.0,4525,2600,74430,8,-1925,2015
383339,4.7,32112.0,14200,14300,65610,1,100,2014
174769,4.0,19434.0,19600,20300,83200,1,700,2015
360863,,179415.0,2025,801,64520,10,-1224,2014
175087,3.9,42342.0,14550,14700,83200,1,150,2015
430397,3.3,81466.0,13650,12600,61450,6,-1050,2015
92146,2.1,41118.0,11750,10000,68360,2,-1750,2015
523800,4.3,32880.0,10550,11500,71660,5,950,2015
547184,3.3,97101.0,3925,1600,78090,10,-2325,2015
196720,3.7,118232.0,11300,11700,67090,6,400,2015
151013,2.8,111793.0,10350,9000,73100,3,-1350,2015
331285,2.0,149535.0,1700,1000,82750,14,-700,2015
232052,2.1,109079.0,8650,7200,89090,7,-1450,2015
288206,2.6,54047.0,15400,16000,59100,5,600,2015
216989,4.3,2720.0,16400,17400,57290,1,1000,2015
50158,2.4,201589.0,1000,2000,77030,17,1000,2015
77800,1.9,1.0,6050,3100,68360,13,-2950,2014
174876,2.3,157412.0,17700,15200,83200,3,-2500,2015
453853,4.8,44593.0,26400,27300,61490,3,900,2015
500514,1.9,117839.0,10950,10600,80610,6,-350,2015
23148,2.9,87710.0,4700,6900,77030,11,2200,2015
81209,2.0,106114.0,3850,3600,68360,10,-250,2015
456086,3.7,76823.0,8075,6000,61490,3,-2075,2015
403055,4.7,58999.0,9000,9300,61450,3,300,2015
115981,4.1,47487.0,16800,17900,68360,2,1100,2015
541467,4.6,24783.0,9800,10100,81400,4,300,2015
19523,2.3,166242.0,2325,2400,77030,11,75,2015
535300,1.9,145059.0,2600,1700,82150,10,-900,2015
404086,4.1,26207.0,18300,16100,61450,1,-2200,2015
331918,4.3,35024.0,10000,8600,82750,3,-1400,2015
123414,3.8,26117.0,12500,12200,73100,3,-300,2015
201311,4.1,14532.0,33700,33400,57290,0,-300,2014
414650,1.9,152734.0,3200,2900,61450,12,-300,2015
480425,3.6,8147.0,15100,13200,73130,2,-1900,2015
152835,3.3,63341.0,9000,9200,73100,4,200,2015
499107,3.5,42433.0,21500,21200,80610,3,-300,2014
14911,3.3,69877.0,18350,21750,77030,5,3400,2015
409008,4.8,19275.0,12300,12300,61450,1,0,2015
141872,3.8,180866.0,8575,8200,73100,8,-375,2015
419410,4.6,26332.0,18700,23400,61450,2,4700,2015
21236,3.5,135814.0,3800,4000,77030,10,200,2015
280750,1.9,154866.0,1700,3500,59100,12,1800,2015
516431,4.5,12615.0,31300,26300,71660,2,-5000,2015
406923,5.0,28444.0,37200,39100,61450,1,1900,2015
405484,2.0,189364.0,700,400,61450,18,-300,2015
336979,4.3,59826.0,15700,15800,82750,2,100,2015
5496,4.2,11138.0,13100,15400,77030,0,2300,2014
394107,4.9,48548.0,24800,23400,65610,2,-1400,2015
472164,4.4,21651.0,13000,14300,62930,1,1300,2015
541560,2.9,23021.0,27900,33250,81400,2,5350,2015
54710,3.2,218043.0,3850,6600,77030,7,2750,2015
502211,3.8,52843.0,11150,10900,80610,2,-250,2015
262601,3.9,137105.0,18350,15400,59100,3,-2950,2015
441512,4.4,21124.0,25000,24500,74430,2,-500,2015
168051,3.3,40245.0,15400,15500,73100,3,100,2015
313562,3.6,60390.0,13900,13500,59100,2,-400,2015
285890,4.0,9534.0,19400,20900,59100,1,1500,2015
480560,2.5,144228.0,1550,1350,73130,12,-200,2015
514616,3.9,41226.0,16100,15400,71660,4,-700,2015
175910,1.9,222451.0,1225,1400,83200,13,175,2015
91075,2.7,92726.0,5175,2700,68360,6,-2475,2015
130991,4.4,6031.0,13100,13600,73100,1,500,2015
285404,2.7,46852.0,10800,10600,59100,2,-200,2015
87217,4.9,102682.0,25900,28000,68360,7,2100,2015
358819,4.6,19608.0,10650,10200,62960,1,-450,2015
232283,4.4,47998.0,24100,24000,89090,2,-100,2015
450438,1.9,122704.0,4925,3600,61490,7,-1325,2014
453966,2.6,57949.0,7975,7500,61490,7,-475,2015
253066,4.8,76342.0,12000,13200,59100,6,1200,2015
399178,2.5,26309.0,11300,6000,61450,3,-5300,2015
244575,4.9,12187.0,22200,21900,59100,1,-300,2015
313140,1.9,185852.0,2500,1900,59100,12,-600,2015
443135,3.8,109586.0,5375,6600,74430,9,1225,2015
44533,3.9,42655.0,12850,13600,77030,2,750,2015
468060,3.4,76569.0,13300,12700,61490,2,-600,2015
138187,4.1,30664.0,11100,11400,73100,1,300,2015
545263,3.8,58375.0,11000,11600,81400,2,600,2015
29989,2.1,35879.0,15700,16000,77030,3,300,2015
26691,4.7,14397.0,18200,18500,77030,4,300,2015
260810,2.7,90495.0,1375,1900,59100,14,525,2015
249690,4.4,21351.0,10400,11200,59100,1,800,2015
96876,4.1,48414.0,12400,13000,68360,2,600,2015
186339,1.9,101936.0,5575,6300,63250,8,725,2015
57948,2.9,133541.0,5100,5800,77030,10,700,2015
220317,3.6,91553.0,17800,16500,57290,7,-1300,2015
52489,2.9,53162.0,3600,6950,77030,14,3350,2015
46685,2.0,15527.0,16750,12100,77030,1,-4650,2015
410439,4.1,49671.0,33300,35200,61450,4,1900,2015
329554,1.9,129157.0,1550,900,82750,14,-650,2015
355179,2.0,209219.0,3375,1550,62960,13,-1825,2015
226489,2.3,119263.0,10800,10600,89090,6,-200,2015
37403,4.3,73407.0,14800,12800,77030,2,-2000,2015
155091,4.9,61380.0,30200,32000,73100,5,1800,2015
44180,3.4,59686.0,9175,9700,77030,4,525,2015
510948,3.1,63481.0,12100,11000,71660,2,-1100,2015
479406,2.6,54453.0,6575,6100,73130,5,-475,2015
391632,3.8,95063.0,18000,17900,65610,4,-100,2015
28799,1.9,18558.0,11750,11000,77030,3,-750,2015
340154,2.0,128655.0,6775,5500,82750,5,-1275,2015
132163,2.0,123192.0,3600,3300,73100,9,-300,2015
542008,3.2,122181.0,8575,9900,81400,6,1325,2015
292748,4.1,33170.0,20700,20400,59100,1,-300,2015
39694,2.5,30120.0,22100,20000,77030,3,-2100,2015
146071,4.9,38091.0,13900,14600,73100,3,700,2015
117039,4.8,2685.0,12050,12500,68360,0,450,2015
109310,2.8,42568.0,18650,17500,68360,2,-1150,2015
83428,2.8,14024.0,16800,14500,68360,1,-2300,2015
44259,2.6,100076.0,8575,7000,77030,9,-1575,2015
21778,4.8,27092.0,27700,29250,77030,2,1550,2015
359274,3.8,57923.0,17300,17250,62960,3,-50,2015
537087,3.3,80833.0,15050,15100,73640,7,50,2015
350827,1.9,113119.0,2225,2600,62960,11,375,2015
311744,1.9,42827.0,10000,8500,59100,2,-1500,2015
409915,2.7,131149.0,4925,4300,61450,7,-625,2015
133563,3.0,11304.0,12550,12700,73100,1,150,2015
392388,4.4,40729.0,27400,25500,65610,1,-1900,2015
404458,1.9,75941.0,2350,2000,61450,13,-350,2015
330516,2.1,34765.0,17300,15400,82750,3,-1900,2015
51416,4.1,102783.0,7825,9000,77030,11,1175,2015
322241,2.2,23578.0,14650,11800,82750,4,-2850,2015
460840,2.4,144566.0,2300,3000,61490,9,700,2015
46333,2.6,174522.0,4925,4600,77030,10,-325,2015
201049,5.0,29654.0,20000,21200,57290,3,1200,2014
18988,2.6,31622.0,12300,11750,77030,3,-550,2015
399701,2.9,182019.0,3675,4700,61450,10,1025,2014
277090,3.0,17066.0,55800,52200,59100,2,-3600,2015
492193,2.0,45184.0,9000,8500,73130,2,-500,2015
72962,4.1,93377.0,10500,11000,77030,9,500,2015
418288,2.0,47480.0,9325,7200,61450,4,-2125,2015
105690,4.4,152639.0,17650,12400,68360,4,-5250,2015
515147,2.8,21757.0,14650,13100,71660,2,-1550,2015
457552,4.4,38877.0,14150,16100,61490,4,1950,2015
320124,,105626.0,12450,9600,82750,4,-2850,2014
149259,4.7,38592.0,12800,13000,73100,5,200,2015
403420,2.1,173268.0,2200,2500,61450,11,300,2015
534271,2.5,102270.0,1825,1000,82150,11,-825,2015
472916,2.0,20802.0,17200,13200,62930,1,-4000,2015
162670,2.8,75848.0,13800,13300,73100,3,-500,2015
544137,2.6,104072.0,10500,12200,81400,9,1700,2015
151127,2.3,76284.0,6200,5700,73100,8,-500,2015
344355,1.9,174596.0,1425,1500,82750,15,75,2015
470216,3.9,16835.0,22700,20900,61490,2,-1800,2015
333930,3.5,41256.0,13000,12500,82750,2,-500,2015
254829,3.9,62484.0,21800,21300,59100,9,-500,2015
53005,1.9,97314.0,4475,2500,77030,11,-1975,2015
473486,4.3,53823.0,9775,9600,62930,2,-175,2015
415119,4.4,37985.0,12750,12400,61450,4,-350,2015
78918,4.1,72253.0,28300,28700,68360,4,400,2015
351550,3.6,26128.0,14350,14800,62960,1,450,2015
101743,3.2,12285.0,17700,17100,68360,3,-600,2015
387362,3.6,91722.0,5250,4800,65610,7,-450,2015
162599,2.8,64179.0,10350,10200,73100,3,-150,2015
525763,2.3,68166.0,12000,7400,70210,3,-4600,2015
270531,1.9,119245.0,6100,6000,59100,10,-100,2015
374913,2.9,121298.0,3625,4400,64520,11,775,2015
59114,4.8,17115.0,24400,24500,77030,3,100,2015
542704,4.9,38669.0,27300,27300,81400,2,0,2015
33189,3.7,83609.0,9075,9600,77030,3,525,2015
523072,3.1,30709.0,11450,12100,71660,3,650,2015
243155,4.4,49840.0,26200,26000,59100,2,-200,2015
301664,2.1,93281.0,7225,6500,59100,6,-725,2015
379922,3.8,32765.0,18350,18750,64520,4,400,2015
325156,1.9,39972.0,8875,7300,82750,4,-1575,2015
194596,3.7,16715.0,45700,45500,67090,3,-200,2015
401887,2.0,20836.0,13200,10200,61450,1,-3000,2015
498007,2.6,75676.0,8125,9100,73130,2,975,2015
339746,4.2,33456.0,24100,23000,82750,2,-1100,2015
429977,3.6,73378.0,10450,10200,61450,2,-250,2015
463181,2.4,87953.0,10850,13400,61490,10,2550,2015
141988,1.9,164345.0,3500,5400,73100,12,1900,2015
438161,4.3,43575.0,10950,10600,74430,2,-350,2015
191998,2.6,83974.0,2275,2500,67090,8,225,2015
264803,2.0,74462.0,11750,7450,59100,9,-4300,2015
344364,4.2,77794.0,35000,35200,82750,2,200,2015
289474,4.1,120256.0,2650,3200,59100,13,550,2015
532943,3.6,63381.0,8925,9000,82150,6,75,2015
437043,1.9,87700.0,7400,6100,74430,8,-1300,2015
413742,3.7,70996.0,16400,16000,61450,7,-400,2015
224607,2.8,59172.0,10350,9600,89090,2,-750,2015
378627,2.8,80644.0,1125,2900,64520,18,1775,2015
202272,1.9,158296.0,2850,3000,57290,8,150,2014
310740,3.6,96418.0,20300,23700,59100,7,3400,2015
366224,4.8,43942.0,16100,17500,64520,4,1400,2015
316040,4.3,81924.0,14350,16100,73200,4,1750,2014
243774,2.4,34275.0,12400,11200,59100,3,-1200,2015
350748,2.5,98755.0,2075,2500,62960,10,425,2015
151540,2.1,113126.0,3175,2100,73100,9,-1075,2015
282073,4.4,38277.0,10050,10000,59100,1,-50,2015
71185,4.7,23168.0,27400,30500,77030,1,3100,2015
236778,4.7,120402.0,42700,36000,59100,3,-6700,2015
26653,2.5,51769.0,20800,19250,77030,4,-1550,2015
79262,3.7,57712.0,24400,23900,68360,3,-500,2015
96928,2.4,79968.0,22600,20200,68360,3,-2400,2015
183731,1.9,100999.0,1125,350,63250,16,-775,2014
268356,1.9,34978.0,19450,17000,59100,1,-2450,2015
182945,,140366.0,6300,6200,63250,8,-100,2014
247635,2.3,34813.0,11100,10300,59100,3,-800,2015
520873,1.9,110672.0,7425,4900,71660,6,-2525,2015
211915,2.7,84291.0,7350,8400,57290,8,1050,2015
165561,3.7,55531.0,9475,10000,73100,2,525,2015
286035,3.8,45073.0,18700,20000,59100,3,1300,2015
404446,2.3,99104.0,6100,8500,61450,12,2400,2015
350073,4.2,10876.0,19200,19000,62960,0,-200,2014
218516,4.9,33908.0,31300,31600,57290,1,300,2015
413476,2.2,88942.0,8175,7500,61450,3,-675,2015
437601,3.2,230312.0,2500,3100,74430,12,600,2015
173465,,129238.0,5400,5200,83200,10,-200,2014
149121,4.5,33101.0,12950,12900,73100,2,-50,2015
67928,3.9,62517.0,7075,8100,77030,3,1025,2015
511070,3.6,23884.0,14800,15600,71660,2,800,2015
19959,4.4,21013.0,24400,25000,77030,1,600,2015
84194,2.8,77385.0,12200,13250,68360,6,1050,2015
302204,4.5,23877.0,14950,15600,59100,3,650,2015
245264,3.4,122564.0,18200,18400,59100,5,200,2015
40767,3.9,38928.0,10900,10250,77030,2,-650,2015
510198,3.2,85700.0,10550,10100,71660,2,-450,2015
374522,4.2,135601.0,4550,4500,64520,7,-50,2015
84623,1.9,72649.0,11400,4000,68360,8,-7400,2015
530298,2.4,61886.0,8775,7600,82150,12,-1175,2015
142537,4.0,40397.0,11700,10900,73100,3,-800,2015
290532,4.1,46403.0,17900,18000,59100,4,100,2015
203009,4.1,58980.0,13800,14300,57290,3,500,2015
423077,3.6,64671.0,19800,19901,61450,2,101,2015
43957,5.0,8035.0,31900,30000,77030,2,-1900,2015
254922,5.0,10972.0,23500,23500,59100,1,0,2015
165566,4.1,48704.0,9525,9700,73100,2,175,2015
190526,2.4,58569.0,15700,14500,63250,5,-1200,2015
526899,4.0,34106.0,9425,10000,70210,4,575,2015
73541,,99883.0,16200,15000,68360,4,-1200,2014
35510,4.3,68052.0,13400,13900,77030,3,500,2015
39705,3.8,62329.0,12350,13200,77030,3,850,2015
362657,5.0,10197.0,48600,47000,64520,0,-1600,2014
190002,1.9,53208.0,14050,11700,63250,1,-2350,2015
506509,3.5,121331.0,30000,27500,80200,3,-2500,2015
436887,1.0,1.0,12600,2300,74430,7,-10300,2015
544026,1.9,161856.0,1550,2300,81400,14,750,2015
156898,4.2,65298.0,15350,15300,73100,2,-50,2015
303637,3.5,27168.0,25400,24200,59100,3,-1200,2015
3594,1.9,113206.0,7975,6000,77030,9,-1975,2015
537120,1.9,113156.0,11800,5200,73640,7,-6600,2015
211904,3.5,59133.0,6300,9200,57290,8,2900,2015
96685,2.8,36332.0,12300,11600,68360,3,-700,2015
164714,4.1,30068.0,17300,18200,73100,2,900,2015
253961,3.5,103508.0,3975,4150,59100,15,175,2015
304827,4.3,22169.0,35900,35800,59100,0,-100,2015
506985,4.3,99340.0,20100,18700,80200,3,-1400,2015
486430,4.6,15877.0,10900,11900,73130,1,1000,2015
135881,3.6,74693.0,4850,4500,73100,7,-350,2015
54810,3.5,51122.0,16850,18900,77030,3,2050,2015
268142,2.8,151094.0,4600,4600,59100,11,0,2015
167692,4.3,80681.0,5100,6300,73100,10,1200,2015
323641,4.6,12636.0,25300,25400,82750,1,100,2015
390657,4.7,86219.0,13150,13900,65610,5,750,2015
229854,2.6,62327.0,11650,11100,89090,2,-550,2015
419744,1.9,103455.0,3775,2700,61450,8,-1075,2015
429033,3.1,93097.0,13100,10400,61450,7,-2700,2015
93203,2.8,116163.0,5200,6500,68360,9,1300,2015
339737,1.9,13585.0,11350,8400,82750,2,-2950,2015
331050,3.3,53586.0,16150,18800,82750,8,2650,2015
486870,4.0,13860.0,16950,17500,73130,1,550,2015
82088,1.9,127354.0,8050,4500,68360,9,-3550,2015
319044,2.9,48449.0,10450,9700,73200,2,-750,2015
408127,3.5,86406.0,9850,9300,61450,4,-550,2015
273242,4.6,21091.0,12400,13000,59100,1,600,2015
163481,4.4,50552.0,21500,24400,73100,5,2900,2015
172096,3.3,66508.0,3500,5100,73100,12,1600,2015
167218,4.6,16878.0,40400,40000,73100,0,-400,2015
383337,3.1,20274.0,14550,12200,65610,1,-2350,2014
525013,1.9,67292.0,9325,7000,70210,8,-2325,2015
291211,2.1,38159.0,26900,39000,59100,2,12100,2015
321038,3.5,89087.0,10150,8900,82750,3,-1250,2015
281083,4.5,18489.0,14300,15400,59100,3,1100,2015
424920,2.8,42265.0,9525,8300,61450,3,-1225,2015
367800,5.0,8159.0,35000,34250,64520,1,-750,2015
254751,2.5,84865.0,12550,13300,59100,4,750,2015
522350,2.2,90324.0,6700,6300,71660,8,-400,2015
310155,4.1,24373.0,36600,36800,59100,3,200,2015
30038,4.4,28343.0,19400,20250,77030,4,850,2015
258374,4.5,23728.0,18900,18600,59100,3,-300,2015
118565,2.9,174946.0,3300,2500,68360,9,-800,2015
158344,4.2,18542.0,28600,30400,73100,1,1800,2015
162800,2.5,77585.0,5550,4500,73100,8,-1050,2015
400421,3.3,107441.0,7400,7600,61450,8,200,2014
264313,3.7,136585.0,11700,14800,59100,6,3100,2015
13990,3.4,98781.0,7750,8600,77030,9,850,2015
107191,3.5,34642.0,32200,32500,68360,3,300,2015
61708,4.8,49700.0,16650,18000,77030,4,1350,2015
507563,4.1,50359.0,11100,10800,80200,2,-300,2015
228570,3.6,63414.0,18900,18600,89090,2,-300,2015
46932,3.7,33638.0,26000,26200,77030,3,200,2015
432773,2.2,141921.0,7000,6200,74430,7,-800,2014
236135,4.0,41788.0,11000,11300,59100,1,300,2014
182053,4.5,42535.0,17550,18300,83200,3,750,2015
417897,2.6,171565.0,2400,3800,61450,11,1400,2015
224767,2.0,142583.0,2275,1500,89090,12,-775,2015
177127,4.2,10443.0,18100,17600,83200,1,-500,2015
95503,3.5,123842.0,10550,8200,68360,8,-2350,2015
221936,,136884.0,1250,600,89090,9,-650,2014
500361,1.9,46613.0,20400,20400,80610,4,0,2015
352277,4.9,23043.0,20300,24500,62960,7,4200,2015
38818,2.8,79495.0,10800,10000,77030,7,-800,2015
395874,4.5,114189.0,4025,5500,65610,9,1475,2015
462821,1.0,139503.0,2375,3000,61490,12,625,2015
477926,2.0,51451.0,14050,14000,73130,3,-50,2015
24475,3.7,85804.0,8525,8200,77030,5,-325,2015
82750,4.1,15881.0,27700,27700,68360,2,0,2015
169150,4.5,30164.0,16550,16400,73100,4,-150,2015
202569,3.7,36663.0,9700,9500,57290,2,-200,2014
396360,2.3,80207.0,17900,16200,65610,5,-1700,2015
27403,2.5,171965.0,850,1600,77030,18,750,2015
3876,1.9,233155.0,2100,2200,77030,8,100,2014
328219,2.9,193321.0,2475,3000,82750,11,525,2015
137615,3.4,40198.0,12700,11700,73100,4,-1000,2015
63026,2.8,128183.0,3625,3200,77030,8,-425,2015
428261,4.4,16982.0,11600,12200,61450,2,600,2015
317710,3.5,46570.0,13800,13700,73200,1,-100,2015
62957,4.0,45482.0,9975,10500,77030,2,525,2015
268456,3.3,42185.0,12100,11700,59100,2,-400,2015
13563,3.9,35041.0,11600,12200,77030,3,600,2015
347178,3.5,109968.0,9600,10100,82750,8,500,2015
382621,3.7,80186.0,10200,9300,65610,7,-900,2014
367362,2.5,30166.0,11350,9800,64520,3,-1550,2015
415575,2.4,70432.0,8175,8700,61450,7,525,2015
146281,3.7,86840.0,16350,16900,73100,5,550,2015
344166,2.9,53541.0,12600,12700,82750,2,100,2015
534778,2.9,128061.0,8900,6900,82150,9,-2000,2015
304911,3.5,66408.0,10950,10800,59100,2,-150,2015
525588,3.7,70157.0,12550,12000,70210,9,-550,2015
297753,2.8,71643.0,20000,18800,59100,3,-1200,2015
269809,4.2,15105.0,16300,16300,59100,2,0,2015
56448,3.2,63312.0,12300,10900,77030,2,-1400,2015
488820,2.0,27610.0,21900,23000,73130,4,1100,2015
18178,3.9,1561.0,14700,15500,77030,1,800,2015
246639,3.7,93181.0,12800,14500,59100,8,1700,2015
284429,4.4,33284.0,16150,16800,59100,3,650,2015
174192,4.1,125952.0,14850,15300,83200,8,450,2015
371631,4.8,68048.0,7225,8400,64520,9,1175,2015
549944,1.0,999999.0,500,600,48460,8,100,2015
51604,4.3,9350.0,11600,12500,77030,1,900,2015
443076,3.5,56101.0,9525,8900,74430,3,-625,2015
68590,3.2,54242.0,20900,21000,77030,4,100,2015
425776,4.5,2540.0,76000,73000,61450,2,-3000,2015
442923,3.7,32391.0,15350,14500,74430,2,-850,2015
502528,2.3,49108.0,10600,9200,80610,3,-1400,2015
82966,4.3,38754.0,22600,22100,68360,4,-500,2015
101177,3.5,36622.0,17300,18500,68360,2,1200,2015
406144,2.7,149124.0,325,1000,61450,17,675,2015
490520,1.9,117401.0,4150,3700,73130,9,-450,2015
306161,3.4,71810.0,8275,10000,59100,7,1725,2015
350764,2.0,148436.0,2275,1900,62960,16,-375,2015
162153,4.1,30416.0,35800,35000,73100,1,-800,2015
81790,1.9,82542.0,5850,3200,68360,6,-2650,2015
25174,1.9,149140.0,875,600,77030,15,-275,2015
1236,3.7,49668.0,11500,11200,77030,2,-300,2014
5875,4.4,14033.0,10300,11500,77030,0,1200,2014
185398,3.4,64243.0,21500,20800,63250,2,-700,2015
307833,3.2,106660.0,4875,4400,59100,9,-475,2015
21106,2.0,78928.0,5750,7100,77030,8,1350,2015
240807,2.0,89833.0,3400,1400,59100,12,-2000,2015
400338,4.0,67885.0,11700,13400,61450,3,1700,2014
481938,4.0,34170.0,11750,11400,73130,1,-350,2015
368319,1.9,31303.0,14000,11400,64520,2,-2600,2015
179712,2.9,108030.0,10650,11100,83200,2,450,2015
496711,4.8,34160.0,17850,18200,73130,1,350,2015
328761,2.9,156034.0,1750,1000,82750,12,-750,2015
111093,3.1,73626.0,8150,9000,68360,4,850,2015
519379,3.3,139027.0,5325,4550,71660,8,-775,2015
41213,4.7,45528.0,15700,16500,77030,3,800,2015
464811,3.6,130073.0,2475,4100,61490,12,1625,2015
209596,4.2,66705.0,8475,10500,57290,3,2025,2015
251926,2.4,106589.0,7700,7000,59100,4,-700,2015
394129,4.4,53921.0,22600,23000,65610,2,400,2015
407231,1.9,110443.0,4525,3600,61450,8,-925,2015
112686,1.9,158488.0,7025,5000,68360,9,-2025,2015
431086,4.3,4780.0,14400,13800,61450,2,-600,2015
464068,1.9,83860.0,5400,5000,61490,8,-400,2015
167868,4.4,27818.0,10850,10800,73100,2,-50,2015
457427,2.6,150156.0,3950,4800,61490,10,850,2015
324639,4.3,10644.0,21200,24000,82750,1,2800,2015
343706,4.4,4177.0,75000,74500,82750,0,-500,2015
481084,4.2,43681.0,19200,18600,73130,3,-600,2015
222400,3.1,91038.0,9975,9000,89090,4,-975,2014
90308,1.9,157011.0,20400,22000,68360,6,1600,2015
245318,3.7,50784.0,28700,29000,59100,5,300,2015
310974,2.9,136696.0,2575,3000,59100,9,425,2015
541509,2.9,32109.0,11550,11600,81400,2,50,2015
188633,2.2,1.0,7625,500,63250,10,-7125,2015
245883,4.3,33518.0,18050,18500,59100,1,450,2015
490648,3.6,17360.0,18050,18000,73130,3,-50,2015
48393,4.1,19775.0,15450,15000,77030,1,-450,2015
489905,4.0,15915.0,15400,16500,73130,1,1100,2015
65460,4.0,38271.0,26300,26000,77030,3,-300,2015
53867,3.7,48314.0,9600,9700,77030,2,100,2015
429675,3.5,136006.0,4125,4600,61450,12,475,2015
223165,3.1,89279.0,6250,4900,89090,9,-1350,2015
437892,2.8,145977.0,2550,2400,74430,11,-150,2015
211854,2.0,111998.0,5300,3300,57290,6,-2000,2015
57186,3.1,46621.0,10800,10500,77030,3,-300,2015
445083,3.3,76620.0,5725,8100,56120,8,2375,2015
545503,3.6,106757.0,4125,4500,81400,8,375,2015
459844,1.9,100643.0,5325,5400,61490,9,75,2015
103005,3.3,125836.0,7550,7700,68360,7,150,2015
506433,1.9,162567.0,1925,2400,80200,12,475,2015
377707,3.8,60713.0,20300,18300,64520,4,-2000,2015
528453,3.7,30882.0,18550,18500,70210,3,-50,2015
76533,3.8,109262.0,13300,12900,68360,7,-400,2014
403735,3.2,36255.0,11550,11200,61450,3,-350,2015
473782,2.9,21924.0,10950,10300,62930,1,-650,2015
17718,4.6,18558.0,22400,23750,77030,2,1350,2015
454751,2.0,190385.0,550,500,61490,20,-50,2015
36704,4.3,28572.0,10800,11900,77030,3,1100,2015
306048,4.2,38040.0,11600,11700,59100,3,100,2015
434509,3.7,51168.0,13250,12900,74430,3,-350,2015
291448,4.1,33169.0,12650,12300,59100,1,-350,2015
412392,4.9,24373.0,20200,21600,61450,1,1400,2015
26469,4.0,18794.0,11050,11300,77030,3,250,2015
267240,4.9,1395.0,23900,24400,59100,1,500,2015
524886,3.0,65064.0,12300,11400,70210,1,-900,2014
236403,3.6,14562.0,14550,12600,59100,1,-1950,2014
279286,4.8,5759.0,18250,18400,59100,1,150,2015
390605,4.4,37738.0,14350,16200,65610,3,1850,2015
132298,3.1,48067.0,12500,12000,73100,2,-500,2015
345606,3.5,13548.0,18000,16700,82750,2,-1300,2015
396709,4.3,47963.0,10250,10900,65610,2,650,2015
481347,4.5,8240.0,19900,20200,73130,2,300,2015
450863,3.7,120636.0,7575,7300,61490,3,-275,2014
339001,3.8,29430.0,26300,26800,82750,3,500,2015
14095,3.2,111121.0,4075,7000,77030,12,2925,2015
336703,3.7,47817.0,17050,17600,82750,4,550,2015
386889,3.9,54692.0,29100,24100,65610,2,-5000,2015
337196,2.0,138157.0,5050,2900,82750,8,-2150,2015
139210,3.5,37620.0,18000,19300,73100,3,1300,2015
70317,2.4,54076.0,12050,11400,77030,2,-650,2015
350992,2.0,349529.0,1600,2000,62960,16,400,2015
450166,4.3,57194.0,19750,20800,61490,3,1050,2015
540379,3.8,21993.0,13550,13000,81400,0,-550,2014
350750,3.4,96450.0,7425,8700,62960,10,1275,2015
543310,4.3,20750.0,14400,15100,81400,1,700,2015
477411,2.1,88489.0,6350,5900,73130,7,-450,2015
401660,2.8,64839.0,8125,8400,61450,3,275,2015
156592,4.0,27117.0,17850,18200,73100,1,350,2015
364496,1.0,269552.0,1375,750,64520,15,-625,2015
240323,2.9,34956.0,7275,7400,59100,2,125,2014
319259,3.6,43822.0,19350,19100,73200,3,-250,2015
151812,3.7,46816.0,23400,23800,73100,3,400,2015
53686,3.0,18923.0,20800,14200,77030,1,-6600,2015
132917,3.0,90051.0,7575,7500,73100,5,-75,2015
396780,4.6,92523.0,17100,14800,65610,2,-2300,2015
253659,2.8,87681.0,8000,7900,59100,3,-100,2015
327901,2.2,109619.0,6225,6500,82750,6,275,2015
470493,4.8,44879.0,8875,10200,62930,4,1325,2014
427114,3.3,36114.0,9525,8400,61450,3,-1125,2015
516486,1.9,107134.0,6025,7500,71660,9,1475,2015
309510,4.5,41653.0,19800,20100,59100,2,300,2015
104273,2.4,139862.0,3750,3800,68360,8,50,2015
479047,4.8,15599.0,19750,21500,73130,2,1750,2015
187003,1.9,92516.0,3850,3000,63250,8,-850,2015
278930,3.6,90655.0,7050,7400,59100,5,350,2015
429818,2.8,123392.0,3475,3500,61450,9,25,2015
157995,3.3,30443.0,13850,12600,73100,2,-1250,2015
227735,3.9,43792.0,13100,12300,89090,4,-800,2015
263341,4.0,38018.0,43700,39300,59100,3,-4400,2015
4221,1.9,100663.0,5225,5000,77030,10,-225,2015
84420,2.5,162296.0,5375,5700,68360,6,325,2015
348224,,128853.0,2650,2600,62960,9,-50,2014
527529,3.7,42837.0,8325,8100,70210,5,-225,2015
474225,4.0,41781.0,12200,11700,62930,2,-500,2015
275531,3.6,46648.0,17100,17700,59100,3,600,2015
84456,2.1,169778.0,5200,4700,68360,8,-500,2015
356844,4.3,27554.0,26100,25600,62960,3,-500,2015
241879,4.2,60740.0,12200,12200,59100,6,0,2014
469961,3.6,175625.0,4400,4000,61490,9,-400,2015
104233,3.6,117697.0,4000,4100,68360,7,100,2015
234642,,106402.0,2900,3200,59100,8,300,2014
91727,3.5,8504.0,18400,18400,68360,1,0,2015
301553,4.9,21958.0,10400,10400,59100,3,0,2015
322051,2.0,88332.0,4700,4100,82750,7,-600,2014
7302,,16923.0,17100,12000,77030,0,-5100,2014
300551,4.4,75188.0,15500,14800,59100,4,-700,2015
488765,4.1,6142.0,19400,18400,73130,2,-1000,2015
547534,3.8,33195.0,12050,12000,78090,3,-50,2015
337600,3.4,57686.0,13900,12000,82750,2,-1900,2015
204591,2.8,14487.0,25700,24500,57290,2,-1200,2015
229216,2.2,76586.0,4325,3000,89090,8,-1325,2015
198339,2.8,90872.0,4650,4100,67090,8,-550,2015
99587,3.9,28833.0,11750,11600,68360,2,-150,2015
421558,2.1,106922.0,6150,5100,61450,11,-1050,2015
521994,3.7,16179.0,15650,17200,71660,1,1550,2015
433730,2.9,42425.0,10650,11100,74430,2,450,2014
451446,3.5,242250.0,825,500,61490,15,-325,2015
317842,1.9,210744.0,1425,900,73200,13,-525,2015
238529,2.5,101954.0,4725,4400,59100,9,-325,2014
6964,,90854.0,6675,5600,77030,7,-1075,2014
331222,1.9,144160.0,2575,2700,82750,12,125,2015
186041,3.8,87867.0,4425,4300,63250,9,-125,2015
205294,4.1,16432.0,30300,32200,57290,1,1900,2015
105364,3.2,107682.0,11200,11300,68360,6,100,2015
485941,3.0,15736.0,20000,20500,73130,1,500,2015
423467,4.8,34111.0,21500,20700,61450,1,-800,2015
88626,3.7,37259.0,11250,11400,68360,2,150,2015
37829,4.0,80470.0,15650,17200,77030,11,1550,2015
265395,3.4,32914.0,11550,11400,59100,1,-150,2015
202917,3.6,81113.0,8125,7800,57290,1,-325,2014
429375,3.8,35645.0,24300,23200,61450,1,-1100,2015
48336,1.9,109900.0,3400,1500,77030,11,-1900,2015
118425,3.5,16736.0,13700,13500,68360,2,-200,2015
547959,2.6,95022.0,10100,8750,78090,9,-1350,2015
116713,3.2,50974.0,8800,8700,68360,2,-100,2015
143048,4.8,15944.0,12350,13100,73100,2,750,2015
14886,3.5,133010.0,4875,5700,77030,5,825,2015
182195,2.5,113928.0,5875,5500,83200,7,-375,2015
81959,1.0,168033.0,3425,2200,68360,8,-1225,2015
459718,2.0,85065.0,5075,5600,61490,6,525,2015
67128,4.2,28806.0,19100,19500,77030,3,400,2015
267495,3.8,64870.0,16500,17000,59100,2,500,2015
36429,2.2,155599.0,2675,3000,77030,10,325,2015
465705,3.9,45850.0,9700,9800,61490,2,100,2015
206784,3.7,106534.0,12350,14500,57290,8,2150,2015
246494,3.7,46739.0,11650,11800,59100,4,150,2015
38073,3.6,47897.0,14650,14600,77030,2,-50,2015
476341,,225179.0,825,450,73130,15,-375,2014
529888,2.2,56362.0,23200,22100,82150,4,-1100,2015
337512,3.7,116854.0,8525,9000,82750,5,475,2015
362463,4.9,1907.0,43300,44750,64520,1,1450,2014
226833,2.1,212885.0,2550,2800,89090,11,250,2015
404898,4.3,33805.0,17050,17200,61450,4,150,2015
60943,4.2,33491.0,16950,17500,77030,3,550,2015
272280,3.2,45590.0,12600,12000,59100,3,-600,2015
268711,3.8,44160.0,12500,12500,59100,4,0,2015
523671,2.6,144287.0,5125,5500,71660,10,375,2015
221429,2.1,135649.0,4125,3300,57290,9,-825,2015
43482,3.9,33200.0,15900,17700,77030,3,1800,2015
243126,4.8,7554.0,26600,25600,59100,1,-1000,2015
115399,2.1,171546.0,3525,3600,68360,11,75,2015
204567,3.5,28277.0,21200,21000,57290,2,-200,2015
398068,4.6,72569.0,16000,17600,61450,6,1600,2014
499727,4.4,14603.0,14200,15200,80610,4,1000,2015
512096,3.8,61427.0,17800,17800,71660,2,0,2015
281707,5.0,7139.0,22800,23700,59100,1,900,2015
526399,4.5,24529.0,23700,23900,70210,2,200,2015
141184,4.2,34892.0,17650,19000,73100,1,1350,2015
78335,2.6,57874.0,2275,4300,68360,9,2025,2014
433115,2.6,259264.0,1525,2200,74430,9,675,2014
519371,2.1,92794.0,7000,7400,71660,7,400,2015
496825,2.5,56441.0,15950,16000,73130,2,50,2015
365163,1.9,169082.0,2050,2200,64520,9,150,2015
238308,2.5,105603.0,1725,1500,59100,7,-225,2014
312223,3.6,61808.0,10550,11000,59100,3,450,2015
189965,2.3,165360.0,2050,1450,63250,13,-600,2015
242480,4.0,22324.0,16750,15100,59100,1,-1650,2015
174086,2.8,166887.0,3250,3500,83200,9,250,2014
268461,5.0,13280.0,24900,24400,59100,2,-500,2015
62680,2.4,123272.0,3650,3300,77030,9,-350,2015
467890,3.1,112794.0,3475,3900,61490,11,425,2015
354837,3.7,46860.0,12850,15600,62960,5,2750,2015
305669,3.4,49993.0,10350,9800,59100,2,-550,2015
30888,3.8,17302.0,10300,9900,77030,2,-400,2015
386667,4.3,98781.0,6425,6200,65610,6,-225,2015
70822,2.3,63510.0,14600,10500,77030,3,-4100,2015
131738,1.9,44960.0,8525,5300,73100,3,-3225,2015
153450,1.9,129317.0,3575,2900,73100,6,-675,2015
431257,2.2,39173.0,12150,10200,61450,3,-1950,2015
167209,4.0,30178.0,16050,16700,73100,1,650,2015
223528,3.7,131654.0,8450,7500,89090,8,-950,2015
444133,4.0,29745.0,18600,18900,74430,1,300,2015
270123,3.5,81480.0,9225,9900,59100,3,675,2015
484039,4.9,51364.0,12650,13800,73130,3,1150,2015
370485,3.9,16076.0,9625,9600,64520,3,-25,2015
481328,5.0,18496.0,23500,23400,73130,2,-100,2015
292540,4.7,24171.0,31200,28600,59100,2,-2600,2015
393116,4.4,36337.0,25600,23900,65610,2,-1700,2015
491370,3.5,37377.0,14000,13700,73130,1,-300,2015
465485,3.2,178689.0,3700,4800,61490,9,1100,2015
2403,2.9,45474.0,17500,16500,77030,4,-1000,2015
196678,4.7,30558.0,8575,8600,67090,3,25,2015
452186,3.6,80074.0,4750,6100,61490,11,1350,2015
288243,3.5,63096.0,4350,6400,59100,7,2050,2015
533629,3.5,81936.0,15800,16000,82150,8,200,2015
511609,2.6,61279.0,4525,6000,71660,13,1475,2015
301744,4.1,78414.0,8200,8400,59100,9,200,2015
335428,3.4,17400.0,14600,15700,82750,2,1100,2015
66503,3.2,57666.0,11050,10900,77030,2,-150,2015
88089,2.5,11800.0,13300,13400,68360,3,100,2015
132139,3.7,54342.0,11800,13100,73100,8,1300,2015
196633,4.8,1866.0,11300,9000,67090,2,-2300,2015
88438,4.6,24601.0,11350,11500,68360,2,150,2015
224131,2.9,103573.0,8550,7400,89090,9,-1150,2015
509411,4.6,27660.0,17450,18500,71660,1,1050,2015
184224,2.5,40905.0,18750,18600,63250,3,-150,2015
56707,4.9,23185.0,13650,13800,77030,1,150,2015
431388,2.8,129129.0,7050,7200,61450,8,150,2015
19081,4.7,84796.0,15950,13300,77030,3,-2650,2015
215218,2.0,196556.0,11150,2200,57290,7,-8950,2015
165526,2.0,122138.0,2000,1500,73100,10,-500,2015
37660,2.9,61870.0,8525,9500,77030,6,975,2015
145841,4.1,28028.0,44500,40750,73100,4,-3750,2015
475266,,113106.0,7175,7300,73130,6,125,2014
219643,3.5,48587.0,17600,19000,57290,3,1400,2015
325134,4.2,41856.0,14700,16300,82750,4,1600,2015
293412,2.8,54815.0,14550,14600,59100,2,50,2015
403570,4.2,48599.0,10550,11200,61450,2,650,2015
63427,3.6,78934.0,19050,18400,77030,1,-650,2015
523825,3.5,65838.0,16300,17300,71660,5,1000,2015
422066,5.0,6128.0,13250,13000,61450,1,-250,2015
52004,3.5,75560.0,21300,20750,77030,4,-550,2015
207470,4.3,15638.0,15800,25200,57290,1,9400,2015
460109,2.1,139403.0,7500,9500,61490,6,2000,2015
476632,4.2,7774.0,12850,12500,73130,1,-350,2014
255658,3.3,74084.0,10550,8700,59100,3,-1850,2015
475081,1.9,92044.0,5375,4400,73130,4,-975,2014
335655,2.5,107222.0,5700,3800,82750,8,-1900,2015
91691,4.3,19183.0,19750,19900,68360,1,150,2015
257663,3.5,61520.0,10800,10501,59100,3,-299,2015
191795,3.2,78445.0,15500,14800,67090,8,-700,2014
376864,1.9,62507.0,31300,31500,64520,3,200,2015
63263,4.1,126554.0,11050,13750,77030,8,2700,2015
279558,4.7,12373.0,22600,24200,59100,1,1600,2015
345827,3.0,53305.0,9875,9500,82750,2,-375,2015
310956,1.9,123074.0,6000,4700,59100,8,-1300,2015
294267,2.9,99248.0,3250,1200,59100,11,-2050,2015
452574,2.5,196742.0,1450,1300,61490,15,-150,2015
192953,1.9,96500.0,35600,28000,67090,4,-7600,2015
377008,2.2,115793.0,1825,1600,64520,13,-225,2015
264246,1.9,108077.0,8575,7200,59100,5,-1375,2015
239770,4.1,51795.0,31000,33000,59100,3,2000,2015
29778,2.0,53121.0,10350,9400,77030,3,-950,2015
248110,2.3,138564.0,1475,1500,59100,10,25,2015
482591,1.9,42740.0,24300,21400,73130,3,-2900,2015
18065,2.9,91536.0,15400,14600,77030,8,-800,2015
397741,,95769.0,12050,11000,61450,3,-1050,2014
64586,2.3,60814.0,12400,13200,77030,7,800,2015
163347,4.9,39694.0,25300,23750,73100,3,-1550,2015
534051,2.6,113616.0,1500,1200,82150,14,-300,2015
484108,3.8,34188.0,10800,11300,73130,3,500,2015
83232,2.9,118701.0,8800,8300,68360,8,-500,2015
73935,2.6,128607.0,3750,4100,68360,6,350,2014
77529,1.9,122964.0,3675,1600,68360,5,-2075,2014
313215,1.9,242807.0,725,700,59100,15,-25,2015
130970,2.5,120214.0,6625,6100,73100,7,-525,2015
127093,3.0,12355.0,18650,18200,73100,1,-450,2015
472624,4.3,30394.0,14900,13250,62930,3,-1650,2015
236669,1.9,21228.0,14350,8700,59100,3,-5650,2015
109209,2.9,76108.0,8500,8700,68360,4,200,2015
49742,2.3,79765.0,15150,13750,77030,6,-1400,2015
474939,2.1,27802.0,17300,14900,73130,3,-2400,2014
388961,2.4,89133.0,3750,3500,65610,8,-250,2015
154262,4.3,36054.0,15800,17100,73100,3,1300,2015
221477,4.5,15796.0,26200,26800,57290,1,600,2015
196722,1.9,136466.0,3200,3000,67090,6,-200,2015
252719,4.3,48592.0,16600,17450,59100,3,850,2015
505718,3.6,45718.0,12450,13300,80610,3,850,2015
513349,3.4,32285.0,10450,10300,71660,1,-150,2015
319069,3.5,45008.0,10900,10300,73200,1,-600,2015
59183,4.7,33447.0,37600,38000,77030,3,400,2015
411206,4.6,23977.0,15650,16500,61450,2,850,2015
52025,3.8,67226.0,28000,29250,77030,5,1250,2015
407684,4.2,36299.0,25900,26700,61450,4,800,2015
42421,3.7,38842.0,9800,10300,77030,2,500,2015
438278,1.9,145079.0,4325,1900,74430,7,-2425,2015
14181,2.0,19598.0,13400,10600,77030,1,-2800,2015
302976,3.5,20344.0,13850,12400,59100,2,-1450,2015
412247,1.9,159101.0,900,700,61450,15,-200,2015
96967,4.1,47158.0,32400,34000,68360,3,1600,2015
197199,1.9,156441.0,3650,2600,67090,12,-1050,2015
374227,4.2,30942.0,22700,15800,64520,3,-6900,2015
374933,4.8,1265.0,16150,15700,64520,0,-450,2015
408547,3.5,61566.0,9800,9100,61450,3,-700,2015
99943,3.4,87571.0,8375,7900,68360,4,-475,2015
480738,4.4,20501.0,23200,21400,73130,2,-1800,2015
442295,3.6,24839.0,18100,18300,74430,3,200,2015
251909,3.5,99300.0,14200,12000,59100,4,-2200,2015
386718,4.9,20512.0,24200,24800,65610,2,600,2015
184823,4.0,12903.0,15850,14800,63250,2,-1050,2015
485759,4.4,2741.0,13150,13400,73130,2,250,2015
289451,4.1,34238.0,10550,14800,59100,11,4250,2015
300764,2.5,69652.0,15350,13300,59100,6,-2050,2015
396826,4.7,75753.0,7575,8500,65610,2,925,2015
67642,3.6,72173.0,24000,24750,77030,7,750,2015
519833,1.9,150423.0,3250,1600,71660,7,-1650,2015
499754,3.8,92417.0,6625,7500,80610,5,875,2015
323829,3.0,57787.0,18150,17000,82750,4,-1150,2015
318433,2.9,136638.0,23800,19000,73200,4,-4800,2015
336878,3.8,180448.0,3400,3400,82750,12,0,2015
291381,2.5,36067.0,16850,17700,59100,3,850,2015
439015,3.9,74615.0,10000,12200,74430,11,2200,2015
475060,,83117.0,7650,7100,73130,4,-550,2014
443582,2.9,145663.0,7025,6900,74430,11,-125,2015
53099,2.3,18642.0,10700,9800,77030,1,-900,2015
33410,4.9,37247.0,34100,34000,77030,3,-100,2015
501990,4.3,20929.0,14700,15500,80610,2,800,2015
53401,2.8,65749.0,21400,21000,77030,4,-400,2015
294885,4.2,20060.0,27300,26200,59100,0,-1100,2015
156683,3.4,110133.0,16150,16500,73100,7,350,2015
138870,4.5,24325.0,15850,16800,73100,3,950,2015
101931,2.4,122402.0,1825,2300,68360,11,475,2015
30625,4.3,10675.0,29600,31250,77030,1,1650,2015
196615,3.7,61940.0,13700,13100,67090,2,-600,2015
172732,3.8,47644.0,12000,11300,73100,5,-700,2015
267494,4.0,61534.0,16850,16500,59100,2,-350,2015
546979,1.9,130586.0,5925,4300,81400,9,-1625,2015
299510,4.4,18786.0,15750,16000,59100,0,250,2015
325449,4.4,22352.0,13150,13500,82750,3,350,2015
192211,2.8,105798.0,9450,8900,67090,5,-550,2014
145910,2.8,93528.0,7000,7500,73100,6,500,2015
18560,1.0,22055.0,32500,27750,77030,1,-4750,2015
215172,2.4,33674.0,18450,17500,57290,4,-950,2015
398905,,28012.0,12000,9000,61450,1,-3000,2014
373986,4.9,4025.0,38900,40000,64520,0,1100,2015
171924,4.7,59894.0,45900,45000,73100,1,-900,2015
292236,1.9,134852.0,1125,300,59100,17,-825,2015
200866,2.0,23531.0,10850,3300,67090,1,-7550,2015
512269,2.6,84283.0,5400,6300,71660,6,900,2015
480620,1.9,24442.0,12000,10700,73130,3,-1300,2015
372817,4.3,40719.0,19800,19800,64520,2,0,2015
340654,4.3,29618.0,15350,15300,82750,3,-50,2015
410210,2.0,128030.0,1500,2300,61450,10,800,2015
228339,2.5,103073.0,3475,4100,89090,10,625,2015
7820,4.5,39606.0,16500,19500,77030,1,3000,2014
302105,1.9,188809.0,925,700,59100,14,-225,2015
80639,5.0,22475.0,72000,70750,68360,2,-1250,2015
320257,3.5,72384.0,7575,7800,82750,7,225,2015
209447,4.2,36155.0,14500,14000,57290,1,-500,2015
332452,3.6,28124.0,21300,20800,82750,3,-500,2015
84677,3.2,54418.0,20100,18000,68360,5,-2100,2015
335279,2.9,137037.0,5225,3900,82750,11,-1325,2015
470100,4.1,22216.0,30600,30600,61490,3,0,2015
337945,4.3,19309.0,21300,20400,82750,3,-900,2015
43218,5.0,9076.0,23400,22800,77030,0,-600,2015
485673,4.7,9652.0,16400,17200,73130,1,800,2015
160926,3.2,42818.0,5125,4400,73100,9,-725,2015
228590,3.0,45952.0,10300,9800,89090,3,-500,2015
100293,3.6,122772.0,8925,9300,68360,11,375,2015
108629,3.8,38817.0,8200,9600,68360,5,1400,2015
318148,4.1,60471.0,32400,32401,73200,2,1,2015
273014,3.7,51929.0,14300,13100,59100,11,-1200,2015
21164,1.9,100670.0,8800,3000,77030,9,-5800,2015
177054,3.5,104517.0,20200,18800,83200,5,-1400,2015
401902,4.6,11749.0,14300,15300,61450,1,1000,2015
526644,4.3,23091.0,13400,12700,70210,2,-700,2015
502303,4.6,38292.0,13500,14100,80610,2,600,2015
129121,3.5,54666.0,15700,15400,73100,2,-300,2015
125851,3.6,10950.0,12600,10500,73100,2,-2100,2015
380337,2.3,117261.0,3375,3300,64520,8,-75,2015
498851,5.0,11655.0,17450,28100,80610,2,10650,2015
134970,3.8,61260.0,12900,12400,73100,1,-500,2015
543410,4.2,24566.0,21700,24400,81400,3,2700,2015
143906,4.3,84466.0,11150,11100,73100,5,-50,2015
311650,4.6,28473.0,50700,52800,59100,2,2100,2015
452464,2.9,154265.0,5600,5700,61490,10,100,2015
461807,2.7,124292.0,11000,10800,61490,4,-200,2015
462501,3.6,115203.0,8975,9100,61490,4,125,2015
390235,3.5,129475.0,5350,5100,65610,6,-250,2015
528102,2.8,85369.0,8325,8900,70210,7,575,2015
180590,4.4,28259.0,16550,17100,83200,3,550,2015
220886,2.8,83849.0,4050,5600,57290,8,1550,2015
133048,4.1,78098.0,10050,11600,73100,7,1550,2015
323878,3.8,53724.0,18900,18300,82750,5,-600,2015
190019,2.2,49558.0,9500,7400,63250,2,-2100,2015
159475,4.8,12178.0,18850,18600,73100,0,-250,2015
36540,2.8,130662.0,14050,14250,77030,8,200,2015
532503,4.0,104528.0,8825,7800,82150,2,-1025,2015
26051,2.7,84761.0,5500,5900,77030,5,400,2015
55847,3.3,112299.0,16400,15400,77030,5,-1000,2015
162284,3.5,59669.0,20800,19600,73100,3,-1200,2015
199797,3.9,34254.0,38900,39400,67090,3,500,2015
134928,3.7,65925.0,17900,17100,73100,7,-800,2015
430680,2.3,105298.0,9225,7500,61450,9,-1725,2015
235763,4.5,37024.0,1825,4400,59100,13,2575,2014
387297,4.3,121920.0,23400,20500,65610,5,-2900,2015
289317,4.4,20236.0,39700,37800,59100,3,-1900,2015
504539,2.3,28801.0,17000,14800,80610,3,-2200,2015
107261,2.5,36664.0,21200,21000,68360,1,-200,2015
226545,1.9,116372.0,3700,2600,89090,10,-1100,2015
130767,2.5,53249.0,9025,7800,73100,5,-1225,2015
241143,3.7,21619.0,22100,22000,59100,2,-100,2015
286261,1.9,113061.0,10700,9200,59100,6,-1500,2015
255626,1.9,35944.0,10900,11600,59100,2,700,2015
419460,3.6,124594.0,2025,1700,61450,11,-325,2015
305188,3.5,51842.0,7600,9600,59100,8,2000,2015
202122,1.9,106730.0,5975,4800,57290,4,-1175,2014
181542,4.6,36030.0,11350,11500,83200,3,150,2015
513620,4.4,32067.0,16150,16900,71660,3,750,2015
434294,1.0,361561.0,700,500,74430,17,-200,2014
507353,2.6,124747.0,6150,7100,80200,7,950,2015
113185,4.5,14827.0,23800,23750,68360,2,-50,2015
233866,,122640.0,5725,6300,59100,6,575,2014
327064,3.9,40443.0,13750,13100,82750,3,-650,2015
143776,3.7,61383.0,9875,9200,73100,3,-675,2015
16563,4.1,22089.0,14200,14500,77030,3,300,2015
442224,2.0,76142.0,7000,7500,74430,7,500,2015
269304,4.0,39805.0,16250,16700,59100,2,450,2015
528087,1.0,175944.0,1750,300,70210,11,-1450,2015
451676,3.5,166653.0,13300,14400,61490,8,1100,2015
71709,2.5,137650.0,11450,11500,77030,7,50,2015
50750,4.2,24021.0,37200,36500,77030,3,-700,2015
527914,3.6,56507.0,21200,20500,70210,3,-700,2015
186782,1.9,102097.0,4375,4700,63250,7,325,2015
277931,4.3,92706.0,7625,7000,59100,8,-625,2015
322748,4.4,7668.0,22300,21100,82750,1,-1200,2015
100833,4.9,92929.0,15650,16500,68360,5,850,2015
325338,4.4,39615.0,16400,16100,82750,3,-300,2015
100612,4.4,19063.0,18950,20100,68360,2,1150,2015
217074,4.2,24845.0,9300,9100,57290,3,-200,2015
256814,2.0,34836.0,17900,16700,59100,3,-1200,2015
400072,3.1,43928.0,16200,16100,61450,1,-100,2014
235775,2.4,105408.0,1250,1600,59100,13,350,2014
488111,4.6,75082.0,17700,18400,73130,3,700,2015
90479,4.4,55934.0,8600,9400,68360,3,800,2015
414365,2.9,21175.0,23000,18400,61450,2,-4600,2015
211639,3.1,31690.0,25700,24000,57290,3,-1700,2015
97832,2.5,82964.0,13650,12500,68360,2,-1150,2015
388753,5.0,75141.0,16250,18400,65610,5,2150,2015
47961,2.5,24415.0,13900,13200,77030,3,-700,2015
427323,4.3,19032.0,26100,29000,61450,1,2900,2015
378161,4.1,22814.0,15600,16100,64520,3,500,2015
238250,3.4,65751.0,12500,13200,59100,7,700,2014
354148,4.9,16845.0,12850,14200,62960,3,1350,2015
451314,2.6,85866.0,4350,4800,61490,10,450,2015
134578,2.9,123590.0,5825,4400,73100,9,-1425,2015
500939,4.0,15324.0,13700,13500,80610,1,-200,2015
475719,1.9,1.0,11500,14500,73130,8,3000,2014
370587,1.9,94529.0,4575,5100,64520,7,525,2015
349848,4.3,45067.0,11800,12500,62960,2,700,2014
165483,2.3,37948.0,10950,9700,73100,2,-1250,2015
357455,3.9,15128.0,17800,17000,62960,1,-800,2015
497995,4.9,442.0,18650,18700,73130,1,50,2015
96043,3.3,84412.0,12450,11500,68360,4,-950,2015
371212,5.0,11275.0,20700,21000,64520,0,300,2015
243639,4.4,46876.0,20200,21000,59100,3,800,2015
25265,2.7,18526.0,9975,9000,77030,2,-975,2015
377068,3.5,15518.0,29400,28900,64520,1,-500,2015
119825,3.5,76626.0,6050,6500,73100,4,450,2014
521953,2.5,141590.0,3050,3400,71660,11,350,2015
119629,4.9,44912.0,15200,16400,73100,3,1200,2014
488945,4.0,24579.0,18250,18000,73130,1,-250,2015
483047,2.4,122464.0,6600,5500,73130,7,-1100,2015
328650,2.5,30980.0,16900,14800,82750,4,-2100,2015
331197,2.5,111611.0,2775,1500,82750,11,-1275,2015
123671,3.9,29368.0,13650,13800,73100,3,150,2015
512578,3.5,56275.0,10900,10900,71660,2,0,2015
233091,2.5,28050.0,28400,22200,59100,4,-6200,2015
359437,3.2,86281.0,35200,32750,62960,4,-2450,2015
488681,4.8,11603.0,17400,18500,73130,1,1100,2015
221722,4.2,11592.0,39100,40500,57290,3,1400,2015
119438,3.6,36040.0,17000,15000,73100,3,-2000,2014
166756,4.2,57538.0,4975,6400,73100,10,1425,2015
44315,4.0,33909.0,28400,27900,77030,1,-500,2015
338407,2.5,35107.0,19400,18600,82750,3,-800,2015
440345,1.0,135052.0,950,350,74430,16,-600,2015
186732,3.4,56251.0,14350,16600,63250,4,2250,2015
343838,3.5,61137.0,11400,11200,82750,2,-200,2015
177266,4.0,22663.0,19050,19700,83200,1,650,2015
171285,3.4,32966.0,18400,17100,73100,1,-1300,2015
538130,4.1,58237.0,10200,10200,55590,2,0,2015
358790,4.8,7732.0,15350,15700,62960,1,350,2015
419923,3.9,65063.0,11050,11100,61450,2,50,2015
154594,1.0,73136.0,7125,5400,73100,8,-1725,2015
468740,4.2,114483.0,10500,13600,61490,8,3100,2015
200275,1.0,139660.0,1125,250,67090,12,-875,2015
2540,2.3,102949.0,9400,8400,77030,4,-1000,2014
523961,,113293.0,12050,11000,70210,4,-1050,2014
34086,2.0,186060.0,1275,850,77030,8,-425,2015
237095,,165955.0,1100,700,59100,10,-400,2014
338043,3.6,6260.0,18150,18800,82750,1,650,2015
83160,2.8,171098.0,2700,1700,68360,7,-1000,2015
102625,4.1,19960.0,22600,24700,68360,4,2100,2015
190198,3.1,82419.0,14900,14250,63250,6,-650,2015
495808,2.6,51534.0,8475,8500,73130,2,25,2015
272977,2.9,126511.0,1950,1200,59100,10,-750,2015
336102,4.5,7040.0,16950,18200,82750,1,1250,2015
520737,4.0,36701.0,21700,21000,71660,2,-700,2015
32057,3.5,100736.0,6725,9700,77030,7,2975,2015
372717,4.8,54221.0,15650,14800,64520,1,-850,2015
221599,3.5,82056.0,25100,26400,57290,6,1300,2015
249628,1.9,108073.0,1800,1500,59100,12,-300,2015
297521,1.0,145420.0,875,400,59100,23,-475,2015
269034,2.9,89408.0,8975,8100,59100,11,-875,2015
501755,4.7,16332.0,25400,27000,80610,2,1600,2015
398707,2.9,142179.0,3550,3900,61450,13,350,2014
520899,2.8,13645.0,16800,16000,71660,1,-800,2015
330527,4.5,18121.0,18750,18300,82750,3,-450,2015
181249,4.9,23968.0,19500,19400,83200,1,-100,2015
453673,2.6,103198.0,8650,8900,61490,8,250,2015
513686,3.7,46148.0,16550,15500,71660,1,-1050,2015
438486,2.0,245404.0,1450,550,74430,16,-900,2015
229046,3.8,93827.0,17650,18100,89090,4,450,2015
201113,4.5,7954.0,13100,13300,57290,3,200,2014
369988,2.8,105836.0,11350,13500,64520,9,2150,2015
10057,3.9,13913.0,15000,14250,77030,1,-750,2014
398623,,127436.0,4800,6000,61450,11,1200,2014
276161,5.0,7320.0,13800,13400,59100,3,-400,2015
22505,2.6,80188.0,9525,10750,77030,11,1225,2015
257452,4.5,13993.0,16200,16000,59100,1,-200,2015
496508,2.0,74211.0,11250,11400,73130,9,150,2015
83804,4.0,95721.0,34000,36400,68360,4,2400,2015
217417,4.4,40243.0,9950,10000,57290,1,50,2015
30068,5.0,26326.0,40800,44500,77030,4,3700,2015
538821,3.8,94432.0,2900,4400,55590,11,1500,2015
286228,1.9,44918.0,11950,12600,59100,4,650,2015
288641,3.4,37181.0,15200,15200,59100,3,0,2015
336003,3.6,32833.0,12000,11400,82750,3,-600,2015
199517,4.6,28479.0,27700,27750,67090,3,50,2015
335075,3.2,11448.0,20100,19400,82750,4,-700,2015
123323,4.0,9329.0,30600,29400,73100,0,-1200,2014
299380,3.8,49892.0,9675,9500,59100,2,-175,2015
16102,3.8,80330.0,22500,21500,77030,3,-1000,2015
82186,2.8,105092.0,2875,2900,68360,10,25,2015
143173,3.6,28589.0,23000,24800,73100,4,1800,2015
145395,5.0,72684.0,14550,17600,73100,7,3050,2015
279571,4.9,14413.0,65000,70200,59100,2,5200,2015
503354,2.8,98455.0,29500,25000,80610,3,-4500,2015
472123,3.0,172711.0,2125,1350,62930,9,-775,2015
525113,3.1,113051.0,9750,7900,70210,8,-1850,2015
141216,4.1,78988.0,6400,7800,73100,8,1400,2015
234145,,132343.0,10800,9500,59100,7,-1300,2014
14573,2.6,227778.0,350,950,77030,15,600,2015
347090,3.6,69567.0,8550,10400,82750,6,1850,2015
137702,4.4,13171.0,20400,21100,73100,2,700,2015
132952,3.5,76104.0,14050,12800,73100,5,-1250,2015
235043,,104840.0,3275,3000,59100,9,-275,2014
298931,2.5,88364.0,4900,5100,59100,9,200,2015
416359,2.6,121641.0,8775,6000,61450,11,-2775,2015
326931,4.0,87621.0,10200,9000,82750,3,-1200,2015
19993,3.6,54304.0,11550,12000,77030,2,450,2015
484721,2.6,71720.0,5075,6000,73130,8,925,2015
34441,1.9,212938.0,1075,1250,77030,11,175,2015
230907,2.4,185725.0,1425,1100,89090,16,-325,2015
202831,2.0,74924.0,7675,8000,57290,5,325,2015
496330,2.8,127857.0,5975,6000,73130,9,25,2015
318427,3.6,65830.0,7850,8500,73200,3,650,2015
3502,2.0,83480.0,7475,7000,77030,7,-475,2014
445355,1.0,223033.0,1050,550,56120,10,-500,2015
269930,3.5,38716.0,12500,12800,59100,3,300,2015
462203,3.4,101578.0,1425,2000,61490,12,575,2015
269178,4.4,23493.0,13850,14500,59100,1,650,2015
51275,2.5,130116.0,5100,4700,77030,9,-400,2015
370547,2.9,56236.0,18350,16250,64520,5,-2100,2015
433590,1.0,139449.0,525,325,74430,18,-200,2014
227022,2.1,36610.0,11400,11800,89090,4,400,2015
455919,2.0,210069.0,2100,3200,61490,11,1100,2015
16637,4.1,25257.0,20900,22750,77030,4,1850,2015
135904,3.7,82285.0,13050,13200,73100,8,150,2015
488965,4.8,43772.0,30100,32800,73130,3,2700,2015
318649,2.8,54275.0,12450,11900,73200,2,-550,2015
303831,3.7,85731.0,11700,9400,59100,7,-2300,2015
102370,2.8,134282.0,3475,3100,68360,9,-375,2015
116841,2.9,22190.0,12350,10600,68360,3,-1750,2015
397109,5.0,26966.0,15350,16500,65610,2,1150,2015
325398,4.0,97724.0,9775,8100,82750,3,-1675,2015
23616,2.7,133893.0,6350,6600,77030,8,250,2015
448496,4.2,14123.0,13750,14700,56120,1,950,2015
135,2.6,56651.0,10250,10700,77030,1,450,2014
231961,2.8,198815.0,5400,2400,89090,4,-3000,2015
450746,3.7,96260.0,14350,13400,61490,2,-950,2015
527726,4.3,33350.0,13300,12600,70210,2,-700,2015
412826,4.2,29775.0,39600,40500,61450,3,900,2015
261686,4.5,37089.0,11050,12800,59100,5,1750,2015
138214,3.0,16687.0,30400,28600,73100,1,-1800,2015
294410,4.0,79545.0,5325,5000,59100,9,-325,2015
78526,3.6,40786.0,11300,11400,68360,1,100,2014
1709,4.1,53345.0,11150,8400,77030,2,-2750,2014
34029,3.5,68204.0,13150,14800,77030,7,1650,2015
444729,,28325.0,31200,30500,56120,2,-700,2014
195698,1.9,119573.0,24500,22000,67090,7,-2500,2015
81678,4.5,23583.0,18500,18800,68360,1,300,2015
176571,3.5,37468.0,17200,17400,83200,1,200,2015
401102,2.2,161843.0,1200,1400,61450,15,200,2015
515081,2.8,7642.0,15850,16900,71660,2,1050,2015
331017,2.4,99199.0,7600,5400,82750,8,-2200,2015
166514,4.1,53633.0,3900,6200,73100,12,2300,2015
225418,4.1,61718.0,13700,14500,89090,2,800,2015
465674,5.0,686.0,12200,13800,61490,1,1600,2015
295075,3.1,78174.0,4250,4000,59100,6,-250,2015
193771,2.6,36116.0,28800,27800,67090,3,-1000,2015
17959,4.8,20459.0,30400,32500,77030,3,2100,2015
151748,4.6,14882.0,11750,12000,73100,2,250,2015
547995,2.9,60660.0,14900,14500,78090,3,-400,2015
355977,3.5,103667.0,7875,7200,62960,8,-675,2015
404509,4.3,15238.0,15550,15400,61450,1,-150,2015
232444,3.5,88227.0,7875,7100,89090,13,-775,2015
18145,1.9,80232.0,1725,1500,77030,14,-225,2015
7412,,146279.0,3025,4400,77030,10,1375,2014
515462,1.9,125816.0,1250,2000,71660,13,750,2015
406173,4.0,30158.0,10450,9700,61450,1,-750,2015
28948,3.6,132979.0,10050,9500,77030,5,-550,2015
446241,1.9,151019.0,7800,7300,56120,9,-500,2015
236773,1.9,54187.0,18150,15400,59100,2,-2750,2014
459115,2.1,49904.0,7775,6500,61490,7,-1275,2015
291715,3.7,84803.0,14050,14800,59100,7,750,2015
326758,2.6,34036.0,19500,19500,82750,2,0,2015
338785,2.8,28074.0,17750,15800,82750,3,-1950,2015
246307,4.1,21757.0,26800,25300,59100,2,-1500,2015
341068,4.4,67444.0,11300,11200,82750,4,-100,2015
155341,4.4,25704.0,18650,13300,73100,3,-5350,2015
145168,4.8,5783.0,35100,36750,73100,1,1650,2015
524943,3.5,16147.0,16600,15800,70210,3,-800,2015
535517,1.9,101376.0,6925,7000,82150,4,75,2015
536772,4.0,17242.0,35300,36700,73640,1,1400,2015
319375,2.9,50180.0,11100,11000,73200,2,-100,2015
281136,4.2,52108.0,15400,17700,59100,4,2300,2015
248693,4.4,17913.0,14900,14250,59100,2,-650,2015
146617,4.5,26219.0,17050,18500,73100,3,1450,2015
329671,3.7,25786.0,35700,34600,82750,3,-1100,2015
174368,4.7,49133.0,20900,22400,83200,4,1500,2015
495708,4.7,8626.0,10700,11600,73130,1,900,2015
363218,4.7,10308.0,21300,21400,64520,0,100,2015
514740,3.3,49928.0,8225,7900,71660,8,-325,2015
128585,3.6,92944.0,9450,8000,73100,5,-1450,2015
346790,2.1,39472.0,19700,18000,82750,3,-1700,2015
217983,4.8,40709.0,18300,18500,57290,3,200,2015
90617,3.8,36079.0,21300,21800,68360,3,500,2015
252034,1.9,13315.0,8000,3600,59100,11,-4400,2015
62716,2.8,128682.0,5550,6300,77030,11,750,2015
74612,,172251.0,3475,2600,68360,10,-875,2014
427846,2.2,169218.0,1850,2500,61450,9,650,2015
441025,3.9,57422.0,16250,16700,74430,3,450,2015
99270,4.8,12098.0,15400,16200,68360,1,800,2015
29144,4.9,14126.0,21300,21500,77030,1,200,2015
543599,3.3,18160.0,15400,15100,81400,1,-300,2015
445353,2.0,305337.0,225,1000,56120,9,775,2015
75513,3.5,39249.0,14350,13800,68360,2,-550,2015
105794,4.8,23629.0,12750,16000,68360,3,3250,2015
148551,4.3,12520.0,12400,13600,73100,1,1200,2015
260060,3.7,77313.0,10950,13800,59100,10,2850,2015
77621,1.9,1.0,14050,8800,68360,8,-5250,2015
2792,1.9,88599.0,8800,8000,77030,4,-800,2014
30750,4.2,15748.0,14200,12900,77030,2,-1300,2015
139738,3.0,170661.0,1525,2400,73100,9,875,2015
494619,5.0,15776.0,35600,35000,73130,1,-600,2015
253968,4.4,30960.0,10700,9600,59100,1,-1100,2015
99138,4.4,43630.0,38800,38800,68360,1,0,2015
201503,4.2,39360.0,14350,15000,57290,2,650,2015
76448,3.6,117596.0,8525,8300,68360,6,-225,2014
180700,3.9,34840.0,13100,13300,83200,1,200,2015
499965,4.1,38588.0,17200,17400,80610,1,200,2015
118075,3.9,6146.0,19500,21200,68360,2,1700,2015
442229,2.0,99091.0,7950,6500,74430,2,-1450,2015
418447,3.6,35865.0,3850,5400,61450,9,1550,2015
25874,3.4,39950.0,10600,11000,77030,2,400,2015
211491,4.7,34095.0,13500,13800,57290,1,300,2015
111184,2.8,17782.0,14600,11400,68360,1,-3200,2015
352069,3.8,32961.0,25800,28000,62960,4,2200,2015
375608,3.9,44616.0,10250,10200,64520,3,-50,2015
458221,3.9,63443.0,6050,7100,61490,7,1050,2015
434334,4.0,16603.0,17000,17200,74430,1,200,2015
148046,3.5,35519.0,21900,22500,73100,1,600,2015
158146,2.9,30447.0,18100,17600,73100,3,-500,2015
181924,2.7,107142.0,5175,5800,83200,8,625,2015
538721,2.9,83222.0,11450,10700,55590,2,-750,2015
490914,4.3,26229.0,17850,18700,73130,3,850,2015
357568,2.0,241728.0,2325,2700,62960,11,375,2015
469618,1.9,153210.0,1650,1100,61490,12,-550,2015
249593,2.0,180471.0,1875,1300,59100,12,-575,2015
166177,3.9,29582.0,11600,10250,73100,3,-1350,2015
166735,3.1,101463.0,15850,16900,73100,7,1050,2015
439709,3.0,179806.0,1025,1800,74430,21,775,2015
371779,4.2,17251.0,13150,13500,64520,3,350,2015
452397,3.7,120067.0,3750,5100,61490,9,1350,2015
287368,3.6,58627.0,23200,22600,59100,2,-600,2015
419665,4.4,54851.0,15650,16200,61450,3,550,2015
72528,3.9,122995.0,15300,17800,77030,8,2500,2015
402932,2.7,204167.0,800,1200,61450,13,400,2015
10381,3.7,69457.0,7800,7500,77030,2,-300,2014
242472,4.0,20911.0,16850,16300,59100,1,-550,2015
199737,3.5,16153.0,13500,13400,67090,2,-100,2015
269221,3.6,31404.0,13950,14800,59100,2,850,2015
133835,4.0,57036.0,10150,10800,73100,2,650,2015
5461,4.4,16144.0,18800,16700,77030,0,-2100,2014
323665,4.1,36093.0,9750,8800,82750,2,-950,2015
537792,4.1,34794.0,20200,19900,55590,1,-300,2014
471982,4.6,36445.0,41600,42000,62930,1,400,2015
250675,4.5,19962.0,15550,16400,59100,2,850,2015
18246,4.4,24350.0,15100,17800,77030,2,2700,2015
485679,4.2,15296.0,16000,17600,73130,1,1600,2015
148590,4.2,12025.0,19500,18800,73100,2,-700,2015
541638,4.3,18300.0,11250,11000,81400,3,-250,2015
306441,2.3,117880.0,9750,10900,59100,11,1150,2015
460780,4.3,98135.0,9800,11000,61490,6,1200,2015
183779,3.8,43081.0,13350,13000,63250,1,-350,2014
11502,2.0,63663.0,9375,9400,77030,2,25,2014
174132,3.8,21093.0,13000,12000,83200,1,-1000,2014
57348,4.4,32613.0,27100,25900,77030,3,-1200,2015
11313,4.7,21120.0,19950,21500,77030,1,1550,2014
540300,2.6,101424.0,6275,6500,81400,7,225,2014
336199,4.9,13941.0,20800,19200,82750,1,-1600,2015
211819,4.1,65503.0,20300,23100,57290,4,2800,2015
249303,3.0,66053.0,7650,7900,59100,7,250,2015
267619,2.1,33780.0,21600,18400,59100,3,-3200,2015
469439,4.4,93719.0,5250,6300,61490,8,1050,2015
485818,3.1,30881.0,12150,12800,73130,3,650,2015
444126,4.3,17512.0,12500,13100,74430,1,600,2015
101549,1.9,115458.0,13300,13750,68360,8,450,2015
490620,2.8,24240.0,13850,13500,73130,2,-350,2015
141085,4.1,35044.0,8700,10250,73100,5,1550,2015
484802,4.1,21500.0,30200,30800,73130,1,600,2015
350232,3.3,62070.0,12350,12200,62960,7,-150,2014
419816,4.4,17533.0,15150,15700,61450,1,550,2015
2300,3.7,22952.0,27500,25500,77030,3,-2000,2014
513229,2.4,48634.0,15650,17600,71660,4,1950,2015
151475,2.6,125409.0,12100,11400,73100,7,-700,2015
184143,4.0,17180.0,17000,19100,63250,1,2100,2015
390599,4.6,53210.0,10250,9900,65610,3,-350,2015
446213,3.7,64831.0,10350,10800,56120,3,450,2015
259625,4.7,17008.0,22800,21000,59100,2,-1800,2015
254435,1.9,107085.0,1375,1200,59100,13,-175,2015
272246,4.3,35630.0,22700,24600,59100,3,1900,2015
135484,2.3,44986.0,18450,17900,73100,2,-550,2015
178485,4.8,17533.0,26100,25600,83200,2,-500,2015
151764,3.7,36281.0,11450,11200,73100,2,-250,2015
386528,4.3,36584.0,10750,12200,65610,2,1450,2015
115991,2.8,105310.0,11600,12200,68360,5,600,2015
411423,2.7,26371.0,26700,25750,61450,3,-950,2015
330098,2.4,61659.0,4775,3700,82750,12,-1075,2015
528029,4.1,35894.0,22500,21500,70210,5,-1000,2015
65651,4.0,24944.0,28200,28500,77030,3,300,2015
111422,4.1,159205.0,5750,7100,68360,12,1350,2015
321088,,53364.0,25000,26000,82750,2,1000,2014
456643,3.5,115651.0,9600,8200,61490,8,-1400,2015
56034,1.9,144149.0,4275,5200,77030,11,925,2015
280235,2.5,20125.0,12850,12300,59100,3,-550,2015
286411,4.5,42103.0,31800,33800,59100,2,2000,2015
343318,4.0,44415.0,17350,18600,82750,3,1250,2015
284028,2.3,77889.0,6350,6800,59100,5,450,2015
28117,3.0,80096.0,12500,13900,77030,7,1400,2015
41630,3.4,73116.0,6825,8500,77030,8,1675,2015
533386,2.7,106223.0,4800,2900,82150,11,-1900,2015
50632,3.6,22234.0,22700,25000,77030,2,2300,2015
413184,2.9,153909.0,2225,2400,61450,11,175,2015
4334,2.0,35333.0,6200,6900,77030,10,700,2015
328326,4.5,146316.0,1900,2050,82750,12,150,2015
83979,3.8,95382.0,5450,7000,68360,10,1550,2015
189889,2.8,47415.0,10100,9400,63250,1,-700,2015
285987,4.6,30931.0,25900,28300,59100,2,2400,2015
541961,3.5,36735.0,14400,15700,81400,3,1300,2015
409537,3.5,78038.0,8950,8200,61450,3,-750,2015
14964,1.0,5291.0,16700,8800,77030,0,-7900,2015
14994,4.2,92378.0,20400,21250,77030,6,850,2015
266085,4.9,18462.0,22000,21200,59100,2,-800,2015
202620,4.3,43464.0,13900,14200,57290,3,300,2015
185853,1.9,103703.0,12500,9000,63250,9,-3500,2015
159645,4.0,30837.0,16150,16900,73100,1,750,2015
320154,2.2,46230.0,34900,30250,82750,5,-4650,2015
358532,2.7,67640.0,6550,6800,62960,5,250,2015
67369,4.2,29369.0,20200,21000,77030,2,800,2015
400687,4.4,39925.0,12600,13300,61450,2,700,2015
270112,1.9,43120.0,11400,8800,59100,3,-2600,2015
224478,2.0,92427.0,7475,7200,89090,8,-275,2015
495335,4.3,30514.0,19150,19800,73130,3,650,2015
177246,3.3,76381.0,14550,14800,83200,7,250,2015
247,1.0,36957.0,11400,9400,77030,1,-2000,2014
253646,3.5,58858.0,13400,12600,59100,3,-800,2015
546855,4.5,41431.0,13950,14700,81400,7,750,2015
339878,3.9,20285.0,21700,21000,82750,0,-700,2015
154130,4.2,52560.0,6875,6500,73100,3,-375,2015
3737,,98116.0,14750,13800,77030,8,-950,2014
22703,4.2,18045.0,25600,25300,77030,1,-300,2015
210222,2.7,149063.0,3000,6400,57290,13,3400,2015
120206,4.4,45030.0,17350,19600,73100,7,2250,2015
191970,1.9,75642.0,18550,16500,67090,7,-2050,2015
191153,2.3,38079.0,19600,18300,67090,4,-1300,2015
507342,1.0,161604.0,1025,200,80200,14,-825,2015
224619,4.5,43879.0,13900,13100,89090,2,-800,2015
309571,3.8,86053.0,10450,10900,59100,3,450,2015
145010,4.1,55298.0,6575,6300,73100,6,-275,2015
512305,2.6,139640.0,8700,8900,71660,3,200,2015
79579,3.7,39026.0,23400,22000,68360,2,-1400,2015
10499,4.1,67255.0,14250,16100,77030,3,1850,2014
48122,3.8,52845.0,19550,21500,77030,4,1950,2015
206256,4.1,23759.0,19050,18400,57290,3,-650,2015
28159,2.5,111408.0,9325,12800,77030,8,3475,2015
282881,3.6,79486.0,11950,16100,59100,6,4150,2015
380298,2.3,72779.0,8425,6600,64520,4,-1825,2015
416087,4.3,58690.0,10450,12800,61450,3,2350,2015
519998,1.9,93889.0,2450,1700,71660,15,-750,2015
72227,3.6,102926.0,12150,7900,77030,7,-4250,2015
218811,2.6,67969.0,5225,5500,57290,5,275,2015
352498,3.4,76517.0,8950,9800,62960,4,850,2015
419664,2.8,76965.0,13650,13000,61450,3,-650,2015
404104,4.9,17109.0,33700,34700,61450,1,1000,2015
192968,4.5,11517.0,25700,26200,67090,2,500,2015
81566,4.6,47166.0,17050,17500,68360,4,450,2015
508968,1.9,24963.0,12000,10500,71660,0,-1500,2014
519812,2.7,194014.0,1750,2000,71660,13,250,2015
230418,2.9,56563.0,10450,9900,89090,2,-550,2015
61725,4.5,39590.0,31500,36500,77030,6,5000,2015
86010,4.2,68073.0,16300,16500,68360,7,200,2015
243370,4.4,17060.0,14650,15400,59100,2,750,2015
328394,4.4,29850.0,24600,24800,82750,3,200,2015
192214,1.9,64827.0,7600,4600,67090,6,-3000,2015
434209,4.0,17629.0,30000,29800,74430,1,-200,2015
161052,4.6,25056.0,11000,11400,73100,3,400,2015
90613,4.7,71900.0,9800,9000,68360,3,-800,2015
373642,3.7,25796.0,18350,17900,64520,3,-450,2015
511027,4.7,26904.0,11700,11000,71660,2,-700,2015
120773,2.8,54656.0,3575,7200,73100,13,3625,2015
452063,3.1,186001.0,425,2250,61490,14,1825,2015
254483,1.9,107922.0,2075,1100,59100,14,-975,2015
277223,4.6,20829.0,22000,22000,59100,2,0,2015
53480,2.8,251387.0,1000,2600,77030,8,1600,2015
372543,2.9,167802.0,1050,1800,64520,13,750,2015
369209,3.5,63658.0,16400,17100,64520,6,700,2015
200530,4.5,11340.0,14900,14600,67090,1,-300,2015
259182,3.2,75282.0,8350,8000,59100,7,-350,2015
204457,4.7,33399.0,24400,24200,57290,1,-200,2015
248208,2.1,86834.0,3475,3900,59100,12,425,2015
279469,4.4,79600.0,11650,14200,59100,6,2550,2015
532699,2.1,193581.0,3925,3200,82150,9,-725,2015
339764,3.3,41443.0,13900,13100,82750,3,-800,2015
478767,2.6,38157.0,10850,10300,73130,4,-550,2015
350230,3.5,82889.0,14700,14600,62960,8,-100,2015
383137,4.7,9917.0,19650,19000,65610,2,-650,2015
517270,3.9,42345.0,12150,12000,71660,1,-150,2015
496833,2.2,47807.0,15950,15300,73130,2,-650,2015
360836,,236273.0,2075,1900,64520,9,-175,2014
48137,2.8,72043.0,6125,7100,77030,4,975,2015
490030,3.9,54095.0,10650,11000,73130,3,350,2015
112058,3.6,120496.0,8275,7200,68360,10,-1075,2015
255243,3.0,74814.0,6475,6600,59100,8,125,2015
286376,1.9,43081.0,11250,9500,59100,2,-1750,2015
521571,4.5,5674.0,20300,20200,71660,1,-100,2015
245449,2.9,63953.0,12700,13000,59100,7,300,2015
321800,2.8,119821.0,6500,6600,82750,7,100,2014
301963,4.4,17337.0,14000,14000,59100,1,0,2015
435339,5.0,4657.0,13200,12800,74430,1,-400,2015
260941,3.7,31393.0,11150,10800,59100,2,-350,2015
31001,2.0,65065.0,19350,20500,77030,4,1150,2015
475808,,112705.0,3625,1800,73130,9,-1825,2014
486075,4.7,26437.0,17150,18500,73130,1,1350,2015
316328,,184009.0,875,3100,73200,12,2225,2014
40677,4.1,14563.0,28800,27000,77030,1,-1800,2015
266099,3.7,38414.0,29300,28900,59100,2,-400,2015
230561,1.9,172101.0,1050,750,89090,14,-300,2015
140197,3.6,39100.0,10850,10600,73100,2,-250,2015
34094,2.3,154655.0,2325,2250,77030,8,-75,2015
195436,2.0,121170.0,2475,1200,67090,9,-1275,2015
21674,2.0,15758.0,11100,6100,77030,1,-5000,2015
336257,4.2,12125.0,17700,19000,82750,2,1300,2015
322386,2.3,118944.0,2750,2800,82750,7,50,2015
120422,2.7,133389.0,7600,7600,73100,7,0,2014
378678,4.4,35386.0,15450,15500,64520,3,50,2015
527644,2.9,50643.0,12250,10300,70210,2,-1950,2015
174185,2.2,95338.0,10050,10200,83200,5,150,2014
74104,4.4,29180.0,19200,19000,68360,1,-200,2015
52869,4.5,63575.0,15250,17750,77030,8,2500,2015
212727,5.0,14849.0,31800,33500,57290,1,1700,2015
524041,,94440.0,10650,10500,70210,5,-150,2014
284104,1.9,121330.0,3525,2900,59100,9,-625,2015
312800,3.7,172248.0,9225,9600,59100,7,375,2015
458841,4.8,3025.0,14450,14400,61490,1,-50,2015
30412,1.9,67798.0,7850,3100,77030,11,-4750,2015
274064,2.7,68102.0,18100,17000,59100,3,-1100,2015
255081,4.6,14939.0,23800,24400,59100,1,600,2015
186975,4.1,60938.0,15650,15800,63250,3,150,2015
359761,4.2,80088.0,9750,9000,62960,6,-750,2015
152100,4.8,45633.0,32700,30250,73100,2,-2450,2015
360162,4.1,100349.0,15650,18200,62960,9,2550,2015
309352,2.6,206467.0,100,1500,59100,9,1400,2015
443501,3.7,78625.0,4250,6000,74430,4,1750,2015
433781,2.4,88012.0,6625,4500,74430,3,-2125,2014
9954,4.6,17702.0,16450,17200,77030,2,750,2015
536599,2.9,135517.0,6550,6200,73640,9,-350,2015
310791,3.5,99328.0,7650,8500,59100,7,850,2015
432577,2.0,99414.0,6375,6500,74430,5,125,2014
196980,2.1,45253.0,7075,5500,67090,5,-1575,2015
185656,1.9,77497.0,8975,8000,63250,6,-975,2015
476678,1.9,12428.0,25400,22500,73130,1,-2900,2014
369633,3.7,38884.0,24300,21500,64520,2,-2800,2015
324334,1.9,29339.0,10150,9400,82750,3,-750,2015
200212,2.4,84264.0,11550,11700,67090,6,150,2015
356073,3.2,42314.0,17800,17700,62960,3,-100,2015
96871,4.4,20945.0,22900,23000,68360,2,100,2015
189971,5.0,54.0,15250,15000,63250,1,-250,2015
364510,4.2,8530.0,21100,20500,64520,1,-600,2015
278461,2.1,96117.0,7075,5900,59100,5,-1175,2015
42551,4.4,70902.0,9000,10100,77030,4,1100,2015
351446,2.5,127671.0,10250,6250,62960,8,-4000,2015
396076,4.9,32795.0,27900,27200,65610,2,-700,2015
306228,4.4,14916.0,17200,17500,59100,1,300,2015
376995,1.9,163321.0,1325,1200,64520,10,-125,2015
216992,4.6,35373.0,16400,16900,57290,1,500,2015
231339,3.0,42007.0,12250,9200,89090,1,-3050,2015
276950,4.9,20246.0,15300,15700,59100,1,400,2015
260548,2.3,98816.0,8550,8200,59100,9,-350,2015
292221,4.1,40601.0,18400,17000,59100,3,-1400,2015
202045,4.2,22672.0,13300,14200,57290,2,900,2014
104143,2.3,103615.0,6375,4400,68360,4,-1975,2015
68069,2.0,111320.0,4575,5100,77030,11,525,2015
32835,3.6,25888.0,50300,51500,77030,2,1200,2015
392634,3.7,46854.0,22200,18500,65610,4,-3700,2015
254102,3.8,56722.0,10400,10200,59100,3,-200,2015
386683,2.5,75005.0,5325,2100,65610,8,-3225,2015
108509,4.3,53355.0,16200,17000,68360,4,800,2015
549349,4.0,39599.0,13400,16100,48460,3,2700,2015
117137,2.5,88833.0,11400,10900,68360,8,-500,2015
483886,3.6,57824.0,11750,11700,73130,2,-50,2015
59198,4.5,31665.0,20000,19000,77030,3,-1000,2015
297855,2.8,112902.0,7450,7800,59100,7,350,2015
3772,,125794.0,6750,4500,77030,8,-2250,2014
444051,3.9,97205.0,2675,4600,74430,12,1925,2015
461230,2.0,115867.0,4200,3300,61490,17,-900,2015
44135,3.9,50703.0,10950,11750,77030,3,800,2015
148628,4.7,36172.0,27600,26800,73100,3,-800,2015
13034,4.5,25098.0,29800,30750,77030,3,950,2015
263513,2.7,42342.0,33300,31000,59100,3,-2300,2015
499610,3.9,74242.0,25000,27800,80610,3,2800,2015
364954,3.7,22737.0,23600,23500,64520,3,-100,2015
331752,4.8,35958.0,21900,22500,82750,4,600,2015
513363,4.9,32633.0,12300,12500,71660,1,200,2015
68985,4.4,26856.0,23400,24500,77030,1,1100,2015
61590,2.8,27284.0,27100,26000,77030,3,-1100,2015
320795,,186153.0,4950,4800,82750,12,-150,2014
62157,1.9,158931.0,775,850,77030,15,75,2015
454195,2.1,164778.0,2000,900,61490,11,-1100,2015
82609,4.3,35119.0,17250,18300,68360,2,1050,2015
152179,4.7,37532.0,24800,25200,73100,3,400,2015
165565,3.7,52114.0,9275,9800,73100,2,525,2015
161264,4.0,29321.0,26800,27400,73100,4,600,2015
520423,2.8,44590.0,20300,18300,71660,3,-2000,2015
110251,4.4,24858.0,12900,15000,68360,2,2100,2015
502123,3.9,47101.0,13800,14700,80610,5,900,2015
356845,4.9,34136.0,13900,14000,62960,1,100,2015
128243,2.9,97669.0,8800,8900,73100,9,100,2015
184436,3.1,47717.0,11350,13000,63250,3,1650,2015
353781,3.2,37511.0,22100,20500,62960,3,-1600,2015
487453,3.9,58059.0,9550,9500,73130,2,-50,2015
320729,,193414.0,1750,2400,82750,11,650,2014
212438,2.7,48010.0,20400,20100,57290,4,-300,2015
466704,1.9,223326.0,3750,3800,61490,10,50,2015
393490,1.9,177228.0,3700,2700,65610,8,-1000,2015
143800,4.2,31785.0,15250,15600,73100,3,350,2015
477907,3.4,30977.0,11350,10700,73130,2,-650,2015
223142,1.9,124922.0,2700,1800,89090,8,-900,2015
337655,4.3,75491.0,25600,25800,82750,6,200,2015
367103,3.9,121422.0,7725,8500,64520,8,775,2015
275299,2.8,117612.0,3825,3300,59100,10,-525,2015
291465,2.7,40607.0,13250,12800,59100,2,-450,2015
392976,4.3,18451.0,28700,26900,65610,2,-1800,2015
548384,1.9,101687.0,6525,4800,48460,11,-1725,2015
267481,3.7,61410.0,13000,12900,59100,2,-100,2015
7988,,96228.0,8500,10700,77030,5,2200,2014
6237,3.7,43952.0,15200,16200,77030,1,1000,2014
264469,3.6,81936.0,7750,8300,59100,7,550,2015
344047,2.0,95454.0,3275,3200,82750,11,-75,2015
329931,1.9,96318.0,9625,7500,82750,9,-2125,2015
408654,2.8,89201.0,7150,6700,61450,9,-450,2015
315248,2.0,184583.0,3275,3400,59100,8,125,2015
6700,3.6,62251.0,31400,31250,77030,3,-150,2014
190239,2.9,34977.0,10350,11200,63250,1,850,2015
121479,4.7,25096.0,14300,13600,73100,1,-700,2014
526411,2.7,28034.0,5475,4000,70210,12,-1475,2015
113223,4.4,17373.0,14500,14200,68360,2,-300,2015
242023,4.8,5645.0,11550,11400,59100,1,-150,2015
243547,4.8,19493.0,20000,19400,59100,3,-600,2015
374870,2.6,169776.0,7325,6000,64520,9,-1325,2015
478826,1.9,146339.0,3575,2300,73130,10,-1275,2015
483297,3.0,33742.0,16700,16300,73130,3,-400,2015
382160,4.9,23722.0,23600,25500,65610,4,1900,2015
125191,3.3,42581.0,22100,22000,73100,3,-100,2015
254794,3.2,42413.0,8175,7000,59100,3,-1175,2015
313705,4.6,27871.0,12200,12500,59100,2,300,2015
401229,4.7,9048.0,15500,15900,61450,1,400,2015
348700,3.6,36317.0,13400,13800,62960,1,400,2014
81998,3.6,17118.0,23400,21900,68360,1,-1500,2015
455129,3.9,44698.0,11950,11500,61490,2,-450,2015
189935,2.5,22903.0,11250,8500,63250,2,-2750,2015
385057,4.2,23545.0,27100,26800,65610,6,-300,2015
100686,4.0,22457.0,40600,41500,68360,3,900,2015
498906,2.7,53737.0,12200,12600,80610,2,400,2014
363623,4.5,34377.0,3900,5400,64520,10,1500,2015
457725,4.7,15317.0,12900,13900,61490,2,1000,2015
394120,4.3,18228.0,18300,17700,65610,2,-600,2015
513139,3.8,38592.0,14300,14000,71660,1,-300,2015
497342,4.0,22707.0,13050,12600,73130,1,-450,2015
34651,2.0,167782.0,2250,2800,77030,15,550,2015
396049,2.1,91398.0,11400,10000,65610,9,-1400,2015
16169,3.9,32398.0,35300,33900,77030,3,-1400,2015
510216,3.9,48820.0,21300,18500,71660,4,-2800,2015
411633,2.4,107527.0,7550,6100,61450,4,-1450,2015
419355,1.9,135404.0,3175,2600,61450,8,-575,2015
409725,3.5,20093.0,17100,15600,61450,2,-1500,2015
399094,1.9,79677.0,7175,7600,61450,2,425,2014
271403,4.6,33931.0,42600,43200,59100,3,600,2015
365028,4.2,85046.0,12650,13200,64520,5,550,2015
105475,3.6,44564.0,21700,20000,68360,4,-1700,2015
261496,4.1,38681.0,15700,15200,59100,3,-500,2015
25499,2.1,13097.0,18250,18000,77030,1,-250,2015
154880,3.7,90774.0,9850,9400,73100,11,-450,2015
335832,3.7,35860.0,15900,15300,82750,3,-600,2015
435746,3.6,88737.0,7275,7600,74430,5,325,2015
68731,3.8,58995.0,13600,13700,77030,1,100,2015
362959,4.4,53662.0,18800,19100,64520,3,300,2014
376045,3.6,125513.0,15750,16700,64520,6,950,2015
105434,2.2,44702.0,11000,9700,68360,2,-1300,2015
284251,4.6,25104.0,15300,16200,59100,2,900,2015
541117,4.8,5141.0,13050,13000,81400,1,-50,2015
157210,2.7,11150.0,20200,20100,73100,1,-100,2015
368852,3.9,58293.0,10650,10100,64520,2,-550,2015
249061,3.4,55263.0,14550,14200,59100,5,-350,2015
473605,4.2,24503.0,12850,12900,62930,1,50,2015
272339,4.3,55359.0,25000,25800,59100,3,800,2015
102134,4.3,40058.0,11400,11400,68360,2,0,2015
39401,3.7,20915.0,12300,12500,77030,2,200,2015
138538,2.9,46449.0,10550,9000,73100,3,-1550,2015
254862,3.4,63083.0,38100,38500,59100,3,400,2015
275391,3.0,11907.0,30700,30600,59100,1,-100,2015
170178,3.5,50310.0,10100,10200,73100,2,100,2015
508976,3.5,42341.0,19800,19100,71660,2,-700,2015
158285,4.4,32813.0,14450,14300,73100,3,-150,2015
230437,2.8,55808.0,20400,18100,89090,2,-2300,2015
47670,3.0,92551.0,8450,7800,77030,3,-650,2015
55776,4.1,24363.0,24100,24400,77030,3,300,2015
244765,2.0,20980.0,25100,20600,59100,3,-4500,2015
277365,3.5,72923.0,11200,11600,59100,5,400,2015
106232,4.0,18875.0,24500,29200,68360,1,4700,2015
147840,3.6,39039.0,20600,21000,73100,3,400,2015
529290,4.2,18791.0,14400,14500,70210,2,100,2015
335481,3.6,90880.0,10550,9500,82750,3,-1050,2015
111231,1.9,207338.0,2450,2000,68360,9,-450,2015
203664,2.8,45850.0,16550,17200,57290,4,650,2015
117014,1.8,105009.0,14750,11400,68360,6,-3350,2015
453582,3.3,61904.0,9650,9400,61490,4,-250,2015
142100,3.8,36950.0,14100,15300,73100,2,1200,2015
344115,2.9,73151.0,13350,13750,82750,5,400,2015
181159,2.5,74273.0,7175,8700,83200,7,1525,2015
418346,5.0,13633.0,14350,15400,61450,1,1050,2015
498588,3.5,40289.0,14250,14700,80610,2,450,2014
383456,3.2,52306.0,9975,8600,65610,3,-1375,2015
328076,3.8,82724.0,23900,21000,82750,4,-2900,2015
133175,3.5,78707.0,8125,9000,73100,8,875,2015
151036,1.9,18143.0,23600,21100,73100,3,-2500,2015
310839,2.5,95946.0,4000,4900,59100,7,900,2015
33944,3.9,57455.0,12100,10750,77030,6,-1350,2015
323276,4.2,15139.0,17150,17000,82750,3,-150,2015
29369,4.7,20061.0,14300,14250,77030,2,-50,2015
471184,3.9,88797.0,7975,7700,62930,3,-275,2015
23807,4.8,119198.0,16500,17500,77030,6,1000,2015
518011,3.2,122576.0,24800,22000,71660,3,-2800,2015
512735,3.4,34387.0,9400,10700,71660,1,1300,2015
110234,4.5,9803.0,12000,12600,68360,2,600,2015
366109,4.4,65504.0,6325,7750,64520,9,1425,2015
122230,4.3,31513.0,10600,11100,73100,2,500,2014
502770,2.4,27352.0,19400,18500,80610,5,-900,2015
215454,2.8,84795.0,9350,9100,57290,6,-250,2015
400078,2.2,53799.0,11700,10500,61450,1,-1200,2014
329483,1.9,121103.0,6825,5700,82750,10,-1125,2015
462155,4.2,116828.0,6475,6700,61490,7,225,2015
14089,2.9,106083.0,1900,2250,77030,12,350,2015
202475,3.6,46201.0,25900,25200,57290,2,-700,2015
125410,4.0,18952.0,22200,21700,73100,2,-500,2015
340359,3.5,69714.0,9150,7700,82750,9,-1450,2015
104547,3.7,13277.0,15950,15600,68360,2,-350,2015
197076,2.4,129371.0,5400,6000,67090,10,600,2015
381335,3.3,35136.0,27700,27000,64520,2,-700,2015
308167,2.7,21031.0,27100,25200,59100,2,-1900,2015
185194,3.5,81826.0,8675,8200,63250,5,-475,2015
204296,2.7,127728.0,9000,7600,57290,9,-1400,2015
216835,1.9,61583.0,6850,5700,57290,4,-1150,2015
213249,4.8,19892.0,14450,14600,57290,2,150,2015
443805,2.9,124438.0,7425,7500,74430,7,75,2015
108347,3.5,97146.0,22100,23000,68360,4,900,2015
412518,3.8,31942.0,21600,22100,61450,1,500,2015
496492,1.9,114101.0,7850,6900,73130,8,-950,2015
56581,3.8,26203.0,11500,12000,77030,3,500,2015
442639,2.2,76695.0,8825,6000,74430,4,-2825,2015
13269,2.6,106836.0,4325,4200,77030,6,-125,2015
531617,3.7,196599.0,4925,2600,82150,7,-2325,2015
216310,5.0,14756.0,22700,23500,57290,2,800,2015
301484,4.4,23766.0,13450,13600,59100,3,150,2015
179915,4.1,15892.0,25000,23000,83200,2,-2000,2015
356235,3.2,107210.0,11800,14500,62960,10,2700,2015
91818,4.4,33325.0,13350,13900,68360,1,550,2015
158868,4.0,18153.0,15150,14700,73100,0,-450,2015
154772,4.4,66931.0,13550,13900,73100,2,350,2015
27854,2.6,47392.0,12700,13100,77030,3,400,2015
519730,4.4,110071.0,6800,7100,71660,9,300,2015
341163,2.8,55882.0,11450,11500,82750,2,50,2015
530679,2.6,113098.0,3000,2100,82150,12,-900,2015
146646,4.0,98224.0,8150,7600,73100,3,-550,2015
235764,4.3,16739.0,25600,24800,59100,13,-800,2014
452427,2.1,134993.0,3925,3400,61490,9,-525,2015
426525,3.8,141924.0,5475,6200,61450,8,725,2015
312401,3.5,16271.0,13100,13200,59100,3,100,2015
123494,3.9,67309.0,28600,29600,73100,3,1000,2014
243084,4.4,14905.0,12700,12800,59100,1,100,2015
365771,4.3,40652.0,27300,28750,64520,4,1450,2015
350103,4.5,14873.0,16750,16700,62960,0,-50,2014
130660,3.7,20387.0,55200,54500,73100,2,-700,2015
145199,4.3,56089.0,36000,35800,73100,3,-200,2015
88892,4.1,39200.0,13450,7000,68360,2,-6450,2015
26936,2.3,154851.0,2075,2000,77030,8,-75,2015
479328,2.8,15043.0,11800,12800,73130,3,1000,2015
109411,5.0,49856.0,9800,9300,68360,3,-500,2015
534585,2.1,55837.0,12000,11000,82150,2,-1000,2015
329038,2.0,140888.0,2475,2100,82750,12,-375,2015
426472,4.0,27762.0,22600,24800,61450,2,2200,2015
141825,4.2,65406.0,8400,10100,73100,7,1700,2015
390437,3.7,52198.0,10150,10100,65610,2,-50,2015
62751,3.2,150261.0,5175,7500,77030,13,2325,2015
221973,,149677.0,1525,1400,89090,13,-125,2014
199452,4.6,18062.0,33700,36750,67090,1,3050,2015
364382,2.7,100997.0,7650,6000,64520,5,-1650,2015
136720,4.2,24861.0,14550,15300,73100,3,750,2015
502610,2.7,75805.0,10750,13000,80610,8,2250,2015
353671,4.4,15143.0,15600,16600,62960,1,1000,2015
479995,3.4,31336.0,14350,15600,73130,4,1250,2015
36502,4.5,10792.0,28500,30000,77030,1,1500,2015
354675,4.3,28896.0,19600,20100,62960,0,500,2015
377510,4.6,31810.0,14900,16300,64520,3,1400,2015
336544,2.6,37772.0,12000,10600,82750,3,-1400,2015
187339,2.6,113526.0,4100,3800,63250,8,-300,2015
41297,4.2,37678.0,18800,19000,77030,4,200,2015
443635,3.0,157522.0,8200,8800,74430,12,600,2015
84049,4.0,39150.0,16300,16900,68360,1,600,2015
277004,4.6,14864.0,16600,16600,59100,1,0,2015
124263,4.2,32748.0,15650,15900,73100,1,250,2015
300355,4.1,44170.0,9400,10900,59100,4,1500,2015
520344,3.7,31757.0,19950,19500,71660,1,-450,2015
106523,4.3,28612.0,12900,13900,68360,1,1000,2015
100097,1.9,123631.0,4750,6200,68360,7,1450,2015
8975,3.5,99045.0,3450,5500,77030,4,2050,2014
53475,1.8,108248.0,3950,1500,77030,8,-2450,2015
145664,3.5,30275.0,22500,22800,73100,1,300,2015
487711,3.3,29133.0,17100,15000,73130,4,-2100,2015
508871,3.7,60564.0,11300,9300,71660,7,-2000,2014
342814,4.1,28954.0,13600,15600,82750,3,2000,2015
353976,2.5,49916.0,36600,32750,62960,3,-3850,2015
494094,4.7,33342.0,18250,19800,73130,1,1550,2015
463833,2.3,17584.0,16650,15000,61490,2,-1650,2015
138343,3.5,100412.0,1825,500,73100,12,-1325,2015
435342,3.8,39379.0,21400,17900,74430,2,-3500,2015
437595,1.9,129201.0,1875,800,74430,11,-1075,2015
177118,2.4,135744.0,3450,3200,83200,12,-250,2015
7474,,137045.0,5600,6500,77030,11,900,2014
17478,2.9,20493.0,17500,16000,77030,1,-1500,2015
517075,4.3,19307.0,25100,23900,71660,1,-1200,2015
483955,4.0,15752.0,12550,12400,73130,1,-150,2015
455475,2.7,190722.0,600,1000,61490,14,400,2015
235790,1.9,122179.0,2125,800,59100,14,-1325,2014
421567,1.9,48261.0,5325,5400,61450,11,75,2015
257751,2.8,21800.0,12750,13400,59100,3,650,2015
115500,4.3,56530.0,28100,31100,68360,3,3000,2015
317930,3.7,57241.0,19050,18300,73200,6,-750,2015
150317,2.8,21803.0,25600,25500,73100,3,-100,2015
470056,5.0,11852.0,19750,20000,61490,1,250,2015
338744,4.9,15726.0,16500,16700,82750,2,200,2015
450679,4.2,16949.0,15400,14900,61490,1,-500,2015
199348,2.9,200767.0,4625,5400,67090,10,775,2015
375136,3.1,125099.0,5425,5200,64520,10,-225,2015
416140,4.3,30093.0,18600,19200,61450,4,600,2015
191120,4.2,24622.0,18100,15500,63250,1,-2600,2015
295061,2.2,55895.0,17650,6500,59100,5,-11150,2015
179510,4.2,24998.0,10100,10200,83200,2,100,2015
486960,2.0,18658.0,19200,18700,73130,1,-500,2015
133009,4.3,55795.0,21100,21000,73100,6,-100,2015
215974,4.8,17516.0,23300,27500,57290,2,4200,2015
344859,3.2,128272.0,7950,7300,82750,5,-650,2015
467780,2.1,167963.0,725,600,61490,17,-125,2015
226034,3.5,125390.0,2750,3200,89090,8,450,2015
211983,3.5,252376.0,575,2200,57290,15,1625,2015
235176,3.3,168374.0,3775,3300,59100,10,-475,2014
228149,2.0,24286.0,18850,13000,89090,1,-5850,2015
311143,2.8,145664.0,7775,7200,59100,11,-575,2015
502434,3.1,51454.0,11250,11100,80610,2,-150,2015
266867,1.9,111569.0,4050,5100,59100,9,1050,2015
516040,3.9,34894.0,13700,13800,71660,1,100,2015
228430,3.7,21553.0,16200,15800,89090,4,-400,2015
226268,3.1,71312.0,3250,2600,89090,12,-650,2015
31995,2.0,70522.0,8000,6800,77030,6,-1200,2015
22644,2.0,12659.0,19050,13600,77030,1,-5450,2015
32794,3.0,5746.0,23500,21200,77030,0,-2300,2015
236958,2.5,72760.0,12900,12000,59100,6,-900,2014
41434,2.6,25489.0,7025,9000,77030,6,1975,2015
461998,3.3,114254.0,14750,15000,61490,6,250,2015
309284,2.3,89431.0,8050,7600,59100,7,-450,2015
178512,3.9,29848.0,28800,31000,83200,3,2200,2015
56877,3.6,46843.0,8900,7200,77030,4,-1700,2015
41108,4.3,23837.0,10300,11300,77030,3,1000,2015
51861,3.6,41658.0,41700,40500,77030,3,-1200,2015
479356,2.4,22891.0,10600,10400,73130,3,-200,2015
121988,4.0,39374.0,14200,15200,73100,2,1000,2014
474573,4.3,77234.0,8275,8500,62930,2,225,2015
73752,3.1,111181.0,4175,3900,68360,6,-275,2014
428208,1.9,159388.0,1025,800,61450,14,-225,2015
353709,4.0,35259.0,17900,18000,62960,0,100,2015
398396,3.4,115456.0,6825,5500,61450,9,-1325,2014
130279,4.3,19101.0,10800,12100,73100,3,1300,2015
263213,4.6,15647.0,14200,15400,59100,3,1200,2015
284814,4.5,34753.0,18750,19200,59100,4,450,2015
513987,3.8,47416.0,10750,10600,71660,2,-150,2015
543163,4.4,44875.0,9000,9400,81400,2,400,2015
549352,4.2,26499.0,14050,14600,48460,3,550,2015
268518,4.0,17113.0,13900,13500,59100,3,-400,2015
321521,1.9,106017.0,1000,800,82750,16,-200,2015
25121,3.6,296322.0,2750,4100,77030,11,1350,2015
134015,3.6,44545.0,12600,11600,73100,3,-1000,2015
310232,4.1,13697.0,16250,15400,59100,3,-850,2015
451412,1.9,118217.0,2150,1500,61490,12,-650,2015
538901,2.4,73565.0,7550,5900,55590,4,-1650,2015
348155,1.0,85855.0,16150,10300,62960,8,-5850,2014
451725,2.1,195824.0,2075,1300,61490,11,-775,2015
92854,2.4,136651.0,1375,900,68360,13,-475,2015
452882,1.9,112057.0,4025,2100,61490,8,-1925,2015
464461,4.4,8580.0,16400,17000,61490,0,600,2015
148740,3.7,44070.0,14450,14300,73100,1,-150,2015
464603,3.9,95474.0,1975,2400,61490,12,425,2015
62,3.9,1608.0,10900,11000,77030,-1,100,2014
51159,3.4,59070.0,18350,20000,77030,7,1650,2015
393768,1.9,70984.0,6600,4800,65610,9,-1800,2015
397163,4.4,45313.0,22400,23600,65610,2,1200,2015
39717,3.8,58570.0,8800,9400,77030,3,600,2015
512411,4.8,18111.0,19500,18400,71660,2,-1100,2015
443144,2.7,109017.0,5400,5300,74430,10,-100,2015
303023,4.1,72749.0,20100,22800,59100,3,2700,2015
413741,4.0,101618.0,8875,9000,61450,7,125,2015
274897,2.9,75868.0,11000,10600,59100,7,-400,2015
117096,1.9,76643.0,7175,5200,68360,7,-1975,2015
447728,5.0,49635.0,33400,35000,56120,4,1600,2015
289457,1.9,182828.0,3050,2600,59100,12,-450,2015
450711,4.3,24112.0,21600,21000,61490,0,-600,2014
358908,2.7,81532.0,5200,5100,62960,12,-100,2015
203121,3.7,32773.0,21700,18600,57290,4,-3100,2015
402206,2.0,127340.0,6650,5500,61450,10,-1150,2015
258216,4.7,8511.0,34300,33600,59100,2,-700,2015
108657,3.5,117712.0,7600,8000,68360,8,400,2015
481038,3.6,40147.0,14700,13900,73130,3,-800,2015
87277,2.8,119831.0,7800,8600,68360,8,800,2015
446060,3.5,79944.0,4475,6500,56120,12,2025,2015
138141,4.0,20418.0,19300,19300,73100,1,0,2015
17645,3.5,24530.0,26600,26750,77030,2,150,2015
20706,3.5,83917.0,11800,12700,77030,4,900,2015
198952,2.5,16879.0,13650,12500,67090,3,-1150,2015
29649,4.3,16413.0,36100,35250,77030,3,-850,2015
136978,3.6,77756.0,22200,29800,73100,8,7600,2015
508405,3.5,46467.0,15000,14000,71660,2,-1000,2014
46694,4.6,11361.0,17950,18100,77030,1,150,2015
280012,4.5,4126.0,13950,14800,59100,1,850,2015
172140,4.6,25910.0,31700,32900,73100,2,1200,2015
37974,4.9,8517.0,29500,28250,77030,1,-1250,2015
448570,4.9,13052.0,18200,18000,56120,1,-200,2015
49336,4.2,23216.0,19550,21250,77030,4,1700,2015
364326,4.9,79518.0,8100,7900,64520,4,-200,2015
367759,4.9,3246.0,42900,46250,64520,1,3350,2015
256791,2.3,32243.0,15450,13800,59100,3,-1650,2015
237446,3.7,49210.0,9050,9700,59100,3,650,2015
5746,3.9,18616.0,21500,21000,77030,0,-500,2014
539789,,141353.0,6925,7500,81400,9,575,2014
420596,2.9,222510.0,11350,11800,61450,8,450,2015
171347,2.7,125371.0,3200,3300,73100,10,100,2015
330781,4.6,62446.0,24700,27500,82750,5,2800,2015
190399,2.0,88326.0,6700,4500,63250,6,-2200,2015
490389,4.9,48144.0,16400,17600,73130,3,1200,2015
345434,3.5,48640.0,13300,12900,82750,3,-400,2015
46914,3.8,34629.0,15000,14700,77030,1,-300,2015
152836,3.6,45440.0,9900,10400,73100,4,500,2015
375520,1.9,151404.0,1750,1300,64520,9,-450,2015
396449,4.1,81315.0,17950,18600,65610,6,650,2015
382622,2.4,103856.0,9250,7800,65610,7,-1450,2014
324246,3.8,49975.0,10450,10100,82750,2,-350,2015
490085,1.9,91201.0,6700,6900,73130,4,200,2015
175897,1.9,114365.0,7675,6500,83200,9,-1175,2015
421690,4.2,34902.0,12300,12900,61450,2,600,2015
333044,2.8,75835.0,10350,10400,82750,6,50,2015
194702,1.0,95268.0,11750,8250,67090,7,-3500,2015
287896,3.7,143559.0,9625,10600,59100,5,975,2015
174790,4.0,18541.0,29900,31400,83200,1,1500,2015
151551,3.7,63352.0,6075,7300,73100,10,1225,2015
197678,2.0,152633.0,1400,350,67090,12,-1050,2015
454204,1.9,144682.0,2850,1400,61490,11,-1450,2015
143299,3.9,35261.0,11750,12200,73100,1,450,2015
18603,4.9,5278.0,11550,12400,77030,1,850,2015
537024,4.3,37736.0,11300,11500,73640,2,200,2015
199249,4.7,9197.0,22700,21900,67090,2,-800,2015
236971,2.7,86584.0,11050,9800,59100,7,-1250,2015
106947,1.9,161208.0,3800,3800,68360,7,0,2015
211517,4.3,20517.0,23300,27400,57290,2,4100,2015
459316,2.7,95669.0,7500,5600,61490,7,-1900,2015
278500,3.2,103211.0,4850,7400,59100,7,2550,2015
361621,4.1,85762.0,4600,5700,64520,8,1100,2014
40592,2.3,138582.0,1875,3200,77030,14,1325,2015
333481,3.7,243422.0,6425,7800,82750,9,1375,2015
28939,4.0,83828.0,5825,7200,77030,5,1375,2015
95728,4.1,29113.0,20800,22200,68360,2,1400,2015
238891,2.7,168301.0,1150,400,59100,13,-750,2014
247718,3.5,64171.0,10300,9900,59100,3,-400,2015
102046,3.8,56483.0,13000,15000,68360,3,2000,2015
459200,4.1,42145.0,20200,22300,61490,3,2100,2015
527318,4.4,26179.0,19550,18700,70210,3,-850,2015
63162,2.7,29820.0,14100,12000,77030,3,-2100,2015
516362,3.9,33661.0,16550,17100,71660,2,550,2015
438062,2.0,109949.0,6825,3500,74430,7,-3325,2015
74595,,113831.0,4775,4100,68360,9,-675,2014
69457,4.0,71391.0,10550,11000,77030,2,450,2015
62385,4.6,67139.0,8950,8200,77030,3,-750,2015
15116,3.3,68773.0,13250,14000,77030,8,750,2015
156870,4.6,101924.0,15100,10600,73100,5,-4500,2015
414440,2.0,196208.0,8475,11500,61450,8,3025,2015
226344,4.4,20920.0,14900,14200,89090,2,-700,2015
172257,3.4,89392.0,11600,10500,73100,7,-1100,2015
453872,3.9,45567.0,13700,13400,61490,4,-300,2015
289013,2.4,125043.0,2125,2600,59100,9,475,2015
371277,3.3,79267.0,10100,11000,64520,8,900,2015
63490,3.8,19185.0,16000,16100,77030,1,100,2015
428781,2.8,152584.0,4775,5100,61450,5,325,2015
262817,4.4,21030.0,20500,21000,59100,1,500,2015
214753,4.2,54625.0,6750,8000,57290,4,1250,2015
263103,4.4,35042.0,35700,36600,59100,3,900,2015
31006,3.4,38332.0,25400,25000,77030,4,-400,2015
359095,2.7,62357.0,21800,20800,62960,2,-1000,2015
